,ts,record_id,user_authority,user,partial,base_asset_value,base_asset_value_closed,liquidation_fee,fee_to_liquidator,fee_to_insurance_fund,liquidator,total_collateral,collateral,unrealized_pnl,margin_ratio
2021-12-05 01:50:36.504518,1969-12-31 19:00:00-05:00,0,11111111111111111111111111111111,11111111111111111111111111111111,False,0,0,0,0,0,11111111111111111111111111111111,0,0,0,0
2021-12-05 01:50:36.504518,2021-11-02 23:44:44-04:00,1,73Wkg27usHy8knWENTmb9zbikugYh93JvBB2bF855vZ2,J9WaUA7r8ct4ZG8o8ATZjvHUPuCYqY42aTsr9xveW5BX,True,109019053,27254763,170209,85104,85105,72FwbpFGoLEazJEdpqNtPNefsadUrimUqma9wSoy4qiS,6808394,20827447,-14019053,624
2021-12-05 01:50:36.504518,2021-11-03 15:16:48-04:00,2,73Wkg27usHy8knWENTmb9zbikugYh93JvBB2bF855vZ2,J9WaUA7r8ct4ZG8o8ATZjvHUPuCYqY42aTsr9xveW5BX,True,83711127,20927781,111875,55937,55938,72FwbpFGoLEazJEdpqNtPNefsadUrimUqma9wSoy4qiS,4475031,16936405,-12461374,534
2021-12-05 01:50:36.504518,2021-11-03 16:14:45-04:00,3,DSEgVqfxXp5wxjn3gNZtmb4E6rJeBm3VcbqdwDnsuzSq,6YVCWznUKheSMPuywSRJgCes7wghPGJXgxfrVfnjN4mB,True,886842089,221710522,1365175,682587,682588,72FwbpFGoLEazJEdpqNtPNefsadUrimUqma9wSoy4qiS,54607013,149594012,-94986999,615
2021-12-05 01:50:36.504518,2021-11-03 16:47:45-04:00,4,73Wkg27usHy8knWENTmb9zbikugYh93JvBB2bF855vZ2,J9WaUA7r8ct4ZG8o8ATZjvHUPuCYqY42aTsr9xveW5BX,True,63192132,15798033,98701,49350,49351,72FwbpFGoLEazJEdpqNtPNefsadUrimUqma9wSoy4qiS,3948050,13703072,-9755022,624
2021-12-05 01:50:36.504518,2021-11-03 17:03:45-04:00,5,3oG1F9Ea32KTbfJcBQRMwn6fftcyARJNnibBZz84UrBi,2rwC8bmYjDxMM58LvLSYr1UpxsnTnqZXoyQa8qsBogst,True,2793365886,698341471,4359465,2179732,2179733,72FwbpFGoLEazJEdpqNtPNefsadUrimUqma9wSoy4qiS,174378631,472745517,-298366886,624
2021-12-05 01:50:36.504518,2021-11-03 18:24:21-04:00,6,DSEgVqfxXp5wxjn3gNZtmb4E6rJeBm3VcbqdwDnsuzSq,6YVCWznUKheSMPuywSRJgCes7wghPGJXgxfrVfnjN4mB,True,678174523,169543630,991998,495999,495999,72FwbpFGoLEazJEdpqNtPNefsadUrimUqma9wSoy4qiS,39679938,123983399,-84303461,585
2021-12-05 01:50:36.504518,2021-11-03 18:24:21-04:00,7,73Wkg27usHy8knWENTmb9zbikugYh93JvBB2bF855vZ2,J9WaUA7r8ct4ZG8o8ATZjvHUPuCYqY42aTsr9xveW5BX,True,48202614,12050653,75098,37549,37549,72FwbpFGoLEazJEdpqNtPNefsadUrimUqma9wSoy4qiS,3003948,11128829,-8124881,623
2021-12-05 01:50:36.504518,2021-11-03 19:01:25-04:00,8,3oG1F9Ea32KTbfJcBQRMwn6fftcyARJNnibBZz84UrBi,2rwC8bmYjDxMM58LvLSYr1UpxsnTnqZXoyQa8qsBogst,True,2130201752,532550438,3333349,1666674,1666675,72FwbpFGoLEazJEdpqNtPNefsadUrimUqma9wSoy4qiS,133333982,392486730,-259152748,625
2021-12-05 01:50:36.504518,2021-11-04 16:51:33-04:00,9,73Wkg27usHy8knWENTmb9zbikugYh93JvBB2bF855vZ2,J9WaUA7r8ct4ZG8o8ATZjvHUPuCYqY42aTsr9xveW5BX,True,36758326,9189581,55871,27935,27936,72FwbpFGoLEazJEdpqNtPNefsadUrimUqma9wSoy4qiS,2234866,8934976,-6700110,607
2021-12-05 01:50:36.504518,2021-11-04 16:52:33-04:00,10,3oG1F9Ea32KTbfJcBQRMwn6fftcyARJNnibBZz84UrBi,2rwC8bmYjDxMM58LvLSYr1UpxsnTnqZXoyQa8qsBogst,True,1633200505,408300126,2274195,1137097,1137098,72FwbpFGoLEazJEdpqNtPNefsadUrimUqma9wSoy4qiS,90967827,321023385,-230055558,556
2021-12-05 01:50:36.504518,2021-11-04 19:22:34-04:00,11,73Wkg27usHy8knWENTmb9zbikugYh93JvBB2bF855vZ2,J9WaUA7r8ct4ZG8o8ATZjvHUPuCYqY42aTsr9xveW5BX,True,27998439,6999609,43513,21756,21757,72FwbpFGoLEazJEdpqNtPNefsadUrimUqma9wSoy4qiS,1740533,7195369,-5454836,621
2021-12-05 01:50:36.504518,2021-11-06 04:34:38-04:00,12,3oG1F9Ea32KTbfJcBQRMwn6fftcyARJNnibBZz84UrBi,2rwC8bmYjDxMM58LvLSYr1UpxsnTnqZXoyQa8qsBogst,True,1233563244,308390811,1926349,963174,963175,72FwbpFGoLEazJEdpqNtPNefsadUrimUqma9wSoy4qiS,77053993,258339105,-181285112,624
2021-12-05 01:50:36.504518,2021-11-06 13:20:38-04:00,13,73Wkg27usHy8knWENTmb9zbikugYh93JvBB2bF855vZ2,J9WaUA7r8ct4ZG8o8ATZjvHUPuCYqY42aTsr9xveW5BX,True,21304502,5326125,33278,16639,16639,72FwbpFGoLEazJEdpqNtPNefsadUrimUqma9wSoy4qiS,1331129,5727961,-4396832,624
2021-12-05 01:50:36.504518,2021-11-06 15:39:37-04:00,14,81GV2H9ipJSZD6YpJGj2XQNfoUroWWnKfwMHGSwvhixd,7cLHoNuNVj8qkn3QmBYLFwja37f1MWEo4e3ZcNSpXTPw,True,6571396827,1642849206,10284072,5142036,5142036,72FwbpFGoLEazJEdpqNtPNefsadUrimUqma9wSoy4qiS,411362904,1122722501,-711359597,625
2021-12-05 01:50:36.504518,2021-11-06 17:34:39-04:00,15,81GV2H9ipJSZD6YpJGj2XQNfoUroWWnKfwMHGSwvhixd,7cLHoNuNVj8qkn3QmBYLFwja37f1MWEo4e3ZcNSpXTPw,True,5055468436,1263867109,6840919,3420459,3420460,72FwbpFGoLEazJEdpqNtPNefsadUrimUqma9wSoy4qiS,273636788,935544466,-661907678,541
2021-12-05 01:50:36.504518,2021-11-10 16:25:04-05:00,16,6zc2j7WaicYnnYjR6iMVLgJ9sqmvuKzkHNSSmcgbXrHw,5NBipewC9DDqx4p8cQn1UxRLZhDWyaTubUFoEzWdLH5Y,True,641803413,160450853,962996,481498,481498,72FwbpFGoLEazJEdpqNtPNefsadUrimUqma9wSoy4qiS,38519854,90906930,-52387076,600
2021-12-05 01:50:36.504518,2021-11-16 05:15:19-05:00,17,6zc2j7WaicYnnYjR6iMVLgJ9sqmvuKzkHNSSmcgbXrHw,5NBipewC9DDqx4p8cQn1UxRLZhDWyaTubUFoEzWdLH5Y,True,470929608,117732402,725163,362581,362582,72FwbpFGoLEazJEdpqNtPNefsadUrimUqma9wSoy4qiS,29006556,78738048,-49731492,615
2021-12-05 01:50:36.504518,2021-11-16 22:14:26-05:00,18,82ahWrNx6L73jAvzt4PAv7FuhwSdGqG4KqAZWD2uwEZt,2funPHa9Xi1hcgj7rHc7NHDYQ5HjgZ7UvbnZpet3u7kQ,True,115186277,28796569,169416,84708,84708,72FwbpFGoLEazJEdpqNtPNefsadUrimUqma9wSoy4qiS,6776654,27848342,-21071688,588
2021-12-05 01:50:36.504518,2021-11-16 22:17:18-05:00,19,7ckvB1uchDPcA5vkjJvu4DHCkgGq81qbJrd4P2CwPDV8,pVjScFyTQfYJ74uA9JLEsChSrtY8fRi2dCM3jtWC6bp,True,42902924,10725731,66987,33493,33494,72FwbpFGoLEazJEdpqNtPNefsadUrimUqma9wSoy4qiS,2679504,10312820,-7633316,624
2021-12-05 01:50:36.504518,2021-11-16 22:17:20-05:00,20,3fB955q6xxxZcgnCyguLwkSa7egxgBoksPQVQ3U8HRHL,GK7cTdhfSpapJB8dFzEkV8c1UFkJPj281DwztnpKjxLx,True,1001309929,250327482,1566816,783408,783408,72FwbpFGoLEazJEdpqNtPNefsadUrimUqma9wSoy4qiS,62672667,241361738,-178689071,625
2021-12-05 01:50:36.504518,2021-11-17 06:36:22-05:00,21,66SjFhmiNYz8tLRnBhZUbowWGTbM16G52X3AT2hma2wN,3wVy8nk24HCFZWMiacGe8QsJquYaadZ9pQg44bGRwdE3,True,306353682,76588420,479244,239622,239622,72FwbpFGoLEazJEdpqNtPNefsadUrimUqma9wSoy4qiS,19169799,73394042,-54224243,625
2021-12-05 01:50:36.504518,2021-11-17 06:36:22-05:00,22,6zc2j7WaicYnnYjR6iMVLgJ9sqmvuKzkHNSSmcgbXrHw,5NBipewC9DDqx4p8cQn1UxRLZhDWyaTubUFoEzWdLH5Y,True,344295978,86073994,488459,244229,244230,72FwbpFGoLEazJEdpqNtPNefsadUrimUqma9wSoy4qiS,19538382,65748413,-46210031,567
2021-12-05 01:50:36.504518,2021-11-17 06:36:22-05:00,23,HNCJ9xJCwy9rBzYHDF4AsE677ueQDGHS1riTGoBGdDgh,D8ZBxkpAFu877Lnsuazfyme3nB5cHYsSoDCUrMPMPLe3,True,285091156,71272789,424331,212165,212166,72FwbpFGoLEazJEdpqNtPNefsadUrimUqma9wSoy4qiS,16973272,66275286,-49302014,595
2021-12-05 01:50:36.504518,2021-11-18 04:35:19-05:00,24,7qJorn74oJLvVFiDqfhRRSGvcxNuU6DTAhQDtkJ3ERnz,EXYBVDWDDvY6fb45EHxTjL7FWJGHN8Cy9FQFHCKSPrEC,True,211058704,52764676,308403,154201,154202,72FwbpFGoLEazJEdpqNtPNefsadUrimUqma9wSoy4qiS,12336123,51282819,-38946696,584
2021-12-05 01:50:36.504518,2021-11-18 04:35:20-05:00,25,82ahWrNx6L73jAvzt4PAv7FuhwSdGqG4KqAZWD2uwEZt,2funPHa9Xi1hcgj7rHc7NHDYQ5HjgZ7UvbnZpet3u7kQ,True,84570913,21142728,122750,61375,61375,72FwbpFGoLEazJEdpqNtPNefsadUrimUqma9wSoy4qiS,4910002,22533254,-17623252,580
2021-12-05 01:50:36.504518,2021-11-18 04:37:17-05:00,26,7ckvB1uchDPcA5vkjJvu4DHCkgGq81qbJrd4P2CwPDV8,pVjScFyTQfYJ74uA9JLEsChSrtY8fRi2dCM3jtWC6bp,True,31455807,7863951,48411,24205,24206,72FwbpFGoLEazJEdpqNtPNefsadUrimUqma9wSoy4qiS,1936461,8382947,-6446486,615
2021-12-05 01:50:36.504518,2021-11-18 04:37:17-05:00,27,3fB955q6xxxZcgnCyguLwkSa7egxgBoksPQVQ3U8HRHL,GK7cTdhfSpapJB8dFzEkV8c1UFkJPj281DwztnpKjxLx,True,734224303,183556075,1135148,567574,567574,72FwbpFGoLEazJEdpqNtPNefsadUrimUqma9wSoy4qiS,45405959,196230002,-150824043,618
2021-12-05 01:50:36.504518,2021-11-18 07:10:54-05:00,28,6zc2j7WaicYnnYjR6iMVLgJ9sqmvuKzkHNSSmcgbXrHw,5NBipewC9DDqx4p8cQn1UxRLZhDWyaTubUFoEzWdLH5Y,True,253983496,63495874,384784,192392,192392,72FwbpFGoLEazJEdpqNtPNefsadUrimUqma9wSoy4qiS,15391368,54293148,-38901780,605
2021-12-05 01:50:36.504518,2021-11-18 07:10:59-05:00,29,5F6M2rEMMvaFGWWCf8XioLucUfb7nnp96vx9BcbroVsD,EYxYvNkDPViCFpWt7nsnhU27BLNuMbikAV7tNjcs3fFe,True,78518409,19629602,120444,60222,60222,72FwbpFGoLEazJEdpqNtPNefsadUrimUqma9wSoy4qiS,4817771,19103387,-14285616,613
2021-12-05 01:50:36.504518,2021-11-18 08:20:16-05:00,30,HNCJ9xJCwy9rBzYHDF4AsE677ueQDGHS1riTGoBGdDgh,D8ZBxkpAFu877Lnsuazfyme3nB5cHYsSoDCUrMPMPLe3,True,209844870,52461217,327261,163630,163631,72FwbpFGoLEazJEdpqNtPNefsadUrimUqma9wSoy4qiS,13090441,54044549,-40954108,623
2021-12-05 01:50:36.504518,2021-11-18 08:20:16-05:00,31,A2gRXnnsmLvMSzZray4DJdn7dgsrZwwK8uxqnajnyZHs,Gtwdm7MT23sMC9bucL12YD9LLjWftjzGso887FsatiuN,True,511674698,127918674,792551,396275,396276,72FwbpFGoLEazJEdpqNtPNefsadUrimUqma9wSoy4qiS,31702048,121599840,-89897792,619
2021-12-05 01:50:36.504518,2021-11-18 08:26:16-05:00,32,82ahWrNx6L73jAvzt4PAv7FuhwSdGqG4KqAZWD2uwEZt,2funPHa9Xi1hcgj7rHc7NHDYQ5HjgZ7UvbnZpet3u7kQ,True,62463019,15615754,96469,48234,48235,72FwbpFGoLEazJEdpqNtPNefsadUrimUqma9wSoy4qiS,3858790,18041823,-14183033,617
2021-12-05 01:50:36.504518,2021-11-18 08:26:18-05:00,33,3Ek5j2ea8wS2nCxsNgn2AbovxzJwGK7zc6xarkigSA3u,DEWmTn3Ah4F3nNXpoQLt1GG65Dsf4ZmGjn7FZUJyK6rP,True,9648863001,2412215750,14711849,7355924,7355925,72FwbpFGoLEazJEdpqNtPNefsadUrimUqma9wSoy4qiS,588473981,2294065700,-1705591719,609
2021-12-05 01:50:36.504518,2021-11-18 08:26:18-05:00,34,EFHg5FatMRRSZnKJPJF9e1iw2cjPJRmwTTZYtkHno9DP,84LnLKhZDJgWFnbBYnYjqWkjymemXfidecPFwnUAvuFj,True,1875250752,468812688,2832332,1416166,1416166,72FwbpFGoLEazJEdpqNtPNefsadUrimUqma9wSoy4qiS,113293312,446689045,-333395733,604
2021-12-05 01:50:36.504518,2021-11-18 08:26:19-05:00,35,26F7WDhDLwsFPgkeUDruwUiRn1R6SWS9rD3t33Tn1Ueq,88RtRiccENAcTo3hExVk9KgWhW5zrfGY175KN5EhnejY,True,420461143,105115285,626973,313486,313487,72FwbpFGoLEazJEdpqNtPNefsadUrimUqma9wSoy4qiS,25078946,101583114,-76504168,596
2021-12-05 01:50:36.504518,2021-11-18 08:26:19-05:00,36,7qJorn74oJLvVFiDqfhRRSGvcxNuU6DTAhQDtkJ3ERnz,EXYBVDWDDvY6fb45EHxTjL7FWJGHN8Cy9FQFHCKSPrEC,True,155668659,38917164,237348,118674,118674,72FwbpFGoLEazJEdpqNtPNefsadUrimUqma9wSoy4qiS,9493953,41331624,-31837671,609
2021-12-05 01:50:36.504518,2021-11-18 08:26:19-05:00,37,BELLbzmdx1SYke9kZUxFi9VcdvwaHmkZyv24FArQ1J2f,5a5LfKakAaFEVkavVHgExKaUr25RWYpzFic6MUQQ62uc,True,12586404230,3146601057,19204976,9602488,9602488,72FwbpFGoLEazJEdpqNtPNefsadUrimUqma9wSoy4qiS,768199057,2992456467,-2224257410,610
2021-12-05 01:50:36.504518,2021-11-18 08:27:17-05:00,38,66SjFhmiNYz8tLRnBhZUbowWGTbM16G52X3AT2hma2wN,3wVy8nk24HCFZWMiacGe8QsJquYaadZ9pQg44bGRwdE3,True,223649976,55912494,328215,164107,164108,72FwbpFGoLEazJEdpqNtPNefsadUrimUqma9wSoy4qiS,13128638,59916842,-46788204,587
2021-12-05 01:50:36.504518,2021-11-18 08:27:19-05:00,39,CQSb6ZVY1KVNXFAg8pxm8RvBBGGqRSU7FMvwHJPy46u8,FRBv3b5VTfKN1bK4DXFY4329LFbvm882P47edrgpuSM,True,6151578840,1537894710,9266157,4633078,4633079,72FwbpFGoLEazJEdpqNtPNefsadUrimUqma9wSoy4qiS,370646284,1130588794,-759942510,602
2021-12-05 01:50:36.504518,2021-11-18 08:27:19-05:00,40,AzmgakTxLAutgbcNkxi3S4M6MvuZvwcrzMc43ErMFk4h,7KR9xHmrpNDAuYo63YTTvWuaKsjbzF3bPTWDudsJK9oU,True,434658457,108664614,658799,329399,329400,72FwbpFGoLEazJEdpqNtPNefsadUrimUqma9wSoy4qiS,26351972,113882515,-87530543,606
2021-12-05 01:50:36.504518,2021-11-18 08:27:21-05:00,41,2XFYFxNQbCr5ao4cVzRZt45fsAwZc4jD9XTABmdqaJWd,CvpzBuDjyimaYFGWFkkBcaZGSRtAvtF6MtRV54mqZ74k,True,4230725,1057681,6440,3220,3220,72FwbpFGoLEazJEdpqNtPNefsadUrimUqma9wSoy4qiS,257622,1025897,-768275,608
2021-12-05 01:50:36.504518,2021-11-18 08:27:22-05:00,42,EQYUWtYbtvN9C9ixiupXPjHyFWHsYa7dUh4DSd6rxbzt,iS616uGNCwCxP1taAvvdvA2KdqfXRSjcQWwZRUgBkLb,True,72557222,18139305,106395,53197,53198,72FwbpFGoLEazJEdpqNtPNefsadUrimUqma9wSoy4qiS,4255810,17580388,-13324578,586
2021-12-05 01:50:36.504518,2021-11-18 08:27:22-05:00,43,36ByQojnxEckWdQTjqHfxKqCx9yjqWQsPsZyqaN72UWR,AZoirtS1fjX61agRM64tqThVinnJTh3BWgiHyNHPTgZP,True,63741003,15935250,97662,48831,48831,72FwbpFGoLEazJEdpqNtPNefsadUrimUqma9wSoy4qiS,3906499,15164496,-11257997,612
2021-12-05 01:50:36.504518,2021-11-18 08:27:35-05:00,44,EvSdLa5PeJiaaaE3omJNG7cw1tptZnHTituYswVHSwm3,68ESX2mBsfxQo2U9jsbmHo7TzPTxr9mGH5Y11ZLR7E3A,True,849278040,212319510,1283255,641627,641628,72FwbpFGoLEazJEdpqNtPNefsadUrimUqma9wSoy4qiS,51330227,202051187,-150720960,604
2021-12-05 01:50:36.504518,2021-11-18 08:55:17-05:00,45,8nXbrdjjaHB73CRPRenGEQj73wbtEFGDwXsehRGMhsap,43pvdcJ6f27wz94D6ZboKwRJYbyvYCrjsJhYsvk7LJCM,True,263455372,65863843,411779,205889,205890,72FwbpFGoLEazJEdpqNtPNefsadUrimUqma9wSoy4qiS,16471180,64837056,-48365876,625
2021-12-05 01:50:36.504518,2021-11-18 09:19:56-05:00,46,7ckvB1uchDPcA5vkjJvu4DHCkgGq81qbJrd4P2CwPDV8,pVjScFyTQfYJ74uA9JLEsChSrtY8fRi2dCM3jtWC6bp,True,23131331,5782832,36138,18069,18069,72FwbpFGoLEazJEdpqNtPNefsadUrimUqma9wSoy4qiS,1445534,6741005,-5295471,624
2021-12-05 01:50:36.504518,2021-11-18 09:21:54-05:00,47,3fB955q6xxxZcgnCyguLwkSa7egxgBoksPQVQ3U8HRHL,GK7cTdhfSpapJB8dFzEkV8c1UFkJPj281DwztnpKjxLx,True,539753368,134938342,844410,422205,422205,72FwbpFGoLEazJEdpqNtPNefsadUrimUqma9wSoy4qiS,33776400,157837180,-124060780,625
2021-12-05 01:50:36.504518,2021-11-18 09:22:55-05:00,48,J5WcVsKNHbfioai1LRowvjvtEmUJBEkeoBim1ThshpoP,Ajh7SWBq3zJR4vb6AFoBS6C9D99wC6YF1sVN22qC1vCA,True,68115782,17028945,106144,53072,53072,72FwbpFGoLEazJEdpqNtPNefsadUrimUqma9wSoy4qiS,4245770,16601048,-12355278,623
2021-12-05 01:50:36.504518,2021-11-18 09:26:56-05:00,49,FpqCxvTkSiwDwD5qEt6hXJxzFDLFLAQ8VevK8zwRqYun,A3p6YQisCJKpNkF7vkjZRbEfbnUt7vTZdR2zPBUSdTkk,True,408660222,102165055,639122,319561,319561,72FwbpFGoLEazJEdpqNtPNefsadUrimUqma9wSoy4qiS,25564893,98695221,-73130328,625
2021-12-05 01:50:36.504518,2021-11-18 09:28:55-05:00,50,6meAnGTy2XNUDk9qSJZGT6BBRinA5iGiDYEy2T88LXuX,BCzNQCn3J1381yNH5xp5ky9QmVKVdSofSUaLHtxKxPBW,True,4245793,1061448,6628,3314,3314,72FwbpFGoLEazJEdpqNtPNefsadUrimUqma9wSoy4qiS,265144,1018351,-753207,624
2021-12-05 01:50:36.504518,2021-11-18 09:28:55-05:00,51,EDE1swNYZ99y9idZacAw5Ncwz2DyD78SqvKMUXA2Dbw4,HSmYYMpNQNr1F2zjvysGRrC57FyusAJNsaXWfbmCfZh4,True,120751016,30187754,187648,93824,93824,72FwbpFGoLEazJEdpqNtPNefsadUrimUqma9wSoy4qiS,7505959,35696335,-28190376,621
2021-12-05 01:50:36.504518,2021-11-18 09:43:17-05:00,52,6zc2j7WaicYnnYjR6iMVLgJ9sqmvuKzkHNSSmcgbXrHw,5NBipewC9DDqx4p8cQn1UxRLZhDWyaTubUFoEzWdLH5Y,True,187099811,46774952,292135,146067,146068,72FwbpFGoLEazJEdpqNtPNefsadUrimUqma9wSoy4qiS,11685407,44252758,-32567351,624
2021-12-05 01:50:36.504518,2021-11-18 09:43:17-05:00,53,3A5AuwDWP4fT7RUqNBj51AxdS4uYkjEZmFYrykBJPp1X,GEXVPiMjcD2RS8jcEmo3k8CET3bJ8Fv3cAUn1ZwhxJy6,True,31144977083,7786244270,48055613,24027806,24027807,72FwbpFGoLEazJEdpqNtPNefsadUrimUqma9wSoy4qiS,1922224555,10079235642,-8157011087,617
2021-12-05 01:50:36.504518,2021-11-18 09:44:15-05:00,54,5F6M2rEMMvaFGWWCf8XioLucUfb7nnp96vx9BcbroVsD,EYxYvNkDPViCFpWt7nsnhU27BLNuMbikAV7tNjcs3fFe,True,57603118,14400779,85805,42902,42903,72FwbpFGoLEazJEdpqNtPNefsadUrimUqma9wSoy4qiS,3432227,15432505,-12000278,595
2021-12-05 01:50:36.504518,2021-11-18 09:44:17-05:00,55,J2gTwrYpzezkRupgBtgudQn5D33x6WjeBhTHnrA1qgqa,FBzoHRwqGRjnMvPEpiZVjtGZYJmAbneE4dpToXPzy8bv,True,42376177448,10594044362,65155050,32577525,32577525,72FwbpFGoLEazJEdpqNtPNefsadUrimUqma9wSoy4qiS,2606202004,10230023556,-7623821552,615
2021-12-05 01:50:36.504518,2021-11-18 09:45:15-05:00,56,E5KDZriZ89a5D4VsMaWxndMMG68RT4weruJ1tCEc6tSx,CaSwkUocpbyyGCQBgKjJZJgcexbyqs2GTrGJH6EMWXAz,True,42291150405,10572787601,62974033,31487016,31487017,72FwbpFGoLEazJEdpqNtPNefsadUrimUqma9wSoy4qiS,2518961323,10227809918,-7708848595,595
2021-12-05 01:50:36.504518,2021-11-18 09:45:15-05:00,57,82ahWrNx6L73jAvzt4PAv7FuhwSdGqG4KqAZWD2uwEZt,2funPHa9Xi1hcgj7rHc7NHDYQ5HjgZ7UvbnZpet3u7kQ,True,45712477,11428119,65905,32952,32953,72FwbpFGoLEazJEdpqNtPNefsadUrimUqma9wSoy4qiS,2636225,14408554,-11772329,576
2021-12-05 01:50:36.504518,2021-11-18 09:45:17-05:00,58,HNCJ9xJCwy9rBzYHDF4AsE677ueQDGHS1riTGoBGdDgh,D8ZBxkpAFu877Lnsuazfyme3nB5cHYsSoDCUrMPMPLe3,True,152994206,38248551,210070,105035,105035,72FwbpFGoLEazJEdpqNtPNefsadUrimUqma9wSoy4qiS,8402826,43510143,-35107317,549
2021-12-05 01:50:36.504518,2021-11-18 09:45:19-05:00,59,3Ek5j2ea8wS2nCxsNgn2AbovxzJwGK7zc6xarkigSA3u,DEWmTn3Ah4F3nNXpoQLt1GG65Dsf4ZmGjn7FZUJyK6rP,True,7069173332,1767293333,10190866,5095433,5095433,72FwbpFGoLEazJEdpqNtPNefsadUrimUqma9wSoy4qiS,407634677,1859031518,-1451396841,576
2021-12-05 01:50:36.504518,2021-11-18 09:45:19-05:00,60,66SjFhmiNYz8tLRnBhZUbowWGTbM16G52X3AT2hma2wN,3wVy8nk24HCFZWMiacGe8QsJquYaadZ9pQg44bGRwdE3,True,164254987,41063746,233729,116864,116865,72FwbpFGoLEazJEdpqNtPNefsadUrimUqma9wSoy4qiS,9349189,47925479,-38576290,569
2021-12-05 01:50:36.504518,2021-11-18 09:45:19-05:00,61,26F7WDhDLwsFPgkeUDruwUiRn1R6SWS9rD3t33Tn1Ueq,88RtRiccENAcTo3hExVk9KgWhW5zrfGY175KN5EhnejY,True,307864068,76966017,425719,212859,212860,72FwbpFGoLEazJEdpqNtPNefsadUrimUqma9wSoy4qiS,17028778,81897729,-64868951,553
2021-12-05 01:50:36.504518,2021-11-18 09:45:20-05:00,62,4xsYjVsPm2C2itNtJb3NYkBp4WySHUwtSbWdu9fge8wz,8zu2jMoTndZpf9khY9PMhve88LRwrKNTuVuLpa5ss8qo,True,2111279004,527819751,2905598,1452799,1452799,72FwbpFGoLEazJEdpqNtPNefsadUrimUqma9wSoy4qiS,116223943,504991684,-388767741,550
2021-12-05 01:50:36.504518,2021-11-18 09:45:20-05:00,63,7DWHQdHp5svNzMwB6E5sStKHdHTw2jWwhK5pGHW8bjXg,EG3PvMxk7SP6J9aDwkPBBqtZYckFHWGTfsnK8nunhYka,True,107006179,26751544,144400,72200,72200,72FwbpFGoLEazJEdpqNtPNefsadUrimUqma9wSoy4qiS,5776019,25796685,-20020666,539
2021-12-05 01:50:36.504518,2021-11-18 09:45:20-05:00,64,7qJorn74oJLvVFiDqfhRRSGvcxNuU6DTAhQDtkJ3ERnz,EXYBVDWDDvY6fb45EHxTjL7FWJGHN8Cy9FQFHCKSPrEC,True,113949939,28487484,161918,80959,80959,72FwbpFGoLEazJEdpqNtPNefsadUrimUqma9wSoy4qiS,6476742,33157817,-26681075,568
2021-12-05 01:50:36.504518,2021-11-18 09:45:20-05:00,65,7zDNgPFeomS1hdQhuY8iGF3nnGMNnx1YrinZJetrefje,AKyG5R6Bac6Fu83ruL9FGpjKCfDKxbP6QfEGbCgqegiV,True,409767671,102441917,556359,278179,278180,72FwbpFGoLEazJEdpqNtPNefsadUrimUqma9wSoy4qiS,22254386,97635132,-75380746,543
2021-12-05 01:50:36.504518,2021-11-18 09:45:20-05:00,66,EFHg5FatMRRSZnKJPJF9e1iw2cjPJRmwTTZYtkHno9DP,84LnLKhZDJgWFnbBYnYjqWkjymemXfidecPFwnUAvuFj,True,1372519660,343129915,1920099,960049,960050,72FwbpFGoLEazJEdpqNtPNefsadUrimUqma9wSoy4qiS,76803965,360947969,-284144004,559
2021-12-05 01:50:36.504518,2021-11-18 09:51:16-05:00,67,EQYUWtYbtvN9C9ixiupXPjHyFWHsYa7dUh4DSd6rxbzt,iS616uGNCwCxP1taAvvdvA2KdqfXRSjcQWwZRUgBkLb,True,53595891,13398972,83438,41719,41719,72FwbpFGoLEazJEdpqNtPNefsadUrimUqma9wSoy4qiS,3337538,14153280,-10815742,622
2021-12-05 01:50:36.504518,2021-11-18 09:55:16-05:00,68,BELLbzmdx1SYke9kZUxFi9VcdvwaHmkZyv24FArQ1J2f,5a5LfKakAaFEVkavVHgExKaUr25RWYpzFic6MUQQ62uc,True,9264879654,2316219913,14395772,7197886,7197886,72FwbpFGoLEazJEdpqNtPNefsadUrimUqma9wSoy4qiS,575830891,2427001038,-1851170147,621
2021-12-05 01:50:36.504518,2021-11-18 09:58:15-05:00,69,8d333AWdyiVhvkAdiKCTwhgzaPBMbn8mtucwUC1SAbZZ,3BM8UNLN7XGRaYRjezAqFVMr1z4PS3VRXiN1NAtvBuD9,True,495185323,123796330,753891,376945,376946,72FwbpFGoLEazJEdpqNtPNefsadUrimUqma9wSoy4qiS,30155678,119969355,-89813677,608
2021-12-05 01:50:36.504518,2021-11-18 09:58:16-05:00,70,EvSdLa5PeJiaaaE3omJNG7cw1tptZnHTituYswVHSwm3,68ESX2mBsfxQo2U9jsbmHo7TzPTxr9mGH5Y11ZLR7E3A,True,625507296,156376824,967866,483933,483933,72FwbpFGoLEazJEdpqNtPNefsadUrimUqma9wSoy4qiS,38714659,163243378,-124528719,618
2021-12-05 01:50:36.504518,2021-11-18 09:58:16-05:00,71,36ByQojnxEckWdQTjqHfxKqCx9yjqWQsPsZyqaN72UWR,AZoirtS1fjX61agRM64tqThVinnJTh3BWgiHyNHPTgZP,True,46900742,11725185,72818,36409,36409,72FwbpFGoLEazJEdpqNtPNefsadUrimUqma9wSoy4qiS,2912742,12261513,-9348771,621
2021-12-05 01:50:36.504518,2021-11-18 09:58:16-05:00,72,CQSb6ZVY1KVNXFAg8pxm8RvBBGGqRSU7FMvwHJPy46u8,FRBv3b5VTfKN1bK4DXFY4329LFbvm882P47edrgpuSM,True,4526046613,1131511653,6865098,3432549,3432549,72FwbpFGoLEazJEdpqNtPNefsadUrimUqma9wSoy4qiS,274603950,934037279,-659433329,606
2021-12-05 01:50:36.504518,2021-11-18 09:58:18-05:00,73,2XFYFxNQbCr5ao4cVzRZt45fsAwZc4jD9XTABmdqaJWd,CvpzBuDjyimaYFGWFkkBcaZGSRtAvtF6MtRV54mqZ74k,True,3111405,777851,4753,2376,2377,72FwbpFGoLEazJEdpqNtPNefsadUrimUqma9wSoy4qiS,190134,828047,-637913,611
2021-12-05 01:50:36.504518,2021-11-18 09:58:19-05:00,74,AzmgakTxLAutgbcNkxi3S4M6MvuZvwcrzMc43ErMFk4h,7KR9xHmrpNDAuYo63YTTvWuaKsjbzF3bPTWDudsJK9oU,True,319645813,79911453,485148,242574,242574,72FwbpFGoLEazJEdpqNtPNefsadUrimUqma9wSoy4qiS,19405946,91411736,-72005790,607
2021-12-05 01:50:36.504518,2021-11-18 10:11:18-05:00,75,8nXbrdjjaHB73CRPRenGEQj73wbtEFGDwXsehRGMhsap,43pvdcJ6f27wz94D6ZboKwRJYbyvYCrjsJhYsvk7LJCM,True,193573515,48393378,302816,151408,151408,72FwbpFGoLEazJEdpqNtPNefsadUrimUqma9wSoy4qiS,12112672,52408670,-40295998,625
2021-12-05 01:50:36.504518,2021-11-18 10:13:18-05:00,76,7ckvB1uchDPcA5vkjJvu4DHCkgGq81qbJrd4P2CwPDV8,pVjScFyTQfYJ74uA9JLEsChSrtY8fRi2dCM3jtWC6bp,True,16998011,4249502,26548,13274,13274,72FwbpFGoLEazJEdpqNtPNefsadUrimUqma9wSoy4qiS,1061939,5384109,-4322170,624
2021-12-05 01:50:36.504518,2021-11-18 10:13:18-05:00,77,9b5c6WqiKuBa6ARf1evmyrDZ8rYv2VCgjSDME7HFbzGk,65TnTCwZ8nTgu8CXXAMvjm6iZhdjwGxmWZnmAgWeebYM,True,543161554,135790388,842403,421201,421202,72FwbpFGoLEazJEdpqNtPNefsadUrimUqma9wSoy4qiS,33696157,129121268,-95425111,620
2021-12-05 01:50:36.504518,2021-11-18 10:14:17-05:00,78,J5WcVsKNHbfioai1LRowvjvtEmUJBEkeoBim1ThshpoP,Ajh7SWBq3zJR4vb6AFoBS6C9D99wC6YF1sVN22qC1vCA,True,50067166,12516791,78222,39111,39111,72FwbpFGoLEazJEdpqNtPNefsadUrimUqma9wSoy4qiS,3128890,13415276,-10286386,624
2021-12-05 01:50:36.504518,2021-11-18 10:14:18-05:00,79,3fB955q6xxxZcgnCyguLwkSa7egxgBoksPQVQ3U8HRHL,GK7cTdhfSpapJB8dFzEkV8c1UFkJPj281DwztnpKjxLx,True,396512066,99128016,617495,308747,308748,72FwbpFGoLEazJEdpqNtPNefsadUrimUqma9wSoy4qiS,24699804,126063918,-101364114,622
2021-12-05 01:50:36.504518,2021-11-18 10:15:21-05:00,80,FpqCxvTkSiwDwD5qEt6hXJxzFDLFLAQ8VevK8zwRqYun,A3p6YQisCJKpNkF7vkjZRbEfbnUt7vTZdR2zPBUSdTkk,True,300181552,75045388,466645,233322,233323,72FwbpFGoLEazJEdpqNtPNefsadUrimUqma9wSoy4qiS,18665800,79835746,-61169946,621
2021-12-05 01:50:36.504518,2021-11-18 10:16:26-05:00,81,EDE1swNYZ99y9idZacAw5Ncwz2DyD78SqvKMUXA2Dbw4,HSmYYMpNQNr1F2zjvysGRrC57FyusAJNsaXWfbmCfZh4,True,88752328,22188082,138081,69040,69041,72FwbpFGoLEazJEdpqNtPNefsadUrimUqma9wSoy4qiS,5523240,28477746,-22954506,622
2021-12-05 01:50:36.504518,2021-11-18 10:17:21-05:00,82,6meAnGTy2XNUDk9qSJZGT6BBRinA5iGiDYEy2T88LXuX,BCzNQCn3J1381yNH5xp5ky9QmVKVdSofSUaLHtxKxPBW,True,3118482,779620,4830,2415,2415,72FwbpFGoLEazJEdpqNtPNefsadUrimUqma9wSoy4qiS,193210,823990,-630780,619
2021-12-05 01:50:36.504518,2021-11-18 10:18:18-05:00,83,DXZMRSKFgnNdiXHps2xzayuztJNH9EUUz2wkCCneXtW5,9Z2sUfTCZCkmw5n3HSsoLG992AcpJo2qxp7XpJnnBxZM,True,121458953,30364738,187677,93838,93839,72FwbpFGoLEazJEdpqNtPNefsadUrimUqma9wSoy4qiS,7507105,29597161,-22090056,618
2021-12-05 01:50:36.504518,2021-11-18 10:20:16-05:00,84,6zc2j7WaicYnnYjR6iMVLgJ9sqmvuKzkHNSSmcgbXrHw,5NBipewC9DDqx4p8cQn1UxRLZhDWyaTubUFoEzWdLH5Y,True,137471424,34367856,214112,107056,107056,72FwbpFGoLEazJEdpqNtPNefsadUrimUqma9wSoy4qiS,8564480,35845261,-27280781,623
2021-12-05 01:50:36.504518,2021-11-18 10:20:16-05:00,85,5F6M2rEMMvaFGWWCf8XioLucUfb7nnp96vx9BcbroVsD,EYxYvNkDPViCFpWt7nsnhU27BLNuMbikAV7tNjcs3fFe,True,42478478,10619619,65754,32877,32877,72FwbpFGoLEazJEdpqNtPNefsadUrimUqma9wSoy4qiS,2630175,12354458,-9724283,619
2021-12-05 01:50:36.504518,2021-11-18 10:21:18-05:00,86,3PmLtoHk5uuB5e6KNUqr9XaFiZYSMSB6yt1k5xzHUFUv,DyrVKXFMchomdbzRaK4CEwYwVMFbGYVja6hwGJQJvUMH,True,1452381802,363095450,2238026,1119013,1119013,72FwbpFGoLEazJEdpqNtPNefsadUrimUqma9wSoy4qiS,89521049,392083423,-302562374,616
2021-12-05 01:50:36.504518,2021-11-18 10:24:18-05:00,87,3A5AuwDWP4fT7RUqNBj51AxdS4uYkjEZmFYrykBJPp1X,GEXVPiMjcD2RS8jcEmo3k8CET3bJ8Fv3cAUn1ZwhxJy6,True,22913240139,5728310034,35820390,17910195,17910195,72FwbpFGoLEazJEdpqNtPNefsadUrimUqma9wSoy4qiS,1432815612,8049286942,-6616471330,625
2021-12-05 01:50:36.504518,2021-11-18 10:24:18-05:00,88,HNCJ9xJCwy9rBzYHDF4AsE677ueQDGHS1riTGoBGdDgh,D8ZBxkpAFu877Lnsuazfyme3nB5cHYsSoDCUrMPMPLe3,True,113260723,28315180,168205,84102,84103,72FwbpFGoLEazJEdpqNtPNefsadUrimUqma9wSoy4qiS,6728230,34544949,-27816719,594
2021-12-05 01:50:36.504518,2021-11-18 10:24:18-05:00,89,7zDNgPFeomS1hdQhuY8iGF3nnGMNnx1YrinZJetrefje,AKyG5R6Bac6Fu83ruL9FGpjKCfDKxbP6QfEGbCgqegiV,True,303707994,75926998,453374,226687,226687,72FwbpFGoLEazJEdpqNtPNefsadUrimUqma9wSoy4qiS,18134989,78297014,-60162025,597
2021-12-05 01:50:36.504518,2021-11-18 10:24:18-05:00,90,7DWHQdHp5svNzMwB6E5sStKHdHTw2jWwhK5pGHW8bjXg,EG3PvMxk7SP6J9aDwkPBBqtZYckFHWGTfsnK8nunhYka,True,79302367,19825591,117340,58670,58670,72FwbpFGoLEazJEdpqNtPNefsadUrimUqma9wSoy4qiS,4693639,20662052,-15968413,591
2021-12-05 01:50:36.504518,2021-11-18 10:25:17-05:00,91,3XzkSrNTGd3Fhd4M3gYzvz2utbQpFN1fhtbAaZu7C39R,GMsZGGfktTzYi7GhD3W6HY9QY9bznqTKfeArksikLE71,True,20670789,5167697,31429,15714,15715,72FwbpFGoLEazJEdpqNtPNefsadUrimUqma9wSoy4qiS,1257163,5085393,-3828230,608
2021-12-05 01:50:36.504518,2021-11-18 10:25:18-05:00,92,26F7WDhDLwsFPgkeUDruwUiRn1R6SWS9rD3t33Tn1Ueq,88RtRiccENAcTo3hExVk9KgWhW5zrfGY175KN5EhnejY,True,227988000,56997000,343352,171676,171676,72FwbpFGoLEazJEdpqNtPNefsadUrimUqma9wSoy4qiS,13734108,65300929,-51566821,602
2021-12-05 01:50:36.504518,2021-11-18 10:25:18-05:00,93,82ahWrNx6L73jAvzt4PAv7FuhwSdGqG4KqAZWD2uwEZt,2funPHa9Xi1hcgj7rHc7NHDYQ5HjgZ7UvbnZpet3u7kQ,True,33821151,8455287,52830,26415,26415,72FwbpFGoLEazJEdpqNtPNefsadUrimUqma9wSoy4qiS,2113209,11405843,-9292634,624
2021-12-05 01:50:36.504518,2021-11-18 10:25:19-05:00,94,57GUgfEp9ZQ5iAU2nx1Z2Tiz3gqq7yBNaqfE1cvxjFYt,98upivFa9Tdy3RZHGM1i2k5zeczaGqioq3rTzc3DMf4x,True,437207805,109301951,670348,335174,335174,72FwbpFGoLEazJEdpqNtPNefsadUrimUqma9wSoy4qiS,26813931,120624442,-93810511,613
2021-12-05 01:50:36.504518,2021-11-18 10:25:19-05:00,95,EFHg5FatMRRSZnKJPJF9e1iw2cjPJRmwTTZYtkHno9DP,84LnLKhZDJgWFnbBYnYjqWkjymemXfidecPFwnUAvuFj,True,1016651737,254162934,1558230,779115,779115,72FwbpFGoLEazJEdpqNtPNefsadUrimUqma9wSoy4qiS,62329212,288274608,-225945396,613
2021-12-05 01:50:36.504518,2021-11-18 10:25:19-05:00,96,4xsYjVsPm2C2itNtJb3NYkBp4WySHUwtSbWdu9fge8wz,8zu2jMoTndZpf9khY9PMhve88LRwrKNTuVuLpa5ss8qo,True,1563315078,390828769,2336404,1168202,1168202,72FwbpFGoLEazJEdpqNtPNefsadUrimUqma9wSoy4qiS,93456185,405406859,-311950674,597
2021-12-05 01:50:36.504518,2021-11-18 10:25:20-05:00,97,66SjFhmiNYz8tLRnBhZUbowWGTbM16G52X3AT2hma2wN,3wVy8nk24HCFZWMiacGe8QsJquYaadZ9pQg44bGRwdE3,True,121567163,30391790,187832,93916,93916,72FwbpFGoLEazJEdpqNtPNefsadUrimUqma9wSoy4qiS,7513308,38071109,-30557801,618
2021-12-05 01:50:36.504518,2021-11-18 10:25:20-05:00,98,7qJorn74oJLvVFiDqfhRRSGvcxNuU6DTAhQDtkJ3ERnz,EXYBVDWDDvY6fb45EHxTjL7FWJGHN8Cy9FQFHCKSPrEC,True,84360427,21090106,130700,65350,65350,72FwbpFGoLEazJEdpqNtPNefsadUrimUqma9wSoy4qiS,5228012,26341558,-21113546,619
2021-12-05 01:50:36.504518,2021-11-18 10:26:15-05:00,99,J2gTwrYpzezkRupgBtgudQn5D33x6WjeBhTHnrA1qgqa,FBzoHRwqGRjnMvPEpiZVjtGZYJmAbneE4dpToXPzy8bv,True,31163779066,7790944766,48209107,24104553,24104554,72FwbpFGoLEazJEdpqNtPNefsadUrimUqma9wSoy4qiS,1928364286,8356936515,-6428572229,618
2021-12-05 01:50:36.504518,2021-11-18 10:26:15-05:00,100,3Ek5j2ea8wS2nCxsNgn2AbovxzJwGK7zc6xarkigSA3u,DEWmTn3Ah4F3nNXpoQLt1GG65Dsf4ZmGjn7FZUJyK6rP,True,5204417208,1301104302,7523145,3761572,3761573,72FwbpFGoLEazJEdpqNtPNefsadUrimUqma9wSoy4qiS,300925823,1489568013,-1188642190,578
2021-12-05 01:50:36.504518,2021-11-18 10:27:24-05:00,101,HfRH3JeKFL399DkU3omcbiXjKvfdVq8YuXBN1rtrcwxz,3pgq9GHmS5DSUqwtPEAx5WgfHwAp65teUyTbnQVuq1UA,True,21132854,5283213,31308,15654,15654,72FwbpFGoLEazJEdpqNtPNefsadUrimUqma9wSoy4qiS,1252342,5121973,-3869631,592
2021-12-05 01:50:36.504518,2021-11-18 10:27:24-05:00,102,E5KDZriZ89a5D4VsMaWxndMMG68RT4weruJ1tCEc6tSx,CaSwkUocpbyyGCQBgKjJZJgcexbyqs2GTrGJH6EMWXAz,True,31068030927,7767007731,45283447,22641723,22641724,72FwbpFGoLEazJEdpqNtPNefsadUrimUqma9wSoy4qiS,1811337898,8335656089,-6524318191,583
2021-12-05 01:50:36.504518,2021-11-18 10:27:27-05:00,103,36ByQojnxEckWdQTjqHfxKqCx9yjqWQsPsZyqaN72UWR,AZoirtS1fjX61agRM64tqThVinnJTh3BWgiHyNHPTgZP,True,34317688,8579422,49707,24853,24854,72FwbpFGoLEazJEdpqNtPNefsadUrimUqma9wSoy4qiS,1988308,9857876,-7869568,579
2021-12-05 01:50:36.504518,2021-11-18 10:27:29-05:00,104,2XFYFxNQbCr5ao4cVzRZt45fsAwZc4jD9XTABmdqaJWd,CvpzBuDjyimaYFGWFkkBcaZGSRtAvtF6MtRV54mqZ74k,True,2277907,569476,3253,1626,1627,72FwbpFGoLEazJEdpqNtPNefsadUrimUqma9wSoy4qiS,130149,664253,-534104,571
2021-12-05 01:50:36.504518,2021-11-18 10:27:34-05:00,105,8nXbrdjjaHB73CRPRenGEQj73wbtEFGDwXsehRGMhsap,43pvdcJ6f27wz94D6ZboKwRJYbyvYCrjsJhYsvk7LJCM,True,141776801,35444200,210163,105081,105082,72FwbpFGoLEazJEdpqNtPNefsadUrimUqma9wSoy4qiS,8406520,42033889,-33627369,592
2021-12-05 01:50:36.504518,2021-11-18 10:27:34-05:00,106,EQYUWtYbtvN9C9ixiupXPjHyFWHsYa7dUh4DSd6rxbzt,iS616uGNCwCxP1taAvvdvA2KdqfXRSjcQWwZRUgBkLb,True,39062986,9765746,53182,26591,26591,72FwbpFGoLEazJEdpqNtPNefsadUrimUqma9wSoy4qiS,2127285,11373205,-9245920,544
2021-12-05 01:50:36.504518,2021-11-18 10:27:37-05:00,107,CQSb6ZVY1KVNXFAg8pxm8RvBBGGqRSU7FMvwHJPy46u8,FRBv3b5VTfKN1bK4DXFY4329LFbvm882P47edrgpuSM,True,3313448254,828362063,4681411,2340705,2340706,72FwbpFGoLEazJEdpqNtPNefsadUrimUqma9wSoy4qiS,187256452,763943372,-576686920,565
2021-12-05 01:50:36.504518,2021-11-18 10:27:37-05:00,108,EvSdLa5PeJiaaaE3omJNG7cw1tptZnHTituYswVHSwm3,68ESX2mBsfxQo2U9jsbmHo7TzPTxr9mGH5Y11ZLR7E3A,True,457497802,114374450,654938,327469,327469,72FwbpFGoLEazJEdpqNtPNefsadUrimUqma9wSoy4qiS,26197537,131247284,-105049747,572
2021-12-05 01:50:36.504518,2021-11-18 10:27:37-05:00,109,AzmgakTxLAutgbcNkxi3S4M6MvuZvwcrzMc43ErMFk4h,7KR9xHmrpNDAuYo63YTTvWuaKsjbzF3bPTWDudsJK9oU,True,233910605,58477651,328492,164246,164246,72FwbpFGoLEazJEdpqNtPNefsadUrimUqma9wSoy4qiS,13139691,72973326,-59833635,561
2021-12-05 01:50:36.504518,2021-11-18 10:27:37-05:00,110,8d333AWdyiVhvkAdiKCTwhgzaPBMbn8mtucwUC1SAbZZ,3BM8UNLN7XGRaYRjezAqFVMr1z4PS3VRXiN1NAtvBuD9,True,362123835,90530958,505066,252533,252533,72FwbpFGoLEazJEdpqNtPNefsadUrimUqma9wSoy4qiS,20202658,96840749,-76638091,557
2021-12-05 01:50:36.504518,2021-11-18 10:27:38-05:00,111,BELLbzmdx1SYke9kZUxFi9VcdvwaHmkZyv24FArQ1J2f,5a5LfKakAaFEVkavVHgExKaUr25RWYpzFic6MUQQ62uc,True,6764584126,1691146031,9464871,4732435,4732436,72FwbpFGoLEazJEdpqNtPNefsadUrimUqma9wSoy4qiS,378594870,1955541773,-1576946903,559
2021-12-05 01:50:36.504518,2021-11-18 11:31:18-05:00,112,J5WcVsKNHbfioai1LRowvjvtEmUJBEkeoBim1ThshpoP,Ajh7SWBq3zJR4vb6AFoBS6C9D99wC6YF1sVN22qC1vCA,True,36779372,9194843,57466,28733,28733,72FwbpFGoLEazJEdpqNtPNefsadUrimUqma9wSoy4qiS,2298644,10784628,-8485984,624
2021-12-05 01:50:36.504518,2021-11-18 11:31:18-05:00,113,9b5c6WqiKuBa6ARf1evmyrDZ8rYv2VCgjSDME7HFbzGk,65TnTCwZ8nTgu8CXXAMvjm6iZhdjwGxmWZnmAgWeebYM,True,398721943,99680485,610257,305128,305129,72FwbpFGoLEazJEdpqNtPNefsadUrimUqma9wSoy4qiS,24410307,104643595,-80233288,612
2021-12-05 01:50:36.504518,2021-11-18 11:31:18-05:00,114,3fB955q6xxxZcgnCyguLwkSa7egxgBoksPQVQ3U8HRHL,GK7cTdhfSpapJB8dFzEkV8c1UFkJPj281DwztnpKjxLx,True,291275614,72818903,453105,226552,226553,72FwbpFGoLEazJEdpqNtPNefsadUrimUqma9wSoy4qiS,18124201,100264365,-82140164,622
2021-12-05 01:50:36.504518,2021-11-18 11:31:18-05:00,115,7ckvB1uchDPcA5vkjJvu4DHCkgGq81qbJrd4P2CwPDV8,pVjScFyTQfYJ74uA9JLEsChSrtY8fRi2dCM3jtWC6bp,True,12476212,3119053,19238,9619,9619,72FwbpFGoLEazJEdpqNtPNefsadUrimUqma9wSoy4qiS,769532,4283542,-3514010,616
2021-12-05 01:50:36.504518,2021-11-18 11:34:18-05:00,116,FpqCxvTkSiwDwD5qEt6hXJxzFDLFLAQ8VevK8zwRqYun,A3p6YQisCJKpNkF7vkjZRbEfbnUt7vTZdR2zPBUSdTkk,True,220586284,55146571,344080,172040,172040,72FwbpFGoLEazJEdpqNtPNefsadUrimUqma9wSoy4qiS,13763218,64195344,-50432126,623
2021-12-05 01:50:36.504518,2021-11-18 11:35:16-05:00,117,6meAnGTy2XNUDk9qSJZGT6BBRinA5iGiDYEy2T88LXuX,BCzNQCn3J1381yNH5xp5ky9QmVKVdSofSUaLHtxKxPBW,True,2290920,572730,3540,1770,1770,72FwbpFGoLEazJEdpqNtPNefsadUrimUqma9wSoy4qiS,141622,662711,-521089,618
2021-12-05 01:50:36.504518,2021-11-18 11:35:16-05:00,118,EDE1swNYZ99y9idZacAw5Ncwz2DyD78SqvKMUXA2Dbw4,HSmYYMpNQNr1F2zjvysGRrC57FyusAJNsaXWfbmCfZh4,True,65159844,16289961,100361,50180,50181,72FwbpFGoLEazJEdpqNtPNefsadUrimUqma9wSoy4qiS,4014451,22635175,-18620724,616
2021-12-05 01:50:36.504518,2021-11-18 11:35:17-05:00,119,DXZMRSKFgnNdiXHps2xzayuztJNH9EUUz2wkCCneXtW5,9Z2sUfTCZCkmw5n3HSsoLG992AcpJo2qxp7XpJnnBxZM,True,89304340,22326085,139393,69696,69697,72FwbpFGoLEazJEdpqNtPNefsadUrimUqma9wSoy4qiS,5575732,23933968,-18358236,624
2021-12-05 01:50:36.504518,2021-11-18 12:03:13-05:00,120,5F6M2rEMMvaFGWWCf8XioLucUfb7nnp96vx9BcbroVsD,EYxYvNkDPViCFpWt7nsnhU27BLNuMbikAV7tNjcs3fFe,True,31210620,7802655,48706,24353,24353,72FwbpFGoLEazJEdpqNtPNefsadUrimUqma9wSoy4qiS,1948263,9889813,-7941550,624
2021-12-05 01:50:36.504518,2021-11-18 12:07:14-05:00,121,FZhvN1RjLoBK9EpCeyEobYsvdHirtbTXV82c9EV9nn2u,FSeHqYNof79JYrRb7ZkJWEb4TfS5wx7HTdvT1kLCexHM,True,123917896,30979474,189729,94864,94865,72FwbpFGoLEazJEdpqNtPNefsadUrimUqma9wSoy4qiS,7589181,30069915,-22480734,612
2021-12-05 01:50:36.504518,2021-11-18 12:07:14-05:00,122,4xsYjVsPm2C2itNtJb3NYkBp4WySHUwtSbWdu9fge8wz,8zu2jMoTndZpf9khY9PMhve88LRwrKNTuVuLpa5ss8qo,True,1151164028,287791007,1774643,887321,887322,72FwbpFGoLEazJEdpqNtPNefsadUrimUqma9wSoy4qiS,70985752,326400030,-255414278,616
2021-12-05 01:50:36.504518,2021-11-18 12:07:16-05:00,123,3PmLtoHk5uuB5e6KNUqr9XaFiZYSMSB6yt1k5xzHUFUv,DyrVKXFMchomdbzRaK4CEwYwVMFbGYVja6hwGJQJvUMH,True,1064078010,266019502,1579329,789664,789665,72FwbpFGoLEazJEdpqNtPNefsadUrimUqma9wSoy4qiS,63173168,315415177,-252242009,593
2021-12-05 01:50:36.504518,2021-11-18 12:07:16-05:00,124,3XzkSrNTGd3Fhd4M3gYzvz2utbQpFN1fhtbAaZu7C39R,GMsZGGfktTzYi7GhD3W6HY9QY9bznqTKfeArksikLE71,True,15208879,3802219,23680,11840,11840,72FwbpFGoLEazJEdpqNtPNefsadUrimUqma9wSoy4qiS,947219,4112693,-3165474,622
2021-12-05 01:50:36.504518,2021-11-18 12:07:16-05:00,125,Gs3WP18hbzNpbBgiU39e6tfkggfCKRyNqPqJQcthuHFD,4XAY25YUma6gUdG2GdbXeivum3t21g93ZagfWGTZYkWZ,True,94249166,23562291,145701,72850,72851,72FwbpFGoLEazJEdpqNtPNefsadUrimUqma9wSoy4qiS,5828076,23597379,-17769303,618
2021-12-05 01:50:36.504518,2021-11-18 12:07:18-05:00,126,7zDNgPFeomS1hdQhuY8iGF3nnGMNnx1YrinZJetrefje,AKyG5R6Bac6Fu83ruL9FGpjKCfDKxbP6QfEGbCgqegiV,True,223344749,55836187,336898,168449,168449,72FwbpFGoLEazJEdpqNtPNefsadUrimUqma9wSoy4qiS,13475921,63038561,-49562640,603
2021-12-05 01:50:36.504518,2021-11-18 12:07:18-05:00,127,7DWHQdHp5svNzMwB6E5sStKHdHTw2jWwhK5pGHW8bjXg,EG3PvMxk7SP6J9aDwkPBBqtZYckFHWGTfsnK8nunhYka,True,58317218,14579304,86923,43461,43462,72FwbpFGoLEazJEdpqNtPNefsadUrimUqma9wSoy4qiS,3476939,16613142,-13136203,596
2021-12-05 01:50:36.504518,2021-11-18 12:07:20-05:00,128,HNCJ9xJCwy9rBzYHDF4AsE677ueQDGHS1riTGoBGdDgh,D8ZBxkpAFu877Lnsuazfyme3nB5cHYsSoDCUrMPMPLe3,True,83285395,20821348,124646,62323,62323,72FwbpFGoLEazJEdpqNtPNefsadUrimUqma9wSoy4qiS,4985850,27509246,-22523396,598
2021-12-05 01:50:36.504518,2021-11-18 12:07:25-05:00,129,26F7WDhDLwsFPgkeUDruwUiRn1R6SWS9rD3t33Tn1Ueq,88RtRiccENAcTo3hExVk9KgWhW5zrfGY175KN5EhnejY,True,167623450,41905862,254909,127454,127455,72FwbpFGoLEazJEdpqNtPNefsadUrimUqma9wSoy4qiS,10196364,52241888,-42045524,608
2021-12-05 01:50:36.504518,2021-11-18 12:08:18-05:00,130,57GUgfEp9ZQ5iAU2nx1Z2Tiz3gqq7yBNaqfE1cvxjFYt,98upivFa9Tdy3RZHGM1i2k5zeczaGqioq3rTzc3DMf4x,True,321374904,80343726,498619,249309,249310,72FwbpFGoLEazJEdpqNtPNefsadUrimUqma9wSoy4qiS,19944781,96843864,-76899083,620
2021-12-05 01:50:36.504518,2021-11-18 12:08:21-05:00,131,EFHg5FatMRRSZnKJPJF9e1iw2cjPJRmwTTZYtkHno9DP,84LnLKhZDJgWFnbBYnYjqWkjymemXfidecPFwnUAvuFj,True,747363707,186840926,1160460,580230,580230,72FwbpFGoLEazJEdpqNtPNefsadUrimUqma9wSoy4qiS,46418411,231058162,-184639751,621
2021-12-05 01:50:36.504518,2021-11-18 12:09:17-05:00,132,82ahWrNx6L73jAvzt4PAv7FuhwSdGqG4KqAZWD2uwEZt,2funPHa9Xi1hcgj7rHc7NHDYQ5HjgZ7UvbnZpet3u7kQ,True,24829146,6207286,38733,19366,19367,72FwbpFGoLEazJEdpqNtPNefsadUrimUqma9wSoy4qiS,1549347,9055632,-7506285,624
2021-12-05 01:50:36.504518,2021-11-18 12:09:17-05:00,133,EQYUWtYbtvN9C9ixiupXPjHyFWHsYa7dUh4DSd6rxbzt,iS616uGNCwCxP1taAvvdvA2KdqfXRSjcQWwZRUgBkLb,True,28990699,7247674,44938,22469,22469,72FwbpFGoLEazJEdpqNtPNefsadUrimUqma9wSoy4qiS,1797553,9038684,-7241131,620
2021-12-05 01:50:36.504518,2021-11-18 12:09:18-05:00,134,3A5AuwDWP4fT7RUqNBj51AxdS4uYkjEZmFYrykBJPp1X,GEXVPiMjcD2RS8jcEmo3k8CET3bJ8Fv3cAUn1ZwhxJy6,True,16812510597,4203127649,26050959,13025479,13025480,72FwbpFGoLEazJEdpqNtPNefsadUrimUqma9wSoy4qiS,1042038377,6406555163,-5364516786,619
2021-12-05 01:50:36.504518,2021-11-18 12:09:19-05:00,135,3Ek5j2ea8wS2nCxsNgn2AbovxzJwGK7zc6xarkigSA3u,DEWmTn3Ah4F3nNXpoQLt1GG65Dsf4ZmGjn7FZUJyK6rP,True,3837650532,959412633,5793050,2896525,2896525,72FwbpFGoLEazJEdpqNtPNefsadUrimUqma9wSoy4qiS,231722022,1190333774,-958611752,603
2021-12-05 01:50:36.504518,2021-11-18 12:09:20-05:00,136,66SjFhmiNYz8tLRnBhZUbowWGTbM16G52X3AT2hma2wN,3wVy8nk24HCFZWMiacGe8QsJquYaadZ9pQg44bGRwdE3,True,89053218,22263304,132392,66196,66196,72FwbpFGoLEazJEdpqNtPNefsadUrimUqma9wSoy4qiS,5295700,30337086,-25041386,594
2021-12-05 01:50:36.504518,2021-11-18 12:10:15-05:00,137,J2gTwrYpzezkRupgBtgudQn5D33x6WjeBhTHnrA1qgqa,FBzoHRwqGRjnMvPEpiZVjtGZYJmAbneE4dpToXPzy8bv,True,22857269773,5714317443,34713202,17356601,17356601,72FwbpFGoLEazJEdpqNtPNefsadUrimUqma9wSoy4qiS,1388528093,6777185060,-5388656967,607
2021-12-05 01:50:36.504518,2021-11-18 12:10:24-05:00,138,36ByQojnxEckWdQTjqHfxKqCx9yjqWQsPsZyqaN72UWR,AZoirtS1fjX61agRM64tqThVinnJTh3BWgiHyNHPTgZP,True,25227517,6306879,36354,18177,18177,72FwbpFGoLEazJEdpqNtPNefsadUrimUqma9wSoy4qiS,1454199,7867217,-6413018,576
2021-12-05 01:50:36.504518,2021-11-18 12:10:28-05:00,139,8d333AWdyiVhvkAdiKCTwhgzaPBMbn8mtucwUC1SAbZZ,3BM8UNLN7XGRaYRjezAqFVMr1z4PS3VRXiN1NAtvBuD9,True,266346246,66586561,368228,184114,184114,72FwbpFGoLEazJEdpqNtPNefsadUrimUqma9wSoy4qiS,14729151,77461439,-62732288,553
2021-12-05 01:50:36.504518,2021-11-18 12:10:28-05:00,140,BELLbzmdx1SYke9kZUxFi9VcdvwaHmkZyv24FArQ1J2f,5a5LfKakAaFEVkavVHgExKaUr25RWYpzFic6MUQQ62uc,True,4979291774,1244822943,7004760,3502380,3502380,72FwbpFGoLEazJEdpqNtPNefsadUrimUqma9wSoy4qiS,280190410,1559543262,-1279352852,562
2021-12-05 01:50:36.504518,2021-11-18 12:10:28-05:00,141,CQSb6ZVY1KVNXFAg8pxm8RvBBGGqRSU7FMvwHJPy46u8,FRBv3b5VTfKN1bK4DXFY4329LFbvm882P47edrgpuSM,True,2435265809,608816452,3382528,1691264,1691264,72FwbpFGoLEazJEdpqNtPNefsadUrimUqma9wSoy4qiS,135301127,618206723,-482905596,555
2021-12-05 01:50:36.504518,2021-11-18 12:10:31-05:00,142,HfRH3JeKFL399DkU3omcbiXjKvfdVq8YuXBN1rtrcwxz,3pgq9GHmS5DSUqwtPEAx5WgfHwAp65teUyTbnQVuq1UA,True,15464111,3866027,21291,10645,10646,72FwbpFGoLEazJEdpqNtPNefsadUrimUqma9wSoy4qiS,851669,4139498,-3287829,550
2021-12-05 01:50:36.504518,2021-11-18 12:10:32-05:00,143,8nXbrdjjaHB73CRPRenGEQj73wbtEFGDwXsehRGMhsap,43pvdcJ6f27wz94D6ZboKwRJYbyvYCrjsJhYsvk7LJCM,True,104128774,26032193,152534,76267,76267,72FwbpFGoLEazJEdpqNtPNefsadUrimUqma9wSoy4qiS,6101385,33526886,-27425501,585
2021-12-05 01:50:36.504518,2021-11-18 12:10:33-05:00,144,E5KDZriZ89a5D4VsMaWxndMMG68RT4weruJ1tCEc6tSx,CaSwkUocpbyyGCQBgKjJZJgcexbyqs2GTrGJH6EMWXAz,True,22818612463,5704653115,32690703,16345351,16345352,72FwbpFGoLEazJEdpqNtPNefsadUrimUqma9wSoy4qiS,1307628128,6734911979,-5427283851,573
2021-12-05 01:50:36.504518,2021-11-18 12:10:33-05:00,145,EvSdLa5PeJiaaaE3omJNG7cw1tptZnHTituYswVHSwm3,68ESX2mBsfxQo2U9jsbmHo7TzPTxr9mGH5Y11ZLR7E3A,True,335245530,83811382,450405,225202,225203,72FwbpFGoLEazJEdpqNtPNefsadUrimUqma9wSoy4qiS,18016217,104692788,-86676571,537
2021-12-05 01:50:36.504518,2021-11-18 12:10:35-05:00,146,AzmgakTxLAutgbcNkxi3S4M6MvuZvwcrzMc43ErMFk4h,7KR9xHmrpNDAuYo63YTTvWuaKsjbzF3bPTWDudsJK9oU,True,171402840,42850710,224019,112009,112010,72FwbpFGoLEazJEdpqNtPNefsadUrimUqma9wSoy4qiS,8960767,57869158,-48908391,522
2021-12-05 01:50:36.504518,2021-11-18 12:10:42-05:00,147,3BJxs1GkLhq2fri6KfiD7bdvx8ntCaSnhCkcmwpJvST8,HT9DNPcrs5JdheyKkBHjtzncg5Wf9axnSAVTtUHF3h9e,True,274668211,68667052,358717,179358,179359,72FwbpFGoLEazJEdpqNtPNefsadUrimUqma9wSoy4qiS,14348686,66283060,-51934374,522
2021-12-05 01:50:36.504518,2021-11-18 12:10:54-05:00,148,2XFYFxNQbCr5ao4cVzRZt45fsAwZc4jD9XTABmdqaJWd,CvpzBuDjyimaYFGWFkkBcaZGSRtAvtF6MtRV54mqZ74k,True,1668136,417034,2208,1104,1104,72FwbpFGoLEazJEdpqNtPNefsadUrimUqma9wSoy4qiS,88349,529224,-440875,529
2021-12-05 01:50:36.504518,2021-11-18 12:11:15-05:00,149,DSEgVqfxXp5wxjn3gNZtmb4E6rJeBm3VcbqdwDnsuzSq,6YVCWznUKheSMPuywSRJgCes7wghPGJXgxfrVfnjN4mB,True,1489636252,372409063,2289689,1144844,1144845,72FwbpFGoLEazJEdpqNtPNefsadUrimUqma9wSoy4qiS,91587560,354791718,-263204158,614
2021-12-05 01:50:36.504518,2021-11-18 12:11:15-05:00,150,J5WcVsKNHbfioai1LRowvjvtEmUJBEkeoBim1ThshpoP,Ajh7SWBq3zJR4vb6AFoBS6C9D99wC6YF1sVN22qC1vCA,True,27008659,6752164,41982,20991,20991,72FwbpFGoLEazJEdpqNtPNefsadUrimUqma9wSoy4qiS,1679308,8619760,-6940452,621
2021-12-05 01:50:36.504518,2021-11-18 12:11:18-05:00,151,7ckvB1uchDPcA5vkjJvu4DHCkgGq81qbJrd4P2CwPDV8,pVjScFyTQfYJ74uA9JLEsChSrtY8fRi2dCM3jtWC6bp,True,9162539,2290634,14010,7005,7005,72FwbpFGoLEazJEdpqNtPNefsadUrimUqma9wSoy4qiS,560423,3390565,-2830142,611
2021-12-05 01:50:36.504518,2021-11-18 12:11:18-05:00,152,9b5c6WqiKuBa6ARf1evmyrDZ8rYv2VCgjSDME7HFbzGk,65TnTCwZ8nTgu8CXXAMvjm6iZhdjwGxmWZnmAgWeebYM,True,292812254,73203063,443066,221533,221533,72FwbpFGoLEazJEdpqNtPNefsadUrimUqma9wSoy4qiS,17722642,84135258,-66412616,605
2021-12-05 01:50:36.504518,2021-11-18 12:11:24-05:00,153,3fB955q6xxxZcgnCyguLwkSa7egxgBoksPQVQ3U8HRHL,GK7cTdhfSpapJB8dFzEkV8c1UFkJPj281DwztnpKjxLx,True,213905975,53476493,330781,165390,165391,72FwbpFGoLEazJEdpqNtPNefsadUrimUqma9wSoy4qiS,13231252,79391964,-66160712,618
2021-12-05 01:50:36.504518,2021-11-18 12:11:28-05:00,154,CBEv8v9XZrgFT8UdEdd813XnRVv9R7GB5PLMyG8UWGC8,4uNcMEcQpJdThpisgNrttkQJTUFTsjEr25qgjkm4titC,True,632081677,158020419,965651,482825,482826,72FwbpFGoLEazJEdpqNtPNefsadUrimUqma9wSoy4qiS,38626066,235308679,-196682613,611
2021-12-05 01:50:36.504518,2021-11-18 12:12:20-05:00,155,FpqCxvTkSiwDwD5qEt6hXJxzFDLFLAQ8VevK8zwRqYun,A3p6YQisCJKpNkF7vkjZRbEfbnUt7vTZdR2zPBUSdTkk,True,161815904,40453976,246984,123492,123492,72FwbpFGoLEazJEdpqNtPNefsadUrimUqma9wSoy4qiS,9879381,51329979,-41450598,610
2021-12-05 01:50:36.504518,2021-11-18 12:12:21-05:00,156,EDE1swNYZ99y9idZacAw5Ncwz2DyD78SqvKMUXA2Dbw4,HSmYYMpNQNr1F2zjvysGRrC57FyusAJNsaXWfbmCfZh4,True,47850441,11962610,72987,36493,36494,72FwbpFGoLEazJEdpqNtPNefsadUrimUqma9wSoy4qiS,2919502,17904757,-14985255,610
2021-12-05 01:50:36.504518,2021-11-18 12:12:22-05:00,157,A9BZ5kjh7iKu7SMzA5WUF31Zst9V7fehwDZaoKs4NpSi,3FzwTaT5LYucvoGGcRVXu5AUDnGHADv6yGqrBT6jEtvH,True,896444058,224111014,1374848,687424,687424,72FwbpFGoLEazJEdpqNtPNefsadUrimUqma9wSoy4qiS,54993955,213548897,-158554942,613
2021-12-05 01:50:36.504518,2021-11-18 12:12:22-05:00,158,DXZMRSKFgnNdiXHps2xzayuztJNH9EUUz2wkCCneXtW5,9Z2sUfTCZCkmw5n3HSsoLG992AcpJo2qxp7XpJnnBxZM,True,65574196,16393549,101658,50829,50829,72FwbpFGoLEazJEdpqNtPNefsadUrimUqma9wSoy4qiS,4066345,19239517,-15173172,620
2021-12-05 01:50:36.504518,2021-11-18 12:12:37-05:00,159,6meAnGTy2XNUDk9qSJZGT6BBRinA5iGiDYEy2T88LXuX,BCzNQCn3J1381yNH5xp5ky9QmVKVdSofSUaLHtxKxPBW,True,1682291,420572,2576,1288,1288,72FwbpFGoLEazJEdpqNtPNefsadUrimUqma9wSoy4qiS,103056,529841,-426785,612
2021-12-05 01:50:36.504518,2021-11-18 12:13:15-05:00,160,8w4uRzN81cghupkF7jNLinGLtCqYwNQFgQtdJfC5so7z,BbbRkq85fYEBGmuxBEEPbt6up4GNB7WQ83VSXwe4ro98,True,9660833088,2415208272,14964396,7482198,7482198,72FwbpFGoLEazJEdpqNtPNefsadUrimUqma9wSoy4qiS,598575860,2298576936,-1700001076,619
2021-12-05 01:50:36.504518,2021-11-18 12:13:20-05:00,161,7zDNgPFeomS1hdQhuY8iGF3nnGMNnx1YrinZJetrefje,AKyG5R6Bac6Fu83ruL9FGpjKCfDKxbP6QfEGbCgqegiV,True,164408856,41102214,250982,125491,125491,72FwbpFGoLEazJEdpqNtPNefsadUrimUqma9wSoy4qiS,10039317,50313730,-40274413,610
2021-12-05 01:50:36.504518,2021-11-18 12:13:23-05:00,162,E6kVebJVmwutZmtjJ1erBzBq4C2yLrSyK1wWTXSeRkc,9HWMtKySmuhf8E5WLjZZLHhGweDL1tCvXMcVunBDaUtE,True,57978888,14494722,87717,43858,43859,72FwbpFGoLEazJEdpqNtPNefsadUrimUqma9wSoy4qiS,3508694,20529055,-17020361,605
2021-12-05 01:50:36.504518,2021-11-18 12:13:23-05:00,163,3PmLtoHk5uuB5e6KNUqr9XaFiZYSMSB6yt1k5xzHUFUv,DyrVKXFMchomdbzRaK4CEwYwVMFbGYVja6hwGJQJvUMH,True,783240408,195810102,1169393,584696,584697,72FwbpFGoLEazJEdpqNtPNefsadUrimUqma9wSoy4qiS,46775739,250837572,-204061833,597
2021-12-05 01:50:36.504518,2021-11-18 12:13:23-05:00,164,FYNnguyYqSVbToc4eDU9zJipCNy2ooz3nMN8AQuq4JzQ,FgkMfWga8jjrTGynPGghMsJHdP4d8wiT9s8xTrqGFaRv,True,67866714,16966678,101582,50791,50791,72FwbpFGoLEazJEdpqNtPNefsadUrimUqma9wSoy4qiS,4063314,16227090,-12163776,598
2021-12-05 01:50:36.504518,2021-11-18 12:13:27-05:00,165,7dSwoqvrbAn6zQ9stAtQEgsgqNze2szYLjuigAXEaapr,7G25dgArTKkpEvqAocVnVNPSAvbAAcogdeeBDak1qetD,True,156753964,39188491,236264,118132,118132,72FwbpFGoLEazJEdpqNtPNefsadUrimUqma9wSoy4qiS,9450560,20675961,-11225401,602
2021-12-05 01:50:36.504518,2021-11-18 12:13:28-05:00,166,5F6M2rEMMvaFGWWCf8XioLucUfb7nnp96vx9BcbroVsD,EYxYvNkDPViCFpWt7nsnhU27BLNuMbikAV7tNjcs3fFe,True,22874730,5718682,34158,17079,17079,72FwbpFGoLEazJEdpqNtPNefsadUrimUqma9wSoy4qiS,1366322,7855777,-6489455,597
2021-12-05 01:50:36.504518,2021-11-18 12:13:28-05:00,167,7DWHQdHp5svNzMwB6E5sStKHdHTw2jWwhK5pGHW8bjXg,EG3PvMxk7SP6J9aDwkPBBqtZYckFHWGTfsnK8nunhYka,True,42922508,10730627,64365,32182,32183,72FwbpFGoLEazJEdpqNtPNefsadUrimUqma9wSoy4qiS,2574610,13242410,-10667800,599
2021-12-05 01:50:36.504518,2021-11-18 12:13:29-05:00,168,FjDp4bWCtqehFD7FunCrjrcdxMezTJj5aqh2VnBvHDQU,HRYeZqcqhP1RPiAGXziR1qCWwk4sF6c5ZYbvSDhX7foN,True,860232907,215058226,1290663,645331,645332,72FwbpFGoLEazJEdpqNtPNefsadUrimUqma9wSoy4qiS,51626544,204926787,-153300243,600
2021-12-05 01:50:36.504518,2021-11-18 12:14:18-05:00,169,4xsYjVsPm2C2itNtJb3NYkBp4WySHUwtSbWdu9fge8wz,8zu2jMoTndZpf9khY9PMhve88LRwrKNTuVuLpa5ss8qo,True,846478482,211619620,1307914,653957,653957,72FwbpFGoLEazJEdpqNtPNefsadUrimUqma9wSoy4qiS,52316570,260843704,-208527134,618
2021-12-05 01:50:36.504518,2021-11-18 12:14:18-05:00,170,Gs3WP18hbzNpbBgiU39e6tfkggfCKRyNqPqJQcthuHFD,4XAY25YUma6gUdG2GdbXeivum3t21g93ZagfWGTZYkWZ,True,69306102,17326525,107540,53770,53770,72FwbpFGoLEazJEdpqNtPNefsadUrimUqma9wSoy4qiS,4301602,19009858,-14708256,620
2021-12-05 01:50:36.504518,2021-11-18 12:14:21-05:00,171,4M7XECgNotuYef6fXsB659bgvA4LBYq9WrUFZP8jEZ8q,EjF9ZKUaBWZodjKy7ET7rEyK1uSsKX2cvcd4eJSYarF8,True,336646336,84161584,513234,256617,256617,72FwbpFGoLEazJEdpqNtPNefsadUrimUqma9wSoy4qiS,20529393,80400907,-59871514,609
2021-12-05 01:50:36.504518,2021-11-18 12:14:23-05:00,172,FZhvN1RjLoBK9EpCeyEobYsvdHirtbTXV82c9EV9nn2u,FSeHqYNof79JYrRb7ZkJWEb4TfS5wx7HTdvT1kLCexHM,True,91093701,22773425,138868,69434,69434,72FwbpFGoLEazJEdpqNtPNefsadUrimUqma9wSoy4qiS,5554731,24260857,-18706126,609
2021-12-05 01:50:36.504518,2021-11-18 12:14:23-05:00,173,26F7WDhDLwsFPgkeUDruwUiRn1R6SWS9rD3t33Tn1Ueq,88RtRiccENAcTo3hExVk9KgWhW5zrfGY175KN5EhnejY,True,123347849,30836962,189292,94646,94646,72FwbpFGoLEazJEdpqNtPNefsadUrimUqma9wSoy4qiS,7571716,41477218,-33905502,613
2021-12-05 01:50:36.504518,2021-11-18 12:17:26-05:00,174,3XzkSrNTGd3Fhd4M3gYzvz2utbQpFN1fhtbAaZu7C39R,GMsZGGfktTzYi7GhD3W6HY9QY9bznqTKfeArksikLE71,True,11181106,2795276,17449,8724,8725,72FwbpFGoLEazJEdpqNtPNefsadUrimUqma9wSoy4qiS,697985,3297681,-2599696,624
2021-12-05 01:50:36.504518,2021-11-19 12:01:40-05:00,175,8w1hzDtCFuTJqWAtwihztrPzxwa7YrJH5uPk877SJnNj,D3gnctosqTZxTQNfLJQRdPgCvGx2JLLHHDmcvW5UX1QN,True,7268846152,1817211538,11334921,5667460,5667461,72FwbpFGoLEazJEdpqNtPNefsadUrimUqma9wSoy4qiS,453396869,1284313812,-830916943,623
2021-12-05 01:50:36.504518,2021-11-21 12:59:45-05:00,176,8w1hzDtCFuTJqWAtwihztrPzxwa7YrJH5uPk877SJnNj,D3gnctosqTZxTQNfLJQRdPgCvGx2JLLHHDmcvW5UX1QN,True,5543393732,1385848433,8489000,4244500,4244500,72FwbpFGoLEazJEdpqNtPNefsadUrimUqma9wSoy4qiS,339560036,1056469171,-716909135,612
2021-12-05 01:50:36.504518,2021-11-21 13:09:43-05:00,177,8w1hzDtCFuTJqWAtwihztrPzxwa7YrJH5uPk877SJnNj,D3gnctosqTZxTQNfLJQRdPgCvGx2JLLHHDmcvW5UX1QN,True,4233718340,1058429585,6372802,3186401,3186401,72FwbpFGoLEazJEdpqNtPNefsadUrimUqma9wSoy4qiS,254912100,869879282,-614967182,602
2021-12-05 01:50:36.504518,2021-11-21 13:34:45-05:00,178,8w1hzDtCFuTJqWAtwihztrPzxwa7YrJH5uPk877SJnNj,D3gnctosqTZxTQNfLJQRdPgCvGx2JLLHHDmcvW5UX1QN,True,3231728035,807932008,4802500,2401250,2401250,72FwbpFGoLEazJEdpqNtPNefsadUrimUqma9wSoy4qiS,192100018,710395718,-518295700,594
2021-12-05 01:50:36.504518,2021-11-21 15:37:45-05:00,179,8w1hzDtCFuTJqWAtwihztrPzxwa7YrJH5uPk877SJnNj,D3gnctosqTZxTQNfLJQRdPgCvGx2JLLHHDmcvW5UX1QN,True,2458851672,614712918,3828982,1914491,1914491,72FwbpFGoLEazJEdpqNtPNefsadUrimUqma9wSoy4qiS,153159300,577294696,-424135396,622
2021-12-05 01:50:36.504518,2021-11-26 03:37:59-05:00,180,Gwe1S7Wthi8pcNCzk1ttAvXwTUpBtfsEoDW5fMWRrPcW,B17Z5G2kPPLkGzhoXmjkjJoNDqPfahXg2gat2u5AmfEc,True,1178704336,294676084,1824478,912239,912239,72FwbpFGoLEazJEdpqNtPNefsadUrimUqma9wSoy4qiS,72979144,282722931,-209743787,619
2021-12-05 01:50:36.504518,2021-11-26 05:09:54-05:00,181,EmHwYySUTRtPZVsRfb3XsnjvGz7hygvp84YDHbx3yUTF,F9zeqPaZA21Kv4nAdfUpsYmX5Xo6M7DaTu24xYLSnsry,True,628830350,157207587,979872,489936,489936,72FwbpFGoLEazJEdpqNtPNefsadUrimUqma9wSoy4qiS,39194905,152676794,-113481889,623
2021-12-05 01:50:36.504518,2021-11-26 05:10:05-05:00,182,Gwe1S7Wthi8pcNCzk1ttAvXwTUpBtfsEoDW5fMWRrPcW,B17Z5G2kPPLkGzhoXmjkjJoNDqPfahXg2gat2u5AmfEc,True,867181735,216795433,1355723,677861,677862,72FwbpFGoLEazJEdpqNtPNefsadUrimUqma9wSoy4qiS,54228942,228454771,-174225829,625
2021-12-05 01:50:36.504518,2021-11-26 05:50:53-05:00,183,GSaQj6w7ssfDpMGzMQd4pyhZvLeGvYc1Vc9Qcsx1t69g,HSNX4PwuAAuUncgs11suc9rFJ6ntB8BRN7ViFYT9RATM,True,4405096173,1101274043,6696907,3348453,3348454,72FwbpFGoLEazJEdpqNtPNefsadUrimUqma9wSoy4qiS,267876295,1011944285,-744067990,608
2021-12-05 01:50:36.504518,2021-11-26 05:50:53-05:00,184,Hn2vg5sPj8WYVoh5H19rjBBcJQRWZfW3u7THZqu9AT8,4xvgBQuFQGaeJyVVjNEBiNhc6rWnjGGY5nxvZt2HBDAm,True,42955840,10738960,66140,33070,33070,72FwbpFGoLEazJEdpqNtPNefsadUrimUqma9wSoy4qiS,2645614,9894113,-7248499,615
2021-12-05 01:50:36.504518,2021-11-26 05:51:18-05:00,185,D9UqfagwAQjJt8f7pi3UM2tdj7EeyFHtYi7uTzvnnMQM,5ojof7CaDX2tPd3mRQfCxAkiZAu8h8V1hrGPzBPQ782E,True,2320133237,580033309,3609087,1804543,1804544,72FwbpFGoLEazJEdpqNtPNefsadUrimUqma9wSoy4qiS,144363489,536725721,-392362232,622
2021-12-05 01:50:36.504518,2021-11-26 05:51:18-05:00,186,EmHwYySUTRtPZVsRfb3XsnjvGz7hygvp84YDHbx3yUTF,F9zeqPaZA21Kv4nAdfUpsYmX5Xo6M7DaTu24xYLSnsry,True,460157210,115039302,668737,334368,334369,72FwbpFGoLEazJEdpqNtPNefsadUrimUqma9wSoy4qiS,26749480,123347048,-96597568,581
2021-12-05 01:50:36.504518,2021-11-26 05:51:18-05:00,187,2XFYFxNQbCr5ao4cVzRZt45fsAwZc4jD9XTABmdqaJWd,CvpzBuDjyimaYFGWFkkBcaZGSRtAvtF6MtRV54mqZ74k,True,1230957,307739,1876,938,938,72FwbpFGoLEazJEdpqNtPNefsadUrimUqma9wSoy4qiS,75055,425900,-350845,609
2021-12-05 01:50:36.504518,2021-11-26 05:51:18-05:00,188,3Ek5j2ea8wS2nCxsNgn2AbovxzJwGK7zc6xarkigSA3u,DEWmTn3Ah4F3nNXpoQLt1GG65Dsf4ZmGjn7FZUJyK6rP,True,2801583783,700395945,4247635,2123817,2123818,72FwbpFGoLEazJEdpqNtPNefsadUrimUqma9wSoy4qiS,169905404,966337426,-796432022,606
2021-12-05 01:50:36.504518,2021-11-26 05:51:18-05:00,189,8d333AWdyiVhvkAdiKCTwhgzaPBMbn8mtucwUC1SAbZZ,3BM8UNLN7XGRaYRjezAqFVMr1z4PS3VRXiN1NAtvBuD9,True,195752790,48938197,294877,147438,147439,72FwbpFGoLEazJEdpqNtPNefsadUrimUqma9wSoy4qiS,11795117,62855144,-51060027,602
2021-12-05 01:50:36.504518,2021-11-26 05:51:18-05:00,190,AzmgakTxLAutgbcNkxi3S4M6MvuZvwcrzMc43ErMFk4h,7KR9xHmrpNDAuYo63YTTvWuaKsjbzF3bPTWDudsJK9oU,True,126434831,31608707,188756,94378,94378,72FwbpFGoLEazJEdpqNtPNefsadUrimUqma9wSoy4qiS,7550241,46350547,-38800306,597
2021-12-05 01:50:36.504518,2021-11-26 05:51:18-05:00,191,CQSb6ZVY1KVNXFAg8pxm8RvBBGGqRSU7FMvwHJPy46u8,FRBv3b5VTfKN1bK4DXFY4329LFbvm882P47edrgpuSM,True,1791341932,447835483,2750103,1375051,1375052,72FwbpFGoLEazJEdpqNtPNefsadUrimUqma9wSoy4qiS,110004144,507608267,-397604123,614
2021-12-05 01:50:36.504518,2021-11-26 05:51:18-05:00,192,EvSdLa5PeJiaaaE3omJNG7cw1tptZnHTituYswVHSwm3,68ESX2mBsfxQo2U9jsbmHo7TzPTxr9mGH5Y11ZLR7E3A,True,247231576,61807894,379594,189797,189797,72FwbpFGoLEazJEdpqNtPNefsadUrimUqma9wSoy4qiS,15183784,84400122,-69216338,614
2021-12-05 01:50:36.504518,2021-11-26 05:51:18-05:00,193,HwMdPKabtCSiMZPhXGZjxMKg7RVwxfHSJGt6FW6XKKN5,4Wuu74hfqpRHY6sB55hzSgqEkK4G6oYXZv4ZA21LUckA,True,44944938135,11236234533,63721992,31860996,31860996,72FwbpFGoLEazJEdpqNtPNefsadUrimUqma9wSoy4qiS,2548879697,10943262497,-8394382800,567
2021-12-05 01:50:36.504518,2021-11-26 05:51:18-05:00,194,66SjFhmiNYz8tLRnBhZUbowWGTbM16G52X3AT2hma2wN,3wVy8nk24HCFZWMiacGe8QsJquYaadZ9pQg44bGRwdE3,True,64642426,16160606,87359,43679,43680,72FwbpFGoLEazJEdpqNtPNefsadUrimUqma9wSoy4qiS,3494360,24423349,-20928989,540
2021-12-05 01:50:36.504518,2021-11-26 05:51:18-05:00,195,57GUgfEp9ZQ5iAU2nx1Z2Tiz3gqq7yBNaqfE1cvxjFYt,98upivFa9Tdy3RZHGM1i2k5zeczaGqioq3rTzc3DMf4x,True,232412864,58103216,313711,156855,156856,72FwbpFGoLEazJEdpqNtPNefsadUrimUqma9wSoy4qiS,12548457,78846812,-66298355,539
2021-12-05 01:50:36.504518,2021-11-26 05:51:18-05:00,196,82ahWrNx6L73jAvzt4PAv7FuhwSdGqG4KqAZWD2uwEZt,2funPHa9Xi1hcgj7rHc7NHDYQ5HjgZ7UvbnZpet3u7kQ,True,17973608,4493402,24885,12442,12443,72FwbpFGoLEazJEdpqNtPNefsadUrimUqma9wSoy4qiS,995423,7273491,-6278068,553
2021-12-05 01:50:36.504518,2021-11-26 05:51:19-05:00,197,EQYUWtYbtvN9C9ixiupXPjHyFWHsYa7dUh4DSd6rxbzt,iS616uGNCwCxP1taAvvdvA2KdqfXRSjcQWwZRUgBkLb,True,20986121,5246530,28776,14388,14388,72FwbpFGoLEazJEdpqNtPNefsadUrimUqma9wSoy4qiS,1151074,7338905,-6187831,548
2021-12-05 01:50:36.504518,2021-11-26 05:51:19-05:00,198,5kwvkEtRFFD84j4ntVgxkacadgJaFvQ9JLhJqzLR7Y3G,GpMMkTv9T7y8DTiizuoJUsWvnSk3GSxADjRMGyYpryxm,False,422806258,422806258,21076744,1053837,20022907,72FwbpFGoLEazJEdpqNtPNefsadUrimUqma9wSoy4qiS,21076744,101135727,-80058983,498
2021-12-05 01:50:36.504518,2021-11-26 06:09:05-05:00,199,BELLbzmdx1SYke9kZUxFi9VcdvwaHmkZyv24FArQ1J2f,5a5LfKakAaFEVkavVHgExKaUr25RWYpzFic6MUQQ62uc,True,3663995297,915998824,5698510,2849255,2849255,72FwbpFGoLEazJEdpqNtPNefsadUrimUqma9wSoy4qiS,227940430,1259320682,-1031380252,622
2021-12-05 01:50:36.504518,2021-11-26 06:13:54-05:00,200,8nXbrdjjaHB73CRPRenGEQj73wbtEFGDwXsehRGMhsap,43pvdcJ6f27wz94D6ZboKwRJYbyvYCrjsJhYsvk7LJCM,True,76354170,19088542,118343,59171,59172,72FwbpFGoLEazJEdpqNtPNefsadUrimUqma9wSoy4qiS,4733725,27045896,-22312171,619
2021-12-05 01:50:36.504518,2021-11-27 21:28:01-05:00,201,E5KDZriZ89a5D4VsMaWxndMMG68RT4weruJ1tCEc6tSx,CaSwkUocpbyyGCQBgKjJZJgcexbyqs2GTrGJH6EMWXAz,True,16882488982,4220622245,26315883,13157941,13157942,72FwbpFGoLEazJEdpqNtPNefsadUrimUqma9wSoy4qiS,1052635330,5383403449,-4330768119,623
2021-12-05 01:50:36.504518,2021-11-27 21:28:12-05:00,202,J2gTwrYpzezkRupgBtgudQn5D33x6WjeBhTHnrA1qgqa,FBzoHRwqGRjnMvPEpiZVjtGZYJmAbneE4dpToXPzy8bv,True,16816260223,4204065055,25906827,12953413,12953414,72FwbpFGoLEazJEdpqNtPNefsadUrimUqma9wSoy4qiS,1036273099,5433288949,-4397015850,616
2021-12-05 01:50:36.504518,2021-11-27 21:28:26-05:00,203,3fB955q6xxxZcgnCyguLwkSa7egxgBoksPQVQ3U8HRHL,GK7cTdhfSpapJB8dFzEkV8c1UFkJPj281DwztnpKjxLx,True,157252477,39313119,245220,122610,122610,72FwbpFGoLEazJEdpqNtPNefsadUrimUqma9wSoy4qiS,9808839,62609104,-52800265,623
2021-12-05 01:50:36.504518,2021-11-27 21:28:26-05:00,204,CBEv8v9XZrgFT8UdEdd813XnRVv9R7GB5PLMyG8UWGC8,4uNcMEcQpJdThpisgNrttkQJTUFTsjEr25qgjkm4titC,True,464700412,116175103,713797,356898,356899,72FwbpFGoLEazJEdpqNtPNefsadUrimUqma9wSoy4qiS,28551881,185448145,-156896264,614
2021-12-05 01:50:36.504518,2021-11-27 21:28:28-05:00,205,7ckvB1uchDPcA5vkjJvu4DHCkgGq81qbJrd4P2CwPDV8,pVjScFyTQfYJ74uA9JLEsChSrtY8fRi2dCM3jtWC6bp,True,6735544,1683886,10342,5171,5171,72FwbpFGoLEazJEdpqNtPNefsadUrimUqma9wSoy4qiS,413708,2672699,-2258991,614
2021-12-05 01:50:36.504518,2021-11-27 21:38:37-05:00,206,FpqCxvTkSiwDwD5qEt6hXJxzFDLFLAQ8VevK8zwRqYun,A3p6YQisCJKpNkF7vkjZRbEfbnUt7vTZdR2zPBUSdTkk,True,119032256,29758064,184185,92092,92093,72FwbpFGoLEazJEdpqNtPNefsadUrimUqma9wSoy4qiS,7367434,40786575,-33419141,618
2021-12-05 01:50:36.504518,2021-11-27 21:38:37-05:00,207,EDE1swNYZ99y9idZacAw5Ncwz2DyD78SqvKMUXA2Dbw4,HSmYYMpNQNr1F2zjvysGRrC57FyusAJNsaXWfbmCfZh4,True,35198590,8799647,54410,27205,27205,72FwbpFGoLEazJEdpqNtPNefsadUrimUqma9wSoy4qiS,2176409,14104727,-11928318,618
2021-12-05 01:50:36.504518,2021-11-27 21:38:38-05:00,208,GSaQj6w7ssfDpMGzMQd4pyhZvLeGvYc1Vc9Qcsx1t69g,HSNX4PwuAAuUncgs11suc9rFJ6ntB8BRN7ViFYT9RATM,True,3268252792,817063198,5081493,2540746,2540747,72FwbpFGoLEazJEdpqNtPNefsadUrimUqma9wSoy4qiS,203259736,797886797,-594627061,621
2021-12-05 01:50:36.504518,2021-11-27 21:38:49-05:00,209,6meAnGTy2XNUDk9qSJZGT6BBRinA5iGiDYEy2T88LXuX,BCzNQCn3J1381yNH5xp5ky9QmVKVdSofSUaLHtxKxPBW,True,1237035,309258,1911,955,956,72FwbpFGoLEazJEdpqNtPNefsadUrimUqma9wSoy4qiS,76468,421259,-344791,618
2021-12-05 01:50:36.504518,2021-11-27 21:38:49-05:00,210,A9BZ5kjh7iKu7SMzA5WUF31Zst9V7fehwDZaoKs4NpSi,3FzwTaT5LYucvoGGcRVXu5AUDnGHADv6yGqrBT6jEtvH,True,659234170,164808542,1021970,510985,510985,72FwbpFGoLEazJEdpqNtPNefsadUrimUqma9wSoy4qiS,40878806,172936235,-132057429,620
2021-12-05 01:50:36.504518,2021-11-27 21:41:37-05:00,211,J5WcVsKNHbfioai1LRowvjvtEmUJBEkeoBim1ThshpoP,Ajh7SWBq3zJR4vb6AFoBS6C9D99wC6YF1sVN22qC1vCA,True,662377377,165594344,1023990,511995,511995,72FwbpFGoLEazJEdpqNtPNefsadUrimUqma9wSoy4qiS,40959621,106410401,-65450780,618
2021-12-05 01:50:36.504518,2021-11-27 21:41:38-05:00,212,BpvWyveup3q7q6Cws5TWkFYiZ8bQXRrfdxvzrN9FnYo6,2CWjropYSn9fJ66FT4zqUcwTrEaPp3CjGgoRATixyca1,True,187924699,46981174,250041,125020,125021,72FwbpFGoLEazJEdpqNtPNefsadUrimUqma9wSoy4qiS,10001661,42072145,-32070484,532
2021-12-05 01:50:36.504518,2021-11-27 21:41:38-05:00,213,57GUgfEp9ZQ5iAU2nx1Z2Tiz3gqq7yBNaqfE1cvxjFYt,98upivFa9Tdy3RZHGM1i2k5zeczaGqioq3rTzc3DMf4x,True,172831272,43207818,239024,119512,119512,72FwbpFGoLEazJEdpqNtPNefsadUrimUqma9wSoy4qiS,9560994,60766274,-51205280,553
2021-12-05 01:50:36.504518,2021-11-27 21:41:38-05:00,214,EvSdLa5PeJiaaaE3omJNG7cw1tptZnHTituYswVHSwm3,68ESX2mBsfxQo2U9jsbmHo7TzPTxr9mGH5Y11ZLR7E3A,True,182865501,45716375,274530,137265,137265,72FwbpFGoLEazJEdpqNtPNefsadUrimUqma9wSoy4qiS,10981203,65455176,-54473973,600
2021-12-05 01:50:36.504518,2021-11-27 21:41:38-05:00,215,D9UqfagwAQjJt8f7pi3UM2tdj7EeyFHtYi7uTzvnnMQM,5ojof7CaDX2tPd3mRQfCxAkiZAu8h8V1hrGPzBPQ782E,True,1714912479,428728119,2592524,1296262,1296262,72FwbpFGoLEazJEdpqNtPNefsadUrimUqma9wSoy4qiS,103700994,423440667,-319739673,604
2021-12-05 01:50:36.504518,2021-11-27 21:41:38-05:00,216,FZhvN1RjLoBK9EpCeyEobYsvdHirtbTXV82c9EV9nn2u,FSeHqYNof79JYrRb7ZkJWEb4TfS5wx7HTdvT1kLCexHM,True,66524049,16631012,91406,45703,45703,72FwbpFGoLEazJEdpqNtPNefsadUrimUqma9wSoy4qiS,3656248,19482532,-15826284,549
2021-12-05 01:50:36.504518,2021-11-27 21:41:38-05:00,217,4xsYjVsPm2C2itNtJb3NYkBp4WySHUwtSbWdu9fge8wz,8zu2jMoTndZpf9khY9PMhve88LRwrKNTuVuLpa5ss8qo,True,618127687,154531921,865443,432721,432722,72FwbpFGoLEazJEdpqNtPNefsadUrimUqma9wSoy4qiS,34617723,207784318,-173166595,560
2021-12-05 01:50:36.504518,2021-11-27 21:41:38-05:00,218,3Ek5j2ea8wS2nCxsNgn2AbovxzJwGK7zc6xarkigSA3u,DEWmTn3Ah4F3nNXpoQLt1GG65Dsf4ZmGjn7FZUJyK6rP,True,2070983098,517745774,3027949,1513974,1513975,72FwbpFGoLEazJEdpqNtPNefsadUrimUqma9wSoy4qiS,121117977,749096115,-627978138,584
2021-12-05 01:50:36.504518,2021-11-27 21:41:38-05:00,219,Hn2vg5sPj8WYVoh5H19rjBBcJQRWZfW3u7THZqu9AT8,4xvgBQuFQGaeJyVVjNEBiNhc6rWnjGGY5nxvZt2HBDAm,True,31470181,7867545,40374,20187,20187,72FwbpFGoLEazJEdpqNtPNefsadUrimUqma9wSoy4qiS,1614996,7798198,-6183202,513
2021-12-05 01:50:36.504518,2021-11-27 21:41:38-05:00,220,8w4uRzN81cghupkF7jNLinGLtCqYwNQFgQtdJfC5so7z,BbbRkq85fYEBGmuxBEEPbt6up4GNB7WQ83VSXwe4ro98,True,7045459660,1761364915,9683291,4841645,4841646,72FwbpFGoLEazJEdpqNtPNefsadUrimUqma9wSoy4qiS,387331664,1867415983,-1480084319,549
2021-12-05 01:50:36.504518,2021-11-27 21:41:38-05:00,221,66SjFhmiNYz8tLRnBhZUbowWGTbM16G52X3AT2hma2wN,3wVy8nk24HCFZWMiacGe8QsJquYaadZ9pQg44bGRwdE3,True,48000776,12000194,64837,32418,32419,72FwbpFGoLEazJEdpqNtPNefsadUrimUqma9wSoy4qiS,2593499,18771540,-16178041,540
2021-12-05 01:50:36.504518,2021-11-27 21:41:38-05:00,222,3XzkSrNTGd3Fhd4M3gYzvz2utbQpFN1fhtbAaZu7C39R,GMsZGGfktTzYi7GhD3W6HY9QY9bznqTKfeArksikLE71,True,8157048,2039262,11406,5703,5703,72FwbpFGoLEazJEdpqNtPNefsadUrimUqma9wSoy4qiS,456248,2634816,-2178568,559
2021-12-05 01:50:36.504518,2021-11-27 21:41:38-05:00,223,4M7XECgNotuYef6fXsB659bgvA4LBYq9WrUFZP8jEZ8q,EjF9ZKUaBWZodjKy7ET7rEyK1uSsKX2cvcd4eJSYarF8,True,245553126,61388281,330496,165248,165248,72FwbpFGoLEazJEdpqNtPNefsadUrimUqma9wSoy4qiS,13219842,65061156,-51841314,538
2021-12-05 01:50:36.504518,2021-11-27 21:41:38-05:00,224,C24que1C7tC3ysDSKhcBTF9NUnjiNhSanWp8Go5FRRb8,hgm3qRRG2njhNPWcUp9UnEU8pyg4gLaR2K13r4Lsqxm,True,662918858,165729714,909355,454677,454678,72FwbpFGoLEazJEdpqNtPNefsadUrimUqma9wSoy4qiS,36374228,173455370,-137081142,548
2021-12-05 01:50:36.504518,2021-11-27 21:41:38-05:00,225,Gs3WP18hbzNpbBgiU39e6tfkggfCKRyNqPqJQcthuHFD,4XAY25YUma6gUdG2GdbXeivum3t21g93ZagfWGTZYkWZ,True,50544988,12636247,69683,34841,34842,72FwbpFGoLEazJEdpqNtPNefsadUrimUqma9wSoy4qiS,2787327,15253424,-12466097,551
2021-12-05 01:50:36.504518,2021-11-27 21:41:38-05:00,226,3t7w8ABEfDYRKp5fLeTJF2jGKWPkgYifD63jSYbvrLrw,DdoegKd6nEoX385sxZtbMWCEUftL9mHVkkQgG1ywdKGh,True,6777110333,1694277583,9699511,4849755,4849756,72FwbpFGoLEazJEdpqNtPNefsadUrimUqma9wSoy4qiS,387980452,1516730352,-1128749900,572
2021-12-05 01:50:36.504518,2021-11-27 21:41:38-05:00,227,8d333AWdyiVhvkAdiKCTwhgzaPBMbn8mtucwUC1SAbZZ,3BM8UNLN7XGRaYRjezAqFVMr1z4PS3VRXiN1NAtvBuD9,True,144413584,36103396,202451,101225,101226,72FwbpFGoLEazJEdpqNtPNefsadUrimUqma9wSoy4qiS,8098051,48796273,-40698222,560
2021-12-05 01:50:36.504518,2021-11-27 21:41:38-05:00,228,E6kVebJVmwutZmtjJ1erBzBq4C2yLrSyK1wWTXSeRkc,9HWMtKySmuhf8E5WLjZZLHhGweDL1tCvXMcVunBDaUtE,True,42206277,10551569,54159,27079,27080,72FwbpFGoLEazJEdpqNtPNefsadUrimUqma9wSoy4qiS,2166366,16209745,-14043379,513
2021-12-05 01:50:36.504518,2021-11-27 21:41:38-05:00,229,GJvu3coUrkqTGMomAKmNdRqKaEaZrhLss3KUFpdcsr6F,FTKCbVVJYqyMXxoW3AMhZcCj1gHdpQMyuRuJq4KUVB6W,True,9904167798,2476041949,12526453,6263226,6263227,72FwbpFGoLEazJEdpqNtPNefsadUrimUqma9wSoy4qiS,501058156,2157990225,-1656932069,505
2021-12-05 01:50:36.504518,2021-11-27 21:41:38-05:00,230,EQYUWtYbtvN9C9ixiupXPjHyFWHsYa7dUh4DSd6rxbzt,iS616uGNCwCxP1taAvvdvA2KdqfXRSjcQWwZRUgBkLb,True,15550505,3887626,20631,10315,10316,72FwbpFGoLEazJEdpqNtPNefsadUrimUqma9wSoy4qiS,825277,5655306,-4830029,530
2021-12-05 01:50:36.504518,2021-11-27 21:41:38-05:00,231,8DKsQyYNJFCzNnHSQMYb6fPnirYJ2rFp5ws3WHW7xU8x,D8gtj4otCcNcRiJn54raBTEf2E5HNf9d9ozuoL9hSiCg,True,9313172366,2328293091,12432636,6216318,6216318,72FwbpFGoLEazJEdpqNtPNefsadUrimUqma9wSoy4qiS,497305455,2022547385,-1525241930,533
2021-12-05 01:50:36.504518,2021-11-27 21:41:38-05:00,232,EmHwYySUTRtPZVsRfb3XsnjvGz7hygvp84YDHbx3yUTF,F9zeqPaZA21Kv4nAdfUpsYmX5Xo6M7DaTu24xYLSnsry,True,338563675,84640918,429344,214672,214672,72FwbpFGoLEazJEdpqNtPNefsadUrimUqma9wSoy4qiS,17173760,96187619,-79013859,507
2021-12-05 01:50:36.504518,2021-11-27 21:41:38-05:00,233,6RkvJTPLnRHhdfat6yP9Jd8QWrC6ad8c9oEygRgpg2Li,14UWcWSMirA7yAaW36BxGuvdYTAqNoxL1YKcstXQmGD5,True,106619814,26654953,144544,72272,72272,72FwbpFGoLEazJEdpqNtPNefsadUrimUqma9wSoy4qiS,5781775,23539303,-17757528,542
2021-12-05 01:50:36.504518,2021-11-27 21:41:38-05:00,234,CQSb6ZVY1KVNXFAg8pxm8RvBBGGqRSU7FMvwHJPy46u8,FRBv3b5VTfKN1bK4DXFY4329LFbvm882P47edrgpuSM,True,1318694892,329673723,1831898,915949,915949,72FwbpFGoLEazJEdpqNtPNefsadUrimUqma9wSoy4qiS,73275953,396465460,-323189507,555
2021-12-05 01:50:36.504518,2021-11-27 21:41:38-05:00,235,HwMdPKabtCSiMZPhXGZjxMKg7RVwxfHSJGt6FW6XKKN5,4Wuu74hfqpRHY6sB55hzSgqEkK4G6oYXZv4ZA21LUckA,True,33259121260,8314780313,45103062,22551531,22551531,72FwbpFGoLEazJEdpqNtPNefsadUrimUqma9wSoy4qiS,1804122504,8654434726,-6850312222,542
2021-12-05 01:50:36.504518,2021-11-27 21:41:39-05:00,236,82ahWrNx6L73jAvzt4PAv7FuhwSdGqG4KqAZWD2uwEZt,2funPHa9Xi1hcgj7rHc7NHDYQ5HjgZ7UvbnZpet3u7kQ,False,13248043,13248043,645933,32296,613637,72FwbpFGoLEazJEdpqNtPNefsadUrimUqma9wSoy4qiS,645933,5586735,-4940802,487
2021-12-05 01:50:36.504518,2021-11-27 21:41:39-05:00,237,DXZMRSKFgnNdiXHps2xzayuztJNH9EUUz2wkCCneXtW5,9Z2sUfTCZCkmw5n3HSsoLG992AcpJo2qxp7XpJnnBxZM,False,47266644,47266644,2076909,103845,1973064,72FwbpFGoLEazJEdpqNtPNefsadUrimUqma9wSoy4qiS,2076909,15371058,-13294149,439
2021-12-05 01:50:36.504518,2021-11-27 21:41:39-05:00,238,5F6M2rEMMvaFGWWCf8XioLucUfb7nnp96vx9BcbroVsD,EYxYvNkDPViCFpWt7nsnhU27BLNuMbikAV7tNjcs3fFe,False,16554209,16554209,739510,36975,702535,72FwbpFGoLEazJEdpqNtPNefsadUrimUqma9wSoy4qiS,739510,6208482,-5468972,446
2021-12-05 01:50:36.504518,2021-11-27 21:41:39-05:00,239,7dSwoqvrbAn6zQ9stAtQEgsgqNze2szYLjuigAXEaapr,7G25dgArTKkpEvqAocVnVNPSAvbAAcogdeeBDak1qetD,False,113439993,113439993,5151760,257588,4894172,72FwbpFGoLEazJEdpqNtPNefsadUrimUqma9wSoy4qiS,5151760,17697491,-12545731,454
2021-12-05 01:50:36.504518,2021-11-27 21:41:39-05:00,240,BELLbzmdx1SYke9kZUxFi9VcdvwaHmkZyv24FArQ1J2f,5a5LfKakAaFEVkavVHgExKaUr25RWYpzFic6MUQQ62uc,True,2687462730,671865682,3606857,1803428,1803429,72FwbpFGoLEazJEdpqNtPNefsadUrimUqma9wSoy4qiS,144274302,979110070,-834835768,536
2021-12-05 01:50:36.504518,2021-11-27 21:41:39-05:00,241,2XFYFxNQbCr5ao4cVzRZt45fsAwZc4jD9XTABmdqaJWd,CvpzBuDjyimaYFGWFkkBcaZGSRtAvtF6MtRV54mqZ74k,True,902468,225617,1153,576,577,72FwbpFGoLEazJEdpqNtPNefsadUrimUqma9wSoy4qiS,46135,330069,-283934,511
2021-12-05 01:50:36.504518,2021-11-27 21:41:40-05:00,242,E6kVebJVmwutZmtjJ1erBzBq4C2yLrSyK1wWTXSeRkc,9HWMtKySmuhf8E5WLjZZLHhGweDL1tCvXMcVunBDaUtE,True,31468311,7867077,48145,24072,24073,72FwbpFGoLEazJEdpqNtPNefsadUrimUqma9wSoy4qiS,1925810,12644887,-10719077,611
2021-12-05 01:50:36.504518,2021-11-27 21:41:40-05:00,243,GJvu3coUrkqTGMomAKmNdRqKaEaZrhLss3KUFpdcsr6F,FTKCbVVJYqyMXxoW3AMhZcCj1gHdpQMyuRuJq4KUVB6W,True,7393817919,1848454479,11355594,5677797,5677797,72FwbpFGoLEazJEdpqNtPNefsadUrimUqma9wSoy4qiS,454223773,1736380457,-1282156684,614
2021-12-05 01:50:36.504518,2021-11-27 21:41:40-05:00,244,EmHwYySUTRtPZVsRfb3XsnjvGz7hygvp84YDHbx3yUTF,F9zeqPaZA21Kv4nAdfUpsYmX5Xo6M7DaTu24xYLSnsry,True,252817525,63204381,390979,195489,195490,72FwbpFGoLEazJEdpqNtPNefsadUrimUqma9wSoy4qiS,15639184,76011230,-60372046,618
2021-12-05 01:50:36.504518,2021-11-27 21:41:40-05:00,245,BpvWyveup3q7q6Cws5TWkFYiZ8bQXRrfdxvzrN9FnYo6,2CWjropYSn9fJ66FT4zqUcwTrEaPp3CjGgoRATixyca1,True,139663703,34915925,211794,105897,105897,72FwbpFGoLEazJEdpqNtPNefsadUrimUqma9wSoy4qiS,8471798,33806349,-25334551,606
2021-12-05 01:50:36.504518,2021-11-27 21:41:41-05:00,246,Hn2vg5sPj8WYVoh5H19rjBBcJQRWZfW3u7THZqu9AT8,4xvgBQuFQGaeJyVVjNEBiNhc6rWnjGGY5nxvZt2HBDAm,True,23401509,5850377,34337,17168,17169,72FwbpFGoLEazJEdpqNtPNefsadUrimUqma9wSoy4qiS,1373495,6212083,-4838588,586
2021-12-05 01:50:36.504518,2021-11-27 21:41:49-05:00,247,EDE1swNYZ99y9idZacAw5Ncwz2DyD78SqvKMUXA2Dbw4,HSmYYMpNQNr1F2zjvysGRrC57FyusAJNsaXWfbmCfZh4,True,25879088,6469772,40053,20026,20027,72FwbpFGoLEazJEdpqNtPNefsadUrimUqma9wSoy4qiS,1602144,11068314,-9466170,619
2021-12-05 01:50:36.504518,2021-11-27 21:41:49-05:00,248,J2gTwrYpzezkRupgBtgudQn5D33x6WjeBhTHnrA1qgqa,FBzoHRwqGRjnMvPEpiZVjtGZYJmAbneE4dpToXPzy8bv,True,12351029987,3087757496,18730027,9365013,9365014,72FwbpFGoLEazJEdpqNtPNefsadUrimUqma9wSoy4qiS,749201091,4324038227,-3574837136,606
2021-12-05 01:50:36.504518,2021-11-27 21:41:50-05:00,249,DSEgVqfxXp5wxjn3gNZtmb4E6rJeBm3VcbqdwDnsuzSq,6YVCWznUKheSMPuywSRJgCes7wghPGJXgxfrVfnjN4mB,True,1424459465,356114866,2012110,1006055,1006055,72FwbpFGoLEazJEdpqNtPNefsadUrimUqma9wSoy4qiS,80484428,318892896,-238408468,565
2021-12-05 01:50:36.504518,2021-11-27 21:41:50-05:00,250,3fB955q6xxxZcgnCyguLwkSa7egxgBoksPQVQ3U8HRHL,GK7cTdhfSpapJB8dFzEkV8c1UFkJPj281DwztnpKjxLx,True,115271115,28817778,172384,86192,86192,72FwbpFGoLEazJEdpqNtPNefsadUrimUqma9wSoy4qiS,6895376,49165332,-42269956,598
2021-12-05 01:50:36.504518,2021-11-27 21:41:50-05:00,251,CDwRuL5cpwTTFEskmrZNNzBfmaLyJ4i1Z9vs9iJANpk8,4MNxu9upSbkx4B2QzVomDxSknNjce8hVKFbF23m5JYS2,True,201649928,50412482,303779,151889,151890,72FwbpFGoLEazJEdpqNtPNefsadUrimUqma9wSoy4qiS,12151188,44955238,-32804050,602
2021-12-05 01:50:36.504518,2021-11-27 21:41:50-05:00,252,A9BZ5kjh7iKu7SMzA5WUF31Zst9V7fehwDZaoKs4NpSi,3FzwTaT5LYucvoGGcRVXu5AUDnGHADv6yGqrBT6jEtvH,True,484097863,121024465,738226,369113,369113,72FwbpFGoLEazJEdpqNtPNefsadUrimUqma9wSoy4qiS,29529071,138923201,-109394130,609
2021-12-05 01:50:36.504518,2021-11-27 21:41:50-05:00,253,6meAnGTy2XNUDk9qSJZGT6BBRinA5iGiDYEy2T88LXuX,BCzNQCn3J1381yNH5xp5ky9QmVKVdSofSUaLHtxKxPBW,True,908313,227078,1377,688,689,72FwbpFGoLEazJEdpqNtPNefsadUrimUqma9wSoy4qiS,55093,333203,-278110,606
2021-12-05 01:50:36.504518,2021-11-27 21:41:51-05:00,254,8nXbrdjjaHB73CRPRenGEQj73wbtEFGDwXsehRGMhsap,43pvdcJ6f27wz94D6ZboKwRJYbyvYCrjsJhYsvk7LJCM,True,56101946,14025486,77185,38592,38593,72FwbpFGoLEazJEdpqNtPNefsadUrimUqma9wSoy4qiS,3087401,20985567,-17898166,550
2021-12-05 01:50:36.504518,2021-11-27 21:41:51-05:00,255,E5KDZriZ89a5D4VsMaWxndMMG68RT4weruJ1tCEc6tSx,CaSwkUocpbyyGCQBgKjJZJgcexbyqs2GTrGJH6EMWXAz,True,12353508034,3088377008,17949018,8974509,8974509,72FwbpFGoLEazJEdpqNtPNefsadUrimUqma9wSoy4qiS,717960744,4290352465,-3572391721,581
2021-12-05 01:50:36.504518,2021-11-27 21:41:51-05:00,256,7ckvB1uchDPcA5vkjJvu4DHCkgGq81qbJrd4P2CwPDV8,pVjScFyTQfYJ74uA9JLEsChSrtY8fRi2dCM3jtWC6bp,True,4931543,1232885,7081,3540,3541,72FwbpFGoLEazJEdpqNtPNefsadUrimUqma9wSoy4qiS,283251,2097618,-1814367,574
2021-12-05 01:50:36.504518,2021-11-27 21:41:51-05:00,257,FpqCxvTkSiwDwD5qEt6hXJxzFDLFLAQ8VevK8zwRqYun,A3p6YQisCJKpNkF7vkjZRbEfbnUt7vTZdR2zPBUSdTkk,True,87277072,21819268,129653,64826,64827,72FwbpFGoLEazJEdpqNtPNefsadUrimUqma9wSoy4qiS,5186129,32248445,-27062316,594
2021-12-05 01:50:36.504518,2021-11-27 21:41:51-05:00,258,CBEv8v9XZrgFT8UdEdd813XnRVv9R7GB5PLMyG8UWGC8,4uNcMEcQpJdThpisgNrttkQJTUFTsjEr25qgjkm4titC,True,340288184,85072046,490023,245011,245012,72FwbpFGoLEazJEdpqNtPNefsadUrimUqma9wSoy4qiS,19600959,145523197,-125922238,576
2021-12-05 01:50:36.504518,2021-11-27 21:41:51-05:00,259,8Xdf67Q5jXKwS52e492xUBu1tMUgS14jJg7V4R2Q28EP,GAPL3bsXP4xcukhgzyqrbDntGwUSm5BfuwJ8TLKkRaZc,True,681146373,170286593,915796,457898,457898,72FwbpFGoLEazJEdpqNtPNefsadUrimUqma9wSoy4qiS,36631853,163206767,-126574914,537
2021-12-05 01:50:36.504518,2021-11-28 13:41:23-05:00,260,4M7XECgNotuYef6fXsB659bgvA4LBYq9WrUFZP8jEZ8q,EjF9ZKUaBWZodjKy7ET7rEyK1uSsKX2cvcd4eJSYarF8,True,182359090,45589772,270067,135033,135034,72FwbpFGoLEazJEdpqNtPNefsadUrimUqma9wSoy4qiS,10802694,51492780,-40690086,592
2021-12-05 01:50:36.504518,2021-11-28 13:41:25-05:00,261,8w4uRzN81cghupkF7jNLinGLtCqYwNQFgQtdJfC5so7z,BbbRkq85fYEBGmuxBEEPbt6up4GNB7WQ83VSXwe4ro98,True,5232930771,1308232692,7960381,3980190,3980191,72FwbpFGoLEazJEdpqNtPNefsadUrimUqma9wSoy4qiS,318415274,1482341012,-1163925738,608
2021-12-05 01:50:36.504518,2021-11-28 13:41:25-05:00,262,2XFYFxNQbCr5ao4cVzRZt45fsAwZc4jD9XTABmdqaJWd,CvpzBuDjyimaYFGWFkkBcaZGSRtAvtF6MtRV54mqZ74k,True,674513,168628,1040,520,520,72FwbpFGoLEazJEdpqNtPNefsadUrimUqma9wSoy4qiS,41605,256931,-215326,616
2021-12-05 01:50:36.504518,2021-11-28 13:41:25-05:00,263,Gs3WP18hbzNpbBgiU39e6tfkggfCKRyNqPqJQcthuHFD,4XAY25YUma6gUdG2GdbXeivum3t21g93ZagfWGTZYkWZ,True,37532381,9383095,57086,28543,28543,72FwbpFGoLEazJEdpqNtPNefsadUrimUqma9wSoy4qiS,2283461,12009580,-9726119,608
2021-12-05 01:50:36.504518,2021-11-28 13:41:25-05:00,264,FZhvN1RjLoBK9EpCeyEobYsvdHirtbTXV82c9EV9nn2u,FSeHqYNof79JYrRb7ZkJWEb4TfS5wx7HTdvT1kLCexHM,True,49333436,12333359,73230,36615,36615,72FwbpFGoLEazJEdpqNtPNefsadUrimUqma9wSoy4qiS,2929236,15358801,-12429565,593
2021-12-05 01:50:36.504518,2021-11-28 13:41:25-05:00,265,3XzkSrNTGd3Fhd4M3gYzvz2utbQpFN1fhtbAaZu7C39R,GMsZGGfktTzYi7GhD3W6HY9QY9bznqTKfeArksikLE71,True,6056355,1514088,9352,4676,4676,72FwbpFGoLEazJEdpqNtPNefsadUrimUqma9wSoy4qiS,374081,2069489,-1695408,617
2021-12-05 01:50:36.504518,2021-11-28 13:41:25-05:00,266,57GUgfEp9ZQ5iAU2nx1Z2Tiz3gqq7yBNaqfE1cvxjFYt,98upivFa9Tdy3RZHGM1i2k5zeczaGqioq3rTzc3DMf4x,True,128138999,32034749,191002,95501,95501,72FwbpFGoLEazJEdpqNtPNefsadUrimUqma9wSoy4qiS,7640095,47530287,-39890192,596
2021-12-05 01:50:36.504518,2021-11-28 13:41:26-05:00,267,C24que1C7tC3ysDSKhcBTF9NUnjiNhSanWp8Go5FRRb8,hgm3qRRG2njhNPWcUp9UnEU8pyg4gLaR2K13r4Lsqxm,True,492235506,123058876,743819,371909,371910,72FwbpFGoLEazJEdpqNtPNefsadUrimUqma9wSoy4qiS,29752781,137541117,-107788336,604
2021-12-05 01:50:36.504518,2021-11-28 13:41:26-05:00,268,EQYUWtYbtvN9C9ixiupXPjHyFWHsYa7dUh4DSd6rxbzt,iS616uGNCwCxP1taAvvdvA2KdqfXRSjcQWwZRUgBkLb,True,11569593,2892398,17338,8669,8669,72FwbpFGoLEazJEdpqNtPNefsadUrimUqma9wSoy4qiS,693535,4409422,-3715887,599
2021-12-05 01:50:36.504518,2021-11-28 13:41:26-05:00,269,66SjFhmiNYz8tLRnBhZUbowWGTbM16G52X3AT2hma2wN,3wVy8nk24HCFZWMiacGe8QsJquYaadZ9pQg44bGRwdE3,True,35635796,8908949,52724,26362,26362,72FwbpFGoLEazJEdpqNtPNefsadUrimUqma9wSoy4qiS,2108970,14607448,-12498478,591
2021-12-05 01:50:36.504518,2021-11-28 13:41:26-05:00,270,GSaQj6w7ssfDpMGzMQd4pyhZvLeGvYc1Vc9Qcsx1t69g,HSNX4PwuAAuUncgs11suc9rFJ6ntB8BRN7ViFYT9RATM,True,2394795397,598698849,3452303,1726151,1726152,72FwbpFGoLEazJEdpqNtPNefsadUrimUqma9wSoy4qiS,138092129,641020152,-502928023,576
2021-12-05 01:50:36.504518,2021-11-28 13:41:35-05:00,271,4xsYjVsPm2C2itNtJb3NYkBp4WySHUwtSbWdu9fge8wz,8zu2jMoTndZpf9khY9PMhve88LRwrKNTuVuLpa5ss8qo,True,458621846,114655461,701800,350900,350900,72FwbpFGoLEazJEdpqNtPNefsadUrimUqma9wSoy4qiS,28072014,162942905,-134870891,612
2021-12-05 01:50:36.504518,2021-11-28 13:41:37-05:00,272,7gxTghaVZPNNwaNEdtQHh4QDCJ4JgigYMd4MMCC9VtFo,4ZZTUrm4jX1jqqTYVFJ9TJQ2BLx2eZgXesmoon1LBa1a,True,12732280,3183070,18945,9472,9473,72FwbpFGoLEazJEdpqNtPNefsadUrimUqma9wSoy4qiS,757830,3015550,-2257720,595
2021-12-05 01:50:36.504518,2021-11-28 13:42:49-05:00,273,8d333AWdyiVhvkAdiKCTwhgzaPBMbn8mtucwUC1SAbZZ,3BM8UNLN7XGRaYRjezAqFVMr1z4PS3VRXiN1NAtvBuD9,True,107229330,26807332,166234,83117,83117,72FwbpFGoLEazJEdpqNtPNefsadUrimUqma9wSoy4qiS,6649394,38255177,-31605783,620
2021-12-05 01:50:36.504518,2021-11-28 13:42:54-05:00,274,DCxghVXCXzEar41CPGichdzvtjwmf4NW7uHtKTj57BNN,Fmh5FPdnFb1KpFkoL6eNfWFGxN78GLdaJgPcVpCoCnkh,True,422294236,105573559,660882,330441,330441,72FwbpFGoLEazJEdpqNtPNefsadUrimUqma9wSoy4qiS,26435298,117269699,-90834401,625
2021-12-05 01:50:36.504518,2021-11-28 13:42:59-05:00,275,6RkvJTPLnRHhdfat6yP9Jd8QWrC6ad8c9oEygRgpg2Li,14UWcWSMirA7yAaW36BxGuvdYTAqNoxL1YKcstXQmGD5,True,79356396,19839099,122660,61330,61330,72FwbpFGoLEazJEdpqNtPNefsadUrimUqma9wSoy4qiS,4906402,18833672,-13927270,618
2021-12-05 01:50:36.504518,2021-12-02 14:51:27-05:00,276,ABjtqe2knhPfwbPpbXyr3XmFA6hDKXAHTfRZ8mwbdcJ6,HXPWkfFS1u3crwgu1kBKLtsn5E7owLWUr5poaQe3NcUs,False,7402334578,7402334578,354342695,17717134,336625561,4BnQKPLuE3DMTtxp8MjUBytgnhvxqq3ZTqZHTVZo4JJh,354342695,1231291688,-876948993,478
2021-12-05 01:50:36.504518,2021-12-03 19:48:41-05:00,277,8GuH7tofwd6okCa9CPV4kbZ1RdpjPAS14kzKgJrUhbP5,DW3PVKVSBEswSoyfFsne169qSSt9Z3JFXcaLqFVSiYfY,True,912298552,228074638,1406888,703444,703444,72FwbpFGoLEazJEdpqNtPNefsadUrimUqma9wSoy4qiS,56275524,213868902,-157593378,616
2021-12-05 01:50:36.504518,2021-12-03 20:01:56-05:00,278,9kK2PuehQxgcXtnYnPNmukmzfDTsVHv15pE86xwi7vYt,DtbCSCur1w6ZMGu56auQaHf8c6gVDJoD1iEwiUyCBcYJ,True,76910126,19227531,120054,60027,60027,4BnQKPLuE3DMTtxp8MjUBytgnhvxqq3ZTqZHTVZo4JJh,4802176,17882960,-13080784,624
2021-12-05 01:50:36.504518,2021-12-03 22:26:14-05:00,279,CUhCSd7jHvycC89L6EqMoDWcWVTXXHhAeXVyB4362qZg,J7B9JBV1xR8a7DKKrw3JwGusY4H2bSQuyHtod2Fzf4jq,True,540742672,135185668,839387,419693,419694,72FwbpFGoLEazJEdpqNtPNefsadUrimUqma9wSoy4qiS,33575487,120642278,-87066791,620
2021-12-05 01:50:36.504518,2021-12-03 22:28:05-05:00,280,DE8KcmECtrF8XoCzuiTJLDFgm4cTSjQFJYSP81WHfr8L,J9GYsnRjDbkwrcqa1XfBmVNXqa9pgzzRymdntFZu1PCv,True,392808366,98202091,614280,307140,307140,72FwbpFGoLEazJEdpqNtPNefsadUrimUqma9wSoy4qiS,24571210,91964508,-67393298,625
2021-12-05 01:50:36.504518,2021-12-03 22:56:47-05:00,281,C66xkhG3GSswFRqZ8BHATwPbPhyGsWxJ1ymMaDerKbLX,HkJXe2vivbt9aVuJkmA11w9uz8Kbg4fB9sdL2fUmJcQR,True,302957295,75739323,470222,235111,235111,4BnQKPLuE3DMTtxp8MjUBytgnhvxqq3ZTqZHTVZo4JJh,18808908,70815758,-52006850,620
2021-12-05 01:50:36.504518,2021-12-03 22:57:50-05:00,282,A4Ce8RnM3qZW9Njo363ywPyhpcUqQTH2PVJn2ugYMmqx,DWSTAcKdqtc8qixLxWGx4shHe1PT2h4hDSMDVQqn1N8L,True,17754933,4438733,27631,13815,13816,4BnQKPLuE3DMTtxp8MjUBytgnhvxqq3ZTqZHTVZo4JJh,1105246,4350313,-3245067,622
2021-12-05 01:50:36.504518,2021-12-03 22:58:18-05:00,283,Gq7fPzML38eX6tSedGqCMhmbw7WsaSEYoEZM3BucjZh8,AvEB59ycFk7Y74Wt79cUV9B49GJqwc5c26GCGc29i5zC,True,212946670,53236667,321069,160534,160535,4BnQKPLuE3DMTtxp8MjUBytgnhvxqq3ZTqZHTVZo4JJh,12842760,49870840,-37028080,603
2021-12-05 01:50:36.504518,2021-12-03 22:58:29-05:00,284,8GuH7tofwd6okCa9CPV4kbZ1RdpjPAS14kzKgJrUhbP5,DW3PVKVSBEswSoyfFsne169qSSt9Z3JFXcaLqFVSiYfY,True,670539535,167634883,1023977,511988,511989,4BnQKPLuE3DMTtxp8MjUBytgnhvxqq3ZTqZHTVZo4JJh,40959117,172870621,-131911504,610
2021-12-05 01:50:36.504518,2021-12-03 22:58:30-05:00,285,9hzdQrYGDWaS9vDhDZGjh79WxE1urqR4ubNacHddr4Us,971fdspGqjQBdVuG7D5JGvxsRYDJPtAMHaJrQQzDuBUg,True,238307084,59576771,361477,180738,180739,72FwbpFGoLEazJEdpqNtPNefsadUrimUqma9wSoy4qiS,14459083,55788538,-41329455,606
2021-12-05 01:50:36.504518,2021-12-03 22:59:30-05:00,286,9kK2PuehQxgcXtnYnPNmukmzfDTsVHv15pE86xwi7vYt,DtbCSCur1w6ZMGu56auQaHf8c6gVDJoD1iEwiUyCBcYJ,True,56448157,14112039,85905,42952,42953,72FwbpFGoLEazJEdpqNtPNefsadUrimUqma9wSoy4qiS,3436235,14481502,-11045267,608
2021-12-05 01:50:36.504518,2021-12-03 23:00:45-05:00,287,94KFzzXCAvEfSf3jrnUpyN3pne8Xfc6nroB7UxTVqeyB,ERQEKcL8qV9WEzLwi5WFjh2wN97q9GD9pqd9umcTypxy,True,21277752,5319438,33199,16599,16600,4BnQKPLuE3DMTtxp8MjUBytgnhvxqq3ZTqZHTVZo4JJh,1327967,4976172,-3648205,624
2021-12-05 01:50:36.504518,2021-12-03 23:00:54-05:00,288,CUhCSd7jHvycC89L6EqMoDWcWVTXXHhAeXVyB4362qZg,J7B9JBV1xR8a7DKKrw3JwGusY4H2bSQuyHtod2Fzf4jq,True,397098307,99274576,605470,302735,302735,4BnQKPLuE3DMTtxp8MjUBytgnhvxqq3ZTqZHTVZo4JJh,24218829,97988860,-73770031,609
2021-12-05 01:50:36.504518,2021-12-03 23:00:55-05:00,289,DE8KcmECtrF8XoCzuiTJLDFgm4cTSjQFJYSP81WHfr8L,J9GYsnRjDbkwrcqa1XfBmVNXqa9pgzzRymdntFZu1PCv,True,288624582,72156145,448316,224158,224158,72FwbpFGoLEazJEdpqNtPNefsadUrimUqma9wSoy4qiS,17932668,74465305,-56532637,621
2021-12-05 01:50:36.504518,2021-12-03 23:54:05-05:00,290,DSnvQca2ReL3mzwucUGzXTqhxqX5BABy4XvoWDLUfKCU,GfRyJVAx5ckPZn4iJ9ZW9yrLVsw3a2nzwg8QVWaQ6qkF,True,2121303257,530325814,3246592,1623296,1623296,72FwbpFGoLEazJEdpqNtPNefsadUrimUqma9wSoy4qiS,129863681,494589240,-364725559,612
2021-12-05 01:50:36.504518,2021-12-03 23:54:23-05:00,291,E5KDZriZ89a5D4VsMaWxndMMG68RT4weruJ1tCEc6tSx,CaSwkUocpbyyGCQBgKjJZJgcexbyqs2GTrGJH6EMWXAz,True,13891806267,3472951566,21586604,10793302,10793302,4BnQKPLuE3DMTtxp8MjUBytgnhvxqq3ZTqZHTVZo4JJh,863464169,3512383910,-2648919741,621
2021-12-05 01:50:36.504518,2021-12-03 23:54:26-05:00,292,C66xkhG3GSswFRqZ8BHATwPbPhyGsWxJ1ymMaDerKbLX,HkJXe2vivbt9aVuJkmA11w9uz8Kbg4fB9sdL2fUmJcQR,True,222577924,55644481,341641,170820,170821,72FwbpFGoLEazJEdpqNtPNefsadUrimUqma9wSoy4qiS,13665670,57314436,-43648766,613
2021-12-05 01:50:36.504518,2021-12-03 23:54:50-05:00,293,A4Ce8RnM3qZW9Njo363ywPyhpcUqQTH2PVJn2ugYMmqx,DWSTAcKdqtc8qixLxWGx4shHe1PT2h4hDSMDVQqn1N8L,True,13053708,3263427,20329,10164,10165,72FwbpFGoLEazJEdpqNtPNefsadUrimUqma9wSoy4qiS,813186,3509550,-2696364,622
2021-12-05 01:50:36.504518,2021-12-03 23:54:50-05:00,294,HnUkyFhntoajDEgXMKeoh4nAuY5y7osLYwmYAApyLSNs,GntEkHxrGpcHFCVLQGjKiXWdenbsqfQgxddpEpxpE65z,True,119305609,29826402,183184,91592,91592,72FwbpFGoLEazJEdpqNtPNefsadUrimUqma9wSoy4qiS,7327362,28007613,-20680251,614
2021-12-05 01:50:36.504518,2021-12-03 23:55:18-05:00,295,J2gTwrYpzezkRupgBtgudQn5D33x6WjeBhTHnrA1qgqa,FBzoHRwqGRjnMvPEpiZVjtGZYJmAbneE4dpToXPzy8bv,True,13307132849,3326783212,20786219,10393109,10393110,4BnQKPLuE3DMTtxp8MjUBytgnhvxqq3ZTqZHTVZo4JJh,831448765,3537919254,-2706470489,624
2021-12-05 01:50:36.504518,2021-12-03 23:55:23-05:00,296,Gq7fPzML38eX6tSedGqCMhmbw7WsaSEYoEZM3BucjZh8,AvEB59ycFk7Y74Wt79cUV9B49GJqwc5c26GCGc29i5zC,True,156959862,39239965,243705,121852,121853,4BnQKPLuE3DMTtxp8MjUBytgnhvxqq3ZTqZHTVZo4JJh,9748219,40271237,-30523018,621
2021-12-05 01:50:36.504518,2021-12-03 23:55:40-05:00,297,8GuH7tofwd6okCa9CPV4kbZ1RdpjPAS14kzKgJrUhbP5,DW3PVKVSBEswSoyfFsne169qSSt9Z3JFXcaLqFVSiYfY,True,489198808,122299702,653895,326947,326948,72FwbpFGoLEazJEdpqNtPNefsadUrimUqma9wSoy4qiS,26155820,138813193,-112657373,534
2021-12-05 01:50:36.504518,2021-12-03 23:55:40-05:00,298,9kK2PuehQxgcXtnYnPNmukmzfDTsVHv15pE86xwi7vYt,DtbCSCur1w6ZMGu56auQaHf8c6gVDJoD1iEwiUyCBcYJ,True,41337327,10334331,58633,29316,29317,72FwbpFGoLEazJEdpqNtPNefsadUrimUqma9wSoy4qiS,2345331,11628259,-9282928,567
2021-12-05 01:50:36.504518,2021-12-03 23:55:40-05:00,299,E3uCNxXMRHD2ayCY48Kafwy55443r3p1EijT92ug26yd,AMqLEmYQZRhhE7dRQQ21QYfBbthnAVQvmPh9PNbyavta,True,12744192,3186048,17540,8770,8770,72FwbpFGoLEazJEdpqNtPNefsadUrimUqma9wSoy4qiS,701623,2975354,-2273731,550
2021-12-05 01:50:36.504518,2021-12-03 23:55:42-05:00,300,CUhCSd7jHvycC89L6EqMoDWcWVTXXHhAeXVyB4362qZg,J7B9JBV1xR8a7DKKrw3JwGusY4H2bSQuyHtod2Fzf4jq,True,292473996,73118499,456590,228295,228295,72FwbpFGoLEazJEdpqNtPNefsadUrimUqma9wSoy4qiS,18263624,78947120,-60683496,624
2021-12-05 01:50:36.504518,2021-12-03 23:55:42-05:00,301,EBUcTqh9AYyRokZRzLbPKL9ZmTUx6KcDEbBeuCLGwqYC,B5WSXfHzYQhUFE2T97GaiqSkeejTWKKGVjMkcFrxEvyJ,True,186135299,46533824,254265,127132,127133,72FwbpFGoLEazJEdpqNtPNefsadUrimUqma9wSoy4qiS,10170626,44013107,-33842481,546
2021-12-05 01:50:36.504518,2021-12-03 23:55:43-05:00,302,9hzdQrYGDWaS9vDhDZGjh79WxE1urqR4ubNacHddr4Us,971fdspGqjQBdVuG7D5JGvxsRYDJPtAMHaJrQQzDuBUg,True,173839588,43459897,229519,114759,114760,72FwbpFGoLEazJEdpqNtPNefsadUrimUqma9wSoy4qiS,9180769,45070855,-35890086,528
2021-12-05 01:50:36.504518,2021-12-03 23:56:03-05:00,303,DSnvQca2ReL3mzwucUGzXTqhxqX5BABy4XvoWDLUfKCU,GfRyJVAx5ckPZn4iJ9ZW9yrLVsw3a2nzwg8QVWaQ6qkF,True,1561879911,390469977,2437988,1218994,1218994,72FwbpFGoLEazJEdpqNtPNefsadUrimUqma9wSoy4qiS,97519557,400337303,-302817746,624
2021-12-05 01:50:36.504518,2021-12-03 23:56:07-05:00,304,EvSdLa5PeJiaaaE3omJNG7cw1tptZnHTituYswVHSwm3,68ESX2mBsfxQo2U9jsbmHo7TzPTxr9mGH5Y11ZLR7E3A,True,143437552,35859388,220042,110021,110021,4BnQKPLuE3DMTtxp8MjUBytgnhvxqq3ZTqZHTVZo4JJh,8801716,43370745,-34569029,613
2021-12-05 01:50:36.504518,2021-12-03 23:56:11-05:00,305,DE8KcmECtrF8XoCzuiTJLDFgm4cTSjQFJYSP81WHfr8L,J9GYsnRjDbkwrcqa1XfBmVNXqa9pgzzRymdntFZu1PCv,True,212221893,53055473,330945,165472,165473,72FwbpFGoLEazJEdpqNtPNefsadUrimUqma9wSoy4qiS,13237808,59887168,-46649360,623
2021-12-05 01:50:36.504518,2021-12-03 23:56:15-05:00,306,94KFzzXCAvEfSf3jrnUpyN3pne8Xfc6nroB7UxTVqeyB,ERQEKcL8qV9WEzLwi5WFjh2wN97q9GD9pqd9umcTypxy,True,15601891,3900472,23458,11729,11729,72FwbpFGoLEazJEdpqNtPNefsadUrimUqma9wSoy4qiS,938345,4030985,-3092640,601
2021-12-05 01:50:36.504518,2021-12-03 23:56:26-05:00,307,FEWgesdpjtMv15TjLLY1LHjzXjZDaLENFTdjuhbwdBg9,4J2YMa9XUzLMfjYDwHeD4GRmXHFBGywYsmcVFvCDYW6T,True,967610649,241902662,1503832,751916,751916,72FwbpFGoLEazJEdpqNtPNefsadUrimUqma9wSoy4qiS,60153282,250212037,-190058755,621
2021-12-05 01:50:36.504518,2021-12-03 23:56:53-05:00,308,C66xkhG3GSswFRqZ8BHATwPbPhyGsWxJ1ymMaDerKbLX,HkJXe2vivbt9aVuJkmA11w9uz8Kbg4fB9sdL2fUmJcQR,True,163654809,40913702,251134,125567,125567,72FwbpFGoLEazJEdpqNtPNefsadUrimUqma9wSoy4qiS,10045395,46062603,-36017208,613
2021-12-05 01:50:36.504518,2021-12-04 00:04:04-05:00,309,9hzdQrYGDWaS9vDhDZGjh79WxE1urqR4ubNacHddr4Us,971fdspGqjQBdVuG7D5JGvxsRYDJPtAMHaJrQQzDuBUg,True,129448980,32362245,200045,100022,100023,72FwbpFGoLEazJEdpqNtPNefsadUrimUqma9wSoy4qiS,8001839,35851348,-27849509,618
2021-12-05 01:50:36.504518,2021-12-04 00:04:04-05:00,310,8GuH7tofwd6okCa9CPV4kbZ1RdpjPAS14kzKgJrUhbP5,DW3PVKVSBEswSoyfFsne169qSSt9Z3JFXcaLqFVSiYfY,True,364237222,91059305,569685,284842,284843,72FwbpFGoLEazJEdpqNtPNefsadUrimUqma9wSoy4qiS,22787421,109952284,-87164863,625
2021-12-05 01:50:36.504518,2021-12-04 00:04:05-05:00,311,HnUkyFhntoajDEgXMKeoh4nAuY5y7osLYwmYAApyLSNs,GntEkHxrGpcHFCVLQGjKiXWdenbsqfQgxddpEpxpE65z,True,87765406,21941351,135442,67721,67721,72FwbpFGoLEazJEdpqNtPNefsadUrimUqma9wSoy4qiS,5417698,22642282,-17224584,617
2021-12-05 01:50:36.504518,2021-12-04 00:04:26-05:00,312,Gq7fPzML38eX6tSedGqCMhmbw7WsaSEYoEZM3BucjZh8,AvEB59ycFk7Y74Wt79cUV9B49GJqwc5c26GCGc29i5zC,True,114616316,28654079,159605,79802,79803,72FwbpFGoLEazJEdpqNtPNefsadUrimUqma9wSoy4qiS,6384225,32381090,-25996865,557
2021-12-05 01:50:36.504518,2021-12-04 00:04:26-05:00,313,EBUcTqh9AYyRokZRzLbPKL9ZmTUx6KcDEbBeuCLGwqYC,B5WSXfHzYQhUFE2T97GaiqSkeejTWKKGVjMkcFrxEvyJ,True,137349471,34337367,191108,95554,95554,72FwbpFGoLEazJEdpqNtPNefsadUrimUqma9wSoy4qiS,7644335,35279612,-27635277,556
2021-12-05 01:50:36.504518,2021-12-04 00:04:26-05:00,314,GSaQj6w7ssfDpMGzMQd4pyhZvLeGvYc1Vc9Qcsx1t69g,HSNX4PwuAAuUncgs11suc9rFJ6ntB8BRN7ViFYT9RATM,True,3217170677,804292669,4838829,2419414,2419415,72FwbpFGoLEazJEdpqNtPNefsadUrimUqma9wSoy4qiS,193553173,746348946,-552795773,601
2021-12-05 01:50:36.504518,2021-12-04 00:04:26-05:00,315,A4Ce8RnM3qZW9Njo363ywPyhpcUqQTH2PVJn2ugYMmqx,DWSTAcKdqtc8qixLxWGx4shHe1PT2h4hDSMDVQqn1N8L,True,9513576,2378394,12869,6434,6435,72FwbpFGoLEazJEdpqNtPNefsadUrimUqma9wSoy4qiS,514765,2813793,-2299028,541
2021-12-05 01:50:36.504518,2021-12-04 00:04:26-05:00,316,6HzCJnV3Z4psm7V64UpJBstZxK2XAxUySyuoX8RJaFwY,2AsimTXANwSRChLJWdLjdJG8X2gwGsrjPguqFZjuAeA9,True,40456428,10114107,61377,30688,30689,72FwbpFGoLEazJEdpqNtPNefsadUrimUqma9wSoy4qiS,2455097,9959447,-7504350,606
2021-12-05 01:50:36.504518,2021-12-04 00:04:26-05:00,317,3LfgumhfN7fRDEPhEN8SfVWXVnmSj6wuWQ1qYxKv6Eup,BYDZyXhUyMKvQnsnVLT8RqNYqUtf5SAFZGZx99E5dUmW,True,4215311,1053827,5796,2898,2898,72FwbpFGoLEazJEdpqNtPNefsadUrimUqma9wSoy4qiS,231867,1016556,-784689,550
2021-12-05 01:50:36.504518,2021-12-04 00:04:30-05:00,318,9kK2PuehQxgcXtnYnPNmukmzfDTsVHv15pE86xwi7vYt,DtbCSCur1w6ZMGu56auQaHf8c6gVDJoD1iEwiUyCBcYJ,True,30491171,7622792,44260,22130,22130,72FwbpFGoLEazJEdpqNtPNefsadUrimUqma9wSoy4qiS,1770427,9244556,-7474129,580
2021-12-05 01:50:36.504518,2021-12-04 00:04:30-05:00,319,E3uCNxXMRHD2ayCY48Kafwy55443r3p1EijT92ug26yd,AMqLEmYQZRhhE7dRQQ21QYfBbthnAVQvmPh9PNbyavta,True,9400812,2350203,13134,6567,6567,72FwbpFGoLEazJEdpqNtPNefsadUrimUqma9wSoy4qiS,525381,2388071,-1862690,558
2021-12-05 01:50:36.504518,2021-12-04 00:04:31-05:00,320,J2gTwrYpzezkRupgBtgudQn5D33x6WjeBhTHnrA1qgqa,FBzoHRwqGRjnMvPEpiZVjtGZYJmAbneE4dpToXPzy8bv,True,9714845104,2428711276,13593474,6796737,6796737,72FwbpFGoLEazJEdpqNtPNefsadUrimUqma9wSoy4qiS,543738994,2846226264,-2302487270,559
2021-12-05 01:50:36.504518,2021-12-04 00:04:32-05:00,321,7ckvB1uchDPcA5vkjJvu4DHCkgGq81qbJrd4P2CwPDV8,pVjScFyTQfYJ74uA9JLEsChSrtY8fRi2dCM3jtWC6bp,True,104848669,26212167,141619,70809,70810,72FwbpFGoLEazJEdpqNtPNefsadUrimUqma9wSoy4qiS,5664762,26284995,-20620233,540
2021-12-05 01:50:36.504518,2021-12-04 00:04:35-05:00,322,E5KDZriZ89a5D4VsMaWxndMMG68RT4weruJ1tCEc6tSx,CaSwkUocpbyyGCQBgKjJZJgcexbyqs2GTrGJH6EMWXAz,True,10132618086,2533154521,13850742,6925371,6925371,72FwbpFGoLEazJEdpqNtPNefsadUrimUqma9wSoy4qiS,554029687,2832325796,-2278296109,546
2021-12-05 01:50:36.504518,2021-12-04 00:04:54-05:00,323,2JH43pKUeXTXPd6LnL4BWgGQpwZHhX8EqyohKCFLAS4i,Bir3EKnDWkv6XX7KmoqAi1y6rxSaC5RfVV6Hwvnkfr2i,True,81088239,20272059,122579,61289,61290,72FwbpFGoLEazJEdpqNtPNefsadUrimUqma9wSoy4qiS,4903171,18805337,-13902166,604
2021-12-05 01:50:36.504518,2021-12-04 00:05:01-05:00,324,7ckvB1uchDPcA5vkjJvu4DHCkgGq81qbJrd4P2CwPDV8,pVjScFyTQfYJ74uA9JLEsChSrtY8fRi2dCM3jtWC6bp,True,77887101,19471775,119343,59671,59672,72FwbpFGoLEazJEdpqNtPNefsadUrimUqma9wSoy4qiS,4773742,20988800,-16215058,612
2021-12-05 01:50:36.504518,2021-12-04 00:05:01-05:00,325,A4Ce8RnM3qZW9Njo363ywPyhpcUqQTH2PVJn2ugYMmqx,DWSTAcKdqtc8qixLxWGx4shHe1PT2h4hDSMDVQqn1N8L,True,7061312,1765328,10700,5350,5350,72FwbpFGoLEazJEdpqNtPNefsadUrimUqma9wSoy4qiS,428026,2226182,-1798156,606
2021-12-05 01:50:36.504518,2021-12-04 00:05:05-05:00,326,FEWgesdpjtMv15TjLLY1LHjzXjZDaLENFTdjuhbwdBg9,4J2YMa9XUzLMfjYDwHeD4GRmXHFBGywYsmcVFvCDYW6T,True,708893766,177223441,1043269,521634,521635,72FwbpFGoLEazJEdpqNtPNefsadUrimUqma9wSoy4qiS,41730768,201126836,-159396068,588
2021-12-05 01:50:36.504518,2021-12-04 00:05:05-05:00,327,9hzdQrYGDWaS9vDhDZGjh79WxE1urqR4ubNacHddr4Us,971fdspGqjQBdVuG7D5JGvxsRYDJPtAMHaJrQQzDuBUg,True,95182089,23795522,147428,73714,73714,72FwbpFGoLEazJEdpqNtPNefsadUrimUqma9wSoy4qiS,5897148,28689635,-22792487,619
2021-12-05 01:50:36.504518,2021-12-04 00:05:10-05:00,328,94KFzzXCAvEfSf3jrnUpyN3pne8Xfc6nroB7UxTVqeyB,ERQEKcL8qV9WEzLwi5WFjh2wN97q9GD9pqd9umcTypxy,True,11432434,2858108,16105,8052,8053,72FwbpFGoLEazJEdpqNtPNefsadUrimUqma9wSoy4qiS,644218,3232703,-2588485,563
2021-12-05 01:50:36.504518,2021-12-04 00:05:10-05:00,329,3LfgumhfN7fRDEPhEN8SfVWXVnmSj6wuWQ1qYxKv6Eup,BYDZyXhUyMKvQnsnVLT8RqNYqUtf5SAFZGZx99E5dUmW,True,3128613,782153,4830,2415,2415,72FwbpFGoLEazJEdpqNtPNefsadUrimUqma9wSoy4qiS,193200,814625,-621425,617
2021-12-05 01:50:36.504518,2021-12-04 00:05:10-05:00,330,EBUcTqh9AYyRokZRzLbPKL9ZmTUx6KcDEbBeuCLGwqYC,B5WSXfHzYQhUFE2T97GaiqSkeejTWKKGVjMkcFrxEvyJ,True,101911895,25477973,158825,79412,79413,72FwbpFGoLEazJEdpqNtPNefsadUrimUqma9wSoy4qiS,6353018,28180463,-21827445,623
2021-12-05 01:50:36.504518,2021-12-04 00:05:10-05:00,331,CUhCSd7jHvycC89L6EqMoDWcWVTXXHhAeXVyB4362qZg,J7B9JBV1xR8a7DKKrw3JwGusY4H2bSQuyHtod2Fzf4jq,True,213503939,53375984,298100,149050,149050,72FwbpFGoLEazJEdpqNtPNefsadUrimUqma9wSoy4qiS,11924015,63291678,-51367663,558
2021-12-05 01:50:36.504518,2021-12-04 00:05:17-05:00,332,DE8KcmECtrF8XoCzuiTJLDFgm4cTSjQFJYSP81WHfr8L,J9GYsnRjDbkwrcqa1XfBmVNXqa9pgzzRymdntFZu1PCv,True,155161956,38790489,221988,110994,110994,72FwbpFGoLEazJEdpqNtPNefsadUrimUqma9wSoy4qiS,8879535,47872927,-38993392,572
2021-12-05 01:50:36.504518,2021-12-04 00:05:19-05:00,333,EvSdLa5PeJiaaaE3omJNG7cw1tptZnHTituYswVHSwm3,68ESX2mBsfxQo2U9jsbmHo7TzPTxr9mGH5Y11ZLR7E3A,True,105008925,26252231,149924,74962,74962,72FwbpFGoLEazJEdpqNtPNefsadUrimUqma9wSoy4qiS,5996961,34493874,-28496913,571
2021-12-05 01:50:36.504518,2021-12-04 00:05:19-05:00,334,FV9CBGGTbppLnBKh79f2LzD1diTiS5g6u89FcpZHZmnK,Fe7mtmCUziFqbbYTvrhAcAq1Ub7YLfTJRtQ1hG7GzJD1,True,53757264,13439316,83338,41669,41669,72FwbpFGoLEazJEdpqNtPNefsadUrimUqma9wSoy4qiS,3333552,12359767,-9026215,620
2021-12-05 01:50:36.504518,2021-12-04 00:05:20-05:00,335,Gq7fPzML38eX6tSedGqCMhmbw7WsaSEYoEZM3BucjZh8,AvEB59ycFk7Y74Wt79cUV9B49GJqwc5c26GCGc29i5zC,True,85038485,21259621,132521,66260,66261,72FwbpFGoLEazJEdpqNtPNefsadUrimUqma9wSoy4qiS,5300868,25722871,-20422003,623
2021-12-05 01:50:36.504518,2021-12-04 00:05:20-05:00,336,DSnvQca2ReL3mzwucUGzXTqhxqX5BABy4XvoWDLUfKCU,GfRyJVAx5ckPZn4iJ9ZW9yrLVsw3a2nzwg8QVWaQ6qkF,True,1143395064,285848766,1672454,836227,836227,72FwbpFGoLEazJEdpqNtPNefsadUrimUqma9wSoy4qiS,66898174,322124458,-255226284,585
2021-12-05 01:50:36.504518,2021-12-04 00:05:20-05:00,337,C66xkhG3GSswFRqZ8BHATwPbPhyGsWxJ1ymMaDerKbLX,HkJXe2vivbt9aVuJkmA11w9uz8Kbg4fB9sdL2fUmJcQR,True,120153678,30038419,179728,89864,89864,72FwbpFGoLEazJEdpqNtPNefsadUrimUqma9wSoy4qiS,7189124,36790599,-29601475,598
2021-12-05 01:50:36.504518,2021-12-04 00:05:20-05:00,338,8w1hzDtCFuTJqWAtwihztrPzxwa7YrJH5uPk877SJnNj,D3gnctosqTZxTQNfLJQRdPgCvGx2JLLHHDmcvW5UX1QN,True,1751986511,437996627,2492665,1246332,1246333,72FwbpFGoLEazJEdpqNtPNefsadUrimUqma9wSoy4qiS,99706603,417722271,-318015668,569
2021-12-05 01:50:36.504518,2021-12-04 00:05:22-05:00,339,HnUkyFhntoajDEgXMKeoh4nAuY5y7osLYwmYAApyLSNs,GntEkHxrGpcHFCVLQGjKiXWdenbsqfQgxddpEpxpE65z,True,64513116,16128279,99282,49641,49641,72FwbpFGoLEazJEdpqNtPNefsadUrimUqma9wSoy4qiS,3971317,18201072,-14229755,615
2021-12-05 01:50:36.504518,2021-12-04 00:05:28-05:00,340,E3uCNxXMRHD2ayCY48Kafwy55443r3p1EijT92ug26yd,AMqLEmYQZRhhE7dRQQ21QYfBbthnAVQvmPh9PNbyavta,True,6974751,1743687,10909,5454,5455,72FwbpFGoLEazJEdpqNtPNefsadUrimUqma9wSoy4qiS,436389,1909270,-1472881,625
2021-12-05 01:50:36.504518,2021-12-04 00:10:06-05:00,341,5Rxuqgs4CaSKbfDXqBMFXkLTQ9dxrUjThXzoy3ouYVtK,BgvbKru66ebrGUcFFymGTmsaQv6GgcGMybiWaXqzBtwX,True,47053440,11763360,73104,36552,36552,72FwbpFGoLEazJEdpqNtPNefsadUrimUqma9wSoy4qiS,2924184,10865189,-7941005,621
2021-12-05 01:50:36.504518,2021-12-04 00:24:29-05:00,342,GbPWktFegZQEz5CDL2kphHexVrQgy3hTmXa8mCEZtdps,BVQzSYxgF1v6ftSLe5mftqgvretxPcNCrtN8RrHKDn5x,True,894996000,223749000,1375929,687964,687965,72FwbpFGoLEazJEdpqNtPNefsadUrimUqma9wSoy4qiS,55037178,207032031,-151994853,614
2021-12-05 01:50:36.504518,2021-12-04 00:24:39-05:00,343,FFsQo78UMHAfXc8F38txcR3sjWCqEjLT9AGoCvtuWbh6,Bn1dsirxXSzuWVCz8rSnGXDz7UTUV2yLqfa8QNa7QgcR,True,8477880,2119470,13045,6522,6523,72FwbpFGoLEazJEdpqNtPNefsadUrimUqma9wSoy4qiS,521834,2043954,-1522120,615
2021-12-05 01:50:36.504518,2021-12-04 00:24:39-05:00,344,2qsrQ75TWz5g3KVoWbKKa9DsLQ5uCAndmfjqPsWzwExJ,Bj7LHrHSg9M3H9ZxFCxqdw8u79iw8K2awJHzk7QNdayy,True,3359522,839880,5210,2605,2605,72FwbpFGoLEazJEdpqNtPNefsadUrimUqma9wSoy4qiS,208419,848897,-640478,620
2021-12-05 01:50:36.504518,2021-12-04 00:24:39-05:00,345,8GuH7tofwd6okCa9CPV4kbZ1RdpjPAS14kzKgJrUhbP5,DW3PVKVSBEswSoyfFsne169qSSt9Z3JFXcaLqFVSiYfY,True,267328816,66832204,409215,204607,204608,72FwbpFGoLEazJEdpqNtPNefsadUrimUqma9wSoy4qiS,16368635,87596971,-71228336,612
2021-12-05 01:50:36.504518,2021-12-04 00:24:46-05:00,346,J2gTwrYpzezkRupgBtgudQn5D33x6WjeBhTHnrA1qgqa,FBzoHRwqGRjnMvPEpiZVjtGZYJmAbneE4dpToXPzy8bv,True,7180479961,1795119990,10612291,5306145,5306146,72FwbpFGoLEazJEdpqNtPNefsadUrimUqma9wSoy4qiS,424491653,2260971972,-1836480319,591
2021-12-05 01:50:36.504518,2021-12-04 00:24:46-05:00,347,6HzCJnV3Z4psm7V64UpJBstZxK2XAxUySyuoX8RJaFwY,2AsimTXANwSRChLJWdLjdJG8X2gwGsrjPguqFZjuAeA9,True,29631342,7407835,42068,21034,21034,72FwbpFGoLEazJEdpqNtPNefsadUrimUqma9wSoy4qiS,1682741,8022460,-6339719,567
2021-12-05 01:50:36.504518,2021-12-04 00:24:55-05:00,348,E5KDZriZ89a5D4VsMaWxndMMG68RT4weruJ1tCEc6tSx,CaSwkUocpbyyGCQBgKjJZJgcexbyqs2GTrGJH6EMWXAz,True,7464234059,1866058514,10123735,5061867,5061868,72FwbpFGoLEazJEdpqNtPNefsadUrimUqma9wSoy4qiS,404949439,2251879079,-1846929640,542
2021-12-05 01:50:36.504518,2021-12-04 00:25:00-05:00,349,3TTUCUbDMr98vbwUidKDsmkVdLavhTsypKwMvn7s3De6,53PNcr23uUHeNEQWzez9BZdSDMvqMw3DR5NcMAQvDhrq,True,21680400569,5420100142,31819793,15909896,15909897,72FwbpFGoLEazJEdpqNtPNefsadUrimUqma9wSoy4qiS,1272791739,5047921985,-3775130246,587
2021-12-05 01:50:36.504518,2021-12-04 00:25:01-05:00,350,BHQFfHCfTAp6xYFNdHRv65BtaobfhBaLFp2KTMxL6ZhN,Eg8q7M4e3qQvUUGqy8QZVxgE6hR1rtdsYPUXqksJhkv3,True,425457258,106364314,612418,306209,306209,72FwbpFGoLEazJEdpqNtPNefsadUrimUqma9wSoy4qiS,24496745,99012294,-74515549,575
2021-12-05 01:50:36.504518,2021-12-04 00:25:08-05:00,351,9kK2PuehQxgcXtnYnPNmukmzfDTsVHv15pE86xwi7vYt,DtbCSCur1w6ZMGu56auQaHf8c6gVDJoD1iEwiUyCBcYJ,True,22392290,5598072,31251,15625,15626,72FwbpFGoLEazJEdpqNtPNefsadUrimUqma9wSoy4qiS,1250078,7331841,-6081763,558
2021-12-05 01:50:36.504518,2021-12-04 00:25:08-05:00,352,GSaQj6w7ssfDpMGzMQd4pyhZvLeGvYc1Vc9Qcsx1t69g,HSNX4PwuAAuUncgs11suc9rFJ6ntB8BRN7ViFYT9RATM,True,2362672279,590668069,3462715,1731357,1731358,72FwbpFGoLEazJEdpqNtPNefsadUrimUqma9wSoy4qiS,138508615,603722507,-465213892,586
2021-12-05 01:50:36.504518,2021-12-04 00:25:14-05:00,353,FP6SmbXDbcb6c8Pi8uZMn6hnQDUbvbdCfzd5pEqyBgTm,53A9dhER1x3JjdceGMQmjujvWht7uemsoB3ngQLdo6Ub,True,1865197022,466299255,2825427,1412713,1412714,72FwbpFGoLEazJEdpqNtPNefsadUrimUqma9wSoy4qiS,113017102,515616752,-402599650,605
2021-12-05 01:50:36.504518,2021-12-04 00:25:31-05:00,354,CUhCSd7jHvycC89L6EqMoDWcWVTXXHhAeXVyB4362qZg,J7B9JBV1xR8a7DKKrw3JwGusY4H2bSQuyHtod2Fzf4jq,True,158159558,39539889,241437,120718,120719,72FwbpFGoLEazJEdpqNtPNefsadUrimUqma9wSoy4qiS,9657518,50153636,-40496118,610
2021-12-05 01:50:36.504518,2021-12-04 00:25:31-05:00,355,2JH43pKUeXTXPd6LnL4BWgGQpwZHhX8EqyohKCFLAS4i,Bir3EKnDWkv6XX7KmoqAi1y6rxSaC5RfVV6Hwvnkfr2i,True,59518751,14879687,87079,43539,43540,72FwbpFGoLEazJEdpqNtPNefsadUrimUqma9wSoy4qiS,3483163,15207491,-11724328,585
2021-12-05 01:50:36.504518,2021-12-04 00:25:32-05:00,356,94KFzzXCAvEfSf3jrnUpyN3pne8Xfc6nroB7UxTVqeyB,ERQEKcL8qV9WEzLwi5WFjh2wN97q9GD9pqd9umcTypxy,True,8468522,2117130,13057,6528,6529,72FwbpFGoLEazJEdpqNtPNefsadUrimUqma9wSoy4qiS,522309,2569533,-2047224,616
2021-12-05 01:50:36.504518,2021-12-04 00:26:05-05:00,357,EvSdLa5PeJiaaaE3omJNG7cw1tptZnHTituYswVHSwm3,68ESX2mBsfxQo2U9jsbmHo7TzPTxr9mGH5Y11ZLR7E3A,True,77470436,19367609,114019,57009,57010,72FwbpFGoLEazJEdpqNtPNefsadUrimUqma9wSoy4qiS,4560779,27220210,-22659431,588
2021-12-05 01:50:36.504518,2021-12-04 00:26:05-05:00,358,C66xkhG3GSswFRqZ8BHATwPbPhyGsWxJ1ymMaDerKbLX,HkJXe2vivbt9aVuJkmA11w9uz8Kbg4fB9sdL2fUmJcQR,True,88654182,22163545,138707,69353,69354,72FwbpFGoLEazJEdpqNtPNefsadUrimUqma9wSoy4qiS,5548319,29211132,-23662813,625
2021-12-05 01:50:36.504518,2021-12-04 00:26:13-05:00,359,DE8KcmECtrF8XoCzuiTJLDFgm4cTSjQFJYSP81WHfr8L,J9GYsnRjDbkwrcqa1XfBmVNXqa9pgzzRymdntFZu1PCv,True,114468225,28617056,168857,84428,84429,72FwbpFGoLEazJEdpqNtPNefsadUrimUqma9wSoy4qiS,6754305,37903690,-31149385,590
2021-12-05 01:50:36.504518,2021-12-04 00:26:13-05:00,360,DSnvQca2ReL3mzwucUGzXTqhxqX5BABy4XvoWDLUfKCU,GfRyJVAx5ckPZn4iJ9ZW9yrLVsw3a2nzwg8QVWaQ6qkF,True,843619488,210904872,1282472,641236,641236,72FwbpFGoLEazJEdpqNtPNefsadUrimUqma9wSoy4qiS,51298910,256699984,-205401074,608
2021-12-05 01:50:36.504518,2021-12-04 00:26:14-05:00,361,8w1hzDtCFuTJqWAtwihztrPzxwa7YrJH5uPk877SJnNj,D3gnctosqTZxTQNfLJQRdPgCvGx2JLLHHDmcvW5UX1QN,True,1292771437,323192859,1899887,949943,949944,72FwbpFGoLEazJEdpqNtPNefsadUrimUqma9wSoy4qiS,75995491,335849413,-259853922,587
2021-12-05 01:50:36.504518,2021-12-04 00:27:32-05:00,362,E5KDZriZ89a5D4VsMaWxndMMG68RT4weruJ1tCEc6tSx,CaSwkUocpbyyGCQBgKjJZJgcexbyqs2GTrGJH6EMWXAz,True,5534004227,1383501056,8266359,4133179,4133180,72FwbpFGoLEazJEdpqNtPNefsadUrimUqma9wSoy4qiS,330654386,1781685620,-1451031234,597
2021-12-05 01:50:36.504518,2021-12-04 00:27:32-05:00,363,FEWgesdpjtMv15TjLLY1LHjzXjZDaLENFTdjuhbwdBg9,4J2YMa9XUzLMfjYDwHeD4GRmXHFBGywYsmcVFvCDYW6T,True,521668962,130417240,767153,383576,383577,72FwbpFGoLEazJEdpqNtPNefsadUrimUqma9wSoy4qiS,30686136,160255572,-129569436,588
2021-12-05 01:50:36.504518,2021-12-04 00:27:33-05:00,364,A4Ce8RnM3qZW9Njo363ywPyhpcUqQTH2PVJn2ugYMmqx,DWSTAcKdqtc8qixLxWGx4shHe1PT2h4hDSMDVQqn1N8L,True,5195795,1298948,7928,3964,3964,72FwbpFGoLEazJEdpqNtPNefsadUrimUqma9wSoy4qiS,317137,1766016,-1448879,610
2021-12-05 01:50:36.504518,2021-12-04 00:27:37-05:00,365,7ckvB1uchDPcA5vkjJvu4DHCkgGq81qbJrd4P2CwPDV8,pVjScFyTQfYJ74uA9JLEsChSrtY8fRi2dCM3jtWC6bp,True,57290377,14322594,88236,44118,44118,72FwbpFGoLEazJEdpqNtPNefsadUrimUqma9wSoy4qiS,3529450,16815958,-13286508,616
2021-12-05 01:50:36.504518,2021-12-04 00:27:52-05:00,366,FV9CBGGTbppLnBKh79f2LzD1diTiS5g6u89FcpZHZmnK,Fe7mtmCUziFqbbYTvrhAcAq1Ub7YLfTJRtQ1hG7GzJD1,True,39537082,9884270,61733,30866,30867,72FwbpFGoLEazJEdpqNtPNefsadUrimUqma9wSoy4qiS,2469348,10019999,-7550651,624
2021-12-05 01:50:36.504518,2021-12-04 00:27:52-05:00,367,5Rxuqgs4CaSKbfDXqBMFXkLTQ9dxrUjThXzoy3ouYVtK,BgvbKru66ebrGUcFFymGTmsaQv6GgcGMybiWaXqzBtwX,True,34581600,8645400,53565,26782,26783,72FwbpFGoLEazJEdpqNtPNefsadUrimUqma9wSoy4qiS,2142600,8807609,-6665009,619
2021-12-05 01:50:36.504518,2021-12-04 00:27:53-05:00,368,3LfgumhfN7fRDEPhEN8SfVWXVnmSj6wuWQ1qYxKv6Eup,BYDZyXhUyMKvQnsnVLT8RqNYqUtf5SAFZGZx99E5dUmW,True,2299494,574873,3535,1767,1768,72FwbpFGoLEazJEdpqNtPNefsadUrimUqma9wSoy4qiS,141404,654475,-513071,614
2021-12-05 01:50:36.504518,2021-12-04 00:27:55-05:00,369,2g4SyyPcuijqJtfVrxeNs6z5iEAuyizoG1PyTXvxN7SH,4fez27oGJ3gKdY4JKpPVT2bzMNhDWAAQ64J5kxNUAf1e,True,563678896,140919724,864212,432106,432106,72FwbpFGoLEazJEdpqNtPNefsadUrimUqma9wSoy4qiS,34568496,130822940,-96254444,613
2021-12-05 01:50:36.504518,2021-12-04 00:28:02-05:00,370,9hzdQrYGDWaS9vDhDZGjh79WxE1urqR4ubNacHddr4Us,971fdspGqjQBdVuG7D5JGvxsRYDJPtAMHaJrQQzDuBUg,True,69953389,17488347,107913,53956,53957,72FwbpFGoLEazJEdpqNtPNefsadUrimUqma9wSoy4qiS,4316542,22844541,-18527999,617
2021-12-05 01:50:36.504518,2021-12-04 00:28:02-05:00,371,HnUkyFhntoajDEgXMKeoh4nAuY5y7osLYwmYAApyLSNs,GntEkHxrGpcHFCVLQGjKiXWdenbsqfQgxddpEpxpE65z,True,47429385,11857346,72914,36457,36457,72FwbpFGoLEazJEdpqNtPNefsadUrimUqma9wSoy4qiS,2916583,14544534,-11627951,614
2021-12-05 01:50:36.504518,2021-12-04 00:28:20-05:00,372,8GuH7tofwd6okCa9CPV4kbZ1RdpjPAS14kzKgJrUhbP5,DW3PVKVSBEswSoyfFsne169qSSt9Z3JFXcaLqFVSiYfY,True,196838979,49209744,307544,153772,153772,72FwbpFGoLEazJEdpqNtPNefsadUrimUqma9wSoy4qiS,12301787,69383830,-57082043,624
2021-12-05 01:50:36.504518,2021-12-04 00:28:20-05:00,373,6HzCJnV3Z4psm7V64UpJBstZxK2XAxUySyuoX8RJaFwY,2AsimTXANwSRChLJWdLjdJG8X2gwGsrjPguqFZjuAeA9,True,21946002,5486500,34079,17039,17040,72FwbpFGoLEazJEdpqNtPNefsadUrimUqma9wSoy4qiS,1363168,6396761,-5033593,621
2021-12-05 01:50:36.504518,2021-12-04 00:28:20-05:00,374,Gq7fPzML38eX6tSedGqCMhmbw7WsaSEYoEZM3BucjZh8,AvEB59ycFk7Y74Wt79cUV9B49GJqwc5c26GCGc29i5zC,True,62500444,15625111,97248,48624,48624,72FwbpFGoLEazJEdpqNtPNefsadUrimUqma9wSoy4qiS,3889927,20485175,-16595248,622
2021-12-05 01:50:36.504518,2021-12-04 00:28:21-05:00,375,EBUcTqh9AYyRokZRzLbPKL9ZmTUx6KcDEbBeuCLGwqYC,B5WSXfHzYQhUFE2T97GaiqSkeejTWKKGVjMkcFrxEvyJ,True,74897454,18724363,116443,58221,58222,72FwbpFGoLEazJEdpqNtPNefsadUrimUqma9wSoy4qiS,4657725,22565277,-17907552,621
2021-12-05 01:50:36.504518,2021-12-04 00:28:26-05:00,376,3VdSA9CED9f5swRwHX2U15U7J6Muaq8VPnCNy9CaGDHe,2YYstfnfdYic5NWmEbcUEHpccNUVd1EhuCkExvMsoMk8,True,1118897280,279724320,1718955,859477,859478,72FwbpFGoLEazJEdpqNtPNefsadUrimUqma9wSoy4qiS,68758221,259728631,-190970410,614
2021-12-05 01:50:36.504518,2021-12-04 00:29:38-05:00,377,GbPWktFegZQEz5CDL2kphHexVrQgy3hTmXa8mCEZtdps,BVQzSYxgF1v6ftSLe5mftqgvretxPcNCrtN8RrHKDn5x,True,654963840,163740960,934452,467226,467226,72FwbpFGoLEazJEdpqNtPNefsadUrimUqma9wSoy4qiS,37378089,167695991,-130317902,570
2021-12-05 01:50:36.504518,2021-12-04 00:31:27-05:00,378,3VdSA9CED9f5swRwHX2U15U7J6Muaq8VPnCNy9CaGDHe,2YYstfnfdYic5NWmEbcUEHpccNUVd1EhuCkExvMsoMk8,True,823154400,205788600,1275517,637758,637759,72FwbpFGoLEazJEdpqNtPNefsadUrimUqma9wSoy4qiS,51020706,210327828,-159307122,619
2021-12-05 01:50:36.504518,2021-12-04 00:31:30-05:00,379,5Rxuqgs4CaSKbfDXqBMFXkLTQ9dxrUjThXzoy3ouYVtK,BgvbKru66ebrGUcFFymGTmsaQv6GgcGMybiWaXqzBtwX,True,25436160,6359040,39724,19862,19862,72FwbpFGoLEazJEdpqNtPNefsadUrimUqma9wSoy4qiS,1588995,7088344,-5499349,624
2021-12-05 01:50:36.504518,2021-12-04 00:32:39-05:00,380,FFsQo78UMHAfXc8F38txcR3sjWCqEjLT9AGoCvtuWbh6,Bn1dsirxXSzuWVCz8rSnGXDz7UTUV2yLqfa8QNa7QgcR,True,6213945,1553486,9108,4554,4554,72FwbpFGoLEazJEdpqNtPNefsadUrimUqma9wSoy4qiS,364324,1650418,-1286094,586
2021-12-05 01:50:36.504518,2021-12-04 00:32:39-05:00,381,9kK2PuehQxgcXtnYnPNmukmzfDTsVHv15pE86xwi7vYt,DtbCSCur1w6ZMGu56auQaHf8c6gVDJoD1iEwiUyCBcYJ,True,16557109,4139277,24542,12271,12271,72FwbpFGoLEazJEdpqNtPNefsadUrimUqma9wSoy4qiS,981718,5780237,-4798519,592
2021-12-05 01:50:36.504518,2021-12-04 00:32:39-05:00,382,2qsrQ75TWz5g3KVoWbKKa9DsLQ5uCAndmfjqPsWzwExJ,Bj7LHrHSg9M3H9ZxFCxqdw8u79iw8K2awJHzk7QNdayy,True,2462323,615580,3647,1823,1824,72FwbpFGoLEazJEdpqNtPNefsadUrimUqma9wSoy4qiS,145890,683588,-537698,592
2021-12-05 01:50:36.504518,2021-12-04 00:32:39-05:00,383,3TTUCUbDMr98vbwUidKDsmkVdLavhTsypKwMvn7s3De6,53PNcr23uUHeNEQWzez9BZdSDMvqMw3DR5NcMAQvDhrq,True,15997440173,3999360043,24452792,12226396,12226396,9S3tZN1dKmwsMw7We6YNFamHgC8GttWEJU54tAHEaJPC,978111692,4091214377,-3113102685,611
2021-12-05 01:50:36.504518,2021-12-04 00:32:42-05:00,384,J2gTwrYpzezkRupgBtgudQn5D33x6WjeBhTHnrA1qgqa,FBzoHRwqGRjnMvPEpiZVjtGZYJmAbneE4dpToXPzy8bv,True,5275523604,1318880901,7601074,3800537,3800537,72FwbpFGoLEazJEdpqNtPNefsadUrimUqma9wSoy4qiS,304042995,1793453140,-1489410145,576
2021-12-05 01:50:36.504518,2021-12-04 00:32:43-05:00,385,BHQFfHCfTAp6xYFNdHRv65BtaobfhBaLFp2KTMxL6ZhN,Eg8q7M4e3qQvUUGqy8QZVxgE6hR1rtdsYPUXqksJhkv3,True,313331808,78332952,453079,226539,226540,72FwbpFGoLEazJEdpqNtPNefsadUrimUqma9wSoy4qiS,18123191,79778316,-61655125,578
2021-12-05 01:50:36.504518,2021-12-04 00:32:43-05:00,386,2bjiHeP82LQ56fEsqR7xEZ9xyyE8LLeeNc7LBvSQm54r,6wdVmvunXFaPuCAXiDdYNmoumYkXz8M5C5vRnBZ9HSXT,True,398663199,99665799,590811,295405,295406,72FwbpFGoLEazJEdpqNtPNefsadUrimUqma9wSoy4qiS,23632449,92724642,-69092193,592
2021-12-05 01:50:36.504518,2021-12-04 00:32:48-05:00,387,E3uCNxXMRHD2ayCY48Kafwy55443r3p1EijT92ug26yd,AMqLEmYQZRhhE7dRQQ21QYfBbthnAVQvmPh9PNbyavta,True,5094495,1273623,7222,3611,3611,72FwbpFGoLEazJEdpqNtPNefsadUrimUqma9wSoy4qiS,288911,1530170,-1241259,567
2021-12-05 01:50:36.504518,2021-12-04 00:32:57-05:00,388,GSaQj6w7ssfDpMGzMQd4pyhZvLeGvYc1Vc9Qcsx1t69g,HSNX4PwuAAuUncgs11suc9rFJ6ntB8BRN7ViFYT9RATM,True,1743860960,435965240,2672566,1336283,1336283,72FwbpFGoLEazJEdpqNtPNefsadUrimUqma9wSoy4qiS,106902650,484185342,-377282692,613
2021-12-05 01:50:36.504518,2021-12-04 00:33:22-05:00,389,2JH43pKUeXTXPd6LnL4BWgGQpwZHhX8EqyohKCFLAS4i,Bir3EKnDWkv6XX7KmoqAi1y6rxSaC5RfVV6Hwvnkfr2i,True,43993829,10998457,68771,34385,34386,72FwbpFGoLEazJEdpqNtPNefsadUrimUqma9wSoy4qiS,2750849,12189479,-9438630,625
2021-12-05 01:50:36.504518,2021-12-04 00:33:40-05:00,390,6woJkgUd2cpQQQBEp1C2G9NsYAvPwYmZXXTd6AxhieMy,E6xCdLJbDq5qFsvHEffD1Qfqrsj19H81mbj7XMUXUPnr,True,4045454490,1011363622,6158249,3079124,3079125,72FwbpFGoLEazJEdpqNtPNefsadUrimUqma9wSoy4qiS,246329978,821794527,-575464549,608
2021-12-05 01:50:36.504518,2021-12-04 00:33:51-05:00,391,DVV4Vhk44E5YvVzpXgjJMepYgUB5uKXmAhEbFg6R5vWJ,8CS7rCKNx7AQ5yaEA2rHrYx4PHnC9mK3DtSQmiKW2nUb,True,280391414,70097853,432245,216122,216123,72FwbpFGoLEazJEdpqNtPNefsadUrimUqma9wSoy4qiS,17289820,93308498,-76018678,616
2021-12-05 01:50:36.504518,2021-12-04 00:34:25-05:00,392,CUhCSd7jHvycC89L6EqMoDWcWVTXXHhAeXVyB4362qZg,J7B9JBV1xR8a7DKKrw3JwGusY4H2bSQuyHtod2Fzf4jq,True,116386615,29096653,179575,89787,89788,72FwbpFGoLEazJEdpqNtPNefsadUrimUqma9wSoy4qiS,7183027,39789258,-32606231,617
2021-12-05 01:50:36.504518,2021-12-04 00:34:30-05:00,393,DSEgVqfxXp5wxjn3gNZtmb4E6rJeBm3VcbqdwDnsuzSq,6YVCWznUKheSMPuywSRJgCes7wghPGJXgxfrVfnjN4mB,True,1425193220,356298305,2217512,1108756,1108756,72FwbpFGoLEazJEdpqNtPNefsadUrimUqma9wSoy4qiS,88700491,330155148,-241454657,622
2021-12-05 01:50:36.504518,2021-12-04 00:34:32-05:00,394,94KFzzXCAvEfSf3jrnUpyN3pne8Xfc6nroB7UxTVqeyB,ERQEKcL8qV9WEzLwi5WFjh2wN97q9GD9pqd9umcTypxy,True,6231024,1557756,9722,4861,4861,72FwbpFGoLEazJEdpqNtPNefsadUrimUqma9wSoy4qiS,388884,2044718,-1655834,624
2021-12-05 01:50:36.504518,2021-12-04 00:34:34-05:00,395,6Rk6wVu6pCDFwEWDbiY8wS93nDghyHP9kzdUEa6eFRRq,B5v7eFjSX6dDt1kt84Uvtqmrn7STbQPMbFMvjH6WGXJg,True,1453921737,363480433,2223923,1111961,1111962,72FwbpFGoLEazJEdpqNtPNefsadUrimUqma9wSoy4qiS,88956928,491712636,-402755708,611
2021-12-05 01:50:36.504518,2021-12-04 00:34:42-05:00,396,FP6SmbXDbcb6c8Pi8uZMn6hnQDUbvbdCfzd5pEqyBgTm,53A9dhER1x3JjdceGMQmjujvWht7uemsoB3ngQLdo6Ub,True,1372210563,343052640,2087611,1043805,1043806,72FwbpFGoLEazJEdpqNtPNefsadUrimUqma9wSoy4qiS,83504471,412286571,-328782100,608
2021-12-05 01:50:36.504518,2021-12-04 00:34:42-05:00,397,EvSdLa5PeJiaaaE3omJNG7cw1tptZnHTituYswVHSwm3,68ESX2mBsfxQo2U9jsbmHo7TzPTxr9mGH5Y11ZLR7E3A,True,57222766,14305691,89167,44583,44584,72FwbpFGoLEazJEdpqNtPNefsadUrimUqma9wSoy4qiS,3566699,21441644,-17874945,623
2021-12-05 01:50:36.504518,2021-12-04 00:34:42-05:00,398,8w1hzDtCFuTJqWAtwihztrPzxwa7YrJH5uPk877SJnNj,D3gnctosqTZxTQNfLJQRdPgCvGx2JLLHHDmcvW5UX1QN,True,955092218,238773054,1490231,745115,745116,72FwbpFGoLEazJEdpqNtPNefsadUrimUqma9wSoy4qiS,59609244,269055095,-209445851,624
2021-12-05 01:50:36.504518,2021-12-04 00:34:52-05:00,399,DE8KcmECtrF8XoCzuiTJLDFgm4cTSjQFJYSP81WHfr8L,J9GYsnRjDbkwrcqa1XfBmVNXqa9pgzzRymdntFZu1PCv,True,84488936,21122234,130580,65290,65290,72FwbpFGoLEazJEdpqNtPNefsadUrimUqma9wSoy4qiS,5223215,29948127,-24724912,618
2021-12-05 01:50:36.504518,2021-12-04 00:45:24-05:00,400,BgoKAyBNaJ1geeQ2FcGSHEQDWATVD3w3wmcNHtj8Awu3,8Haz7duE2ycueaJsGdrGNnK79KGHwnzKBpoafC8RZGg2,True,4302729200,1075682300,6631022,3315511,3315511,4BnQKPLuE3DMTtxp8MjUBytgnhvxqq3ZTqZHTVZo4JJh,265240897,962006697,-696765800,616
2021-12-05 01:50:36.504518,2021-12-04 00:46:12-05:00,401,C8P84Hs3ARCuQNvkRo8F9UcGMeYeZbNW4UUy4cfW3mV7,8XT1CpJzma29EiwATKe8qe9MAuZwcUoV9skvCjjfyeBJ,True,200083180,50020795,306467,153233,153234,72FwbpFGoLEazJEdpqNtPNefsadUrimUqma9wSoy4qiS,12258687,46175507,-33916820,612
2021-12-05 01:50:36.504518,2021-12-04 00:46:12-05:00,402,Cea5Ry4zLro67jEoS3ba213KYNbvq6VXyZ6JgnjTHd89,DCSyLohbXL5yhmu9ESBHR4ku4MgfnSoNeUsL7oDcEG8Z,True,4535655900,1133913975,6846209,3423104,3423105,72FwbpFGoLEazJEdpqNtPNefsadUrimUqma9wSoy4qiS,273848367,1031273018,-757424651,603
2021-12-05 01:50:36.504518,2021-12-04 00:46:18-05:00,403,E4iZW2i7YcrVadVRGaRNGathDN3pQY1W2tjBExek1rMh,3amQVHc5eUWMTpvK9cgAr8Rxit75o4JfqdcnMgqbUBmv,True,1590686940,397671735,2247280,1123640,1123640,72FwbpFGoLEazJEdpqNtPNefsadUrimUqma9wSoy4qiS,89891233,359005400,-269114167,565
2021-12-05 01:50:36.504518,2021-12-04 00:46:20-05:00,404,DH2tcZVt4nHQbph6znZRrwcyhjwiNYtgeamu72vcC6nR,ACsbP5BDFQEHQHTsdrWTBShhEUh9HeAKsE7iwyK72v2p,True,143576360,35894090,212719,106359,106360,72FwbpFGoLEazJEdpqNtPNefsadUrimUqma9wSoy4qiS,8508772,33033271,-24524499,592
2021-12-05 01:50:36.504518,2021-12-04 00:46:22-05:00,405,6woJkgUd2cpQQQBEp1C2G9NsYAvPwYmZXXTd6AxhieMy,E6xCdLJbDq5qFsvHEffD1Qfqrsj19H81mbj7XMUXUPnr,True,2970285840,742571460,4409167,2204583,2204584,72FwbpFGoLEazJEdpqNtPNefsadUrimUqma9wSoy4qiS,176366701,671986711,-495620010,593
2021-12-05 01:50:36.504518,2021-12-04 00:47:44-05:00,406,GKNBtZbwK4w9hyXD1r38NTGcTJhpjt8R9WFCzdXup9Tk,7RLaL2XoFuqrcCcPEB6FzPJzLnAhjQpwcRmDfdpRXFgB,True,3858216000,964554000,5980967,2990483,2990484,72FwbpFGoLEazJEdpqNtPNefsadUrimUqma9wSoy4qiS,239238681,880568181,-641329500,620
2021-12-05 01:50:36.504518,2021-12-04 00:48:12-05:00,407,4gzW9gBbEMnNm1epY6MMJ1XfxGMtvn2mKFyKPQ2Gyb79,G6x862hmMJ2PLpyyPDwVPGapXjvEeNkqFRTAS3jWVozB,True,387942000,96985500,605741,302870,302871,72FwbpFGoLEazJEdpqNtPNefsadUrimUqma9wSoy4qiS,24229654,92200195,-67970541,624
2021-12-05 01:50:36.504518,2021-12-04 00:48:26-05:00,408,BgoKAyBNaJ1geeQ2FcGSHEQDWATVD3w3wmcNHtj8Awu3,8Haz7duE2ycueaJsGdrGNnK79KGHwnzKBpoafC8RZGg2,True,3165552000,791388000,4927874,2463937,2463937,72FwbpFGoLEazJEdpqNtPNefsadUrimUqma9wSoy4qiS,197114975,781438076,-584323101,622
2021-12-05 01:50:36.504518,2021-12-04 00:48:37-05:00,409,J1sBDjpdBZcsSBS5eg95SSRjRqmQUR9cXJCsLJu8yCUt,F5wRpD2senMkGbL8Uquqo8W9x5NQDDa268dHuVFAZCww,True,405726000,101431500,608293,304146,304147,72FwbpFGoLEazJEdpqNtPNefsadUrimUqma9wSoy4qiS,24331724,98142309,-73810585,599
2021-12-05 01:50:36.504518,2021-12-04 00:48:43-05:00,410,E4iZW2i7YcrVadVRGaRNGathDN3pQY1W2tjBExek1rMh,3amQVHc5eUWMTpvK9cgAr8Rxit75o4JfqdcnMgqbUBmv,True,1177962000,294490500,1814768,907384,907384,72FwbpFGoLEazJEdpqNtPNefsadUrimUqma9wSoy4qiS,72590748,289526497,-216935749,616
2021-12-05 01:50:36.504518,2021-12-04 00:49:12-05:00,411,3qyKG4juvhcDnhoSVAFibqJtk5i4q8vLVgvwzXtdk5KP,2ofR6Hdm8qgQfKnaNFouzzBs311xgPcxny4ViS7g2Wxo,True,88934700,22233675,137677,68838,68839,72FwbpFGoLEazJEdpqNtPNefsadUrimUqma9wSoy4qiS,5507105,21572405,-16065300,619
2021-12-05 01:50:36.504518,2021-12-04 01:14:45-05:00,412,6woJkgUd2cpQQQBEp1C2G9NsYAvPwYmZXXTd6AxhieMy,E6xCdLJbDq5qFsvHEffD1Qfqrsj19H81mbj7XMUXUPnr,True,2195092200,548773050,3388023,1694011,1694012,4BnQKPLuE3DMTtxp8MjUBytgnhvxqq3ZTqZHTVZo4JJh,135520922,539976407,-404455485,617
2021-12-05 01:50:36.504518,2021-12-04 01:14:46-05:00,413,DH2tcZVt4nHQbph6znZRrwcyhjwiNYtgeamu72vcC6nR,ACsbP5BDFQEHQHTsdrWTBShhEUh9HeAKsE7iwyK72v2p,True,106082100,26520525,162787,81393,81394,72FwbpFGoLEazJEdpqNtPNefsadUrimUqma9wSoy4qiS,6511503,26512242,-20000739,613
2021-12-05 01:50:36.504518,2021-12-04 01:16:38-05:00,414,Cea5Ry4zLro67jEoS3ba213KYNbvq6VXyZ6JgnjTHd89,DCSyLohbXL5yhmu9ESBHR4ku4MgfnSoNeUsL7oDcEG8Z,True,3350170500,837542625,5240161,2620080,2620081,4BnQKPLuE3DMTtxp8MjUBytgnhvxqq3ZTqZHTVZo4JJh,209606446,829524480,-619918034,625
2021-12-05 01:50:36.504518,2021-12-04 01:18:12-05:00,415,C8P84Hs3ARCuQNvkRo8F9UcGMeYeZbNW4UUy4cfW3mV7,8XT1CpJzma29EiwATKe8qe9MAuZwcUoV9skvCjjfyeBJ,True,147525750,36881437,228966,114483,114483,72FwbpFGoLEazJEdpqNtPNefsadUrimUqma9wSoy4qiS,9158669,37146132,-27987463,620
2021-12-05 01:50:36.504518,2021-12-04 02:10:48-05:00,416,GKNBtZbwK4w9hyXD1r38NTGcTJhpjt8R9WFCzdXup9Tk,7RLaL2XoFuqrcCcPEB6FzPJzLnAhjQpwcRmDfdpRXFgB,True,2846706900,711676725,4453134,2226567,2226567,72FwbpFGoLEazJEdpqNtPNefsadUrimUqma9wSoy4qiS,178125376,706284982,-528159606,625
2021-12-05 01:50:36.504518,2021-12-04 02:11:04-05:00,417,UJ6ntLsLvDndrqeHcW18GApMs1smigx1yM1RRPrw5cP,HY1KY2jXT1fU6HrS2DySXFsLgykZzhR6AxdLYScU7giX,True,4150050,1037512,5201,2600,2601,72FwbpFGoLEazJEdpqNtPNefsadUrimUqma9wSoy4qiS,208047,1057997,-849950,501
2021-12-05 01:50:36.504518,2021-12-04 02:11:46-05:00,418,4gzW9gBbEMnNm1epY6MMJ1XfxGMtvn2mKFyKPQ2Gyb79,G6x862hmMJ2PLpyyPDwVPGapXjvEeNkqFRTAS3jWVozB,True,285841800,71460450,442154,221077,221077,72FwbpFGoLEazJEdpqNtPNefsadUrimUqma9wSoy4qiS,17686186,73785914,-56099728,618
2021-12-05 01:50:36.504518,2021-12-04 02:15:31-05:00,419,J1sBDjpdBZcsSBS5eg95SSRjRqmQUR9cXJCsLJu8yCUt,F5wRpD2senMkGbL8Uquqo8W9x5NQDDa268dHuVFAZCww,True,299997450,74999362,463988,231994,231994,72FwbpFGoLEazJEdpqNtPNefsadUrimUqma9wSoy4qiS,18559528,78228718,-59669190,618
2021-12-05 01:50:36.504518,2021-12-04 02:16:02-05:00,420,E4iZW2i7YcrVadVRGaRNGathDN3pQY1W2tjBExek1rMh,3amQVHc5eUWMTpvK9cgAr8Rxit75o4JfqdcnMgqbUBmv,True,869520750,217380187,1357693,678846,678847,4BnQKPLuE3DMTtxp8MjUBytgnhvxqq3ZTqZHTVZo4JJh,54307733,230995655,-176687922,624
2021-12-05 01:50:36.504518,2021-12-04 02:16:03-05:00,421,BgoKAyBNaJ1geeQ2FcGSHEQDWATVD3w3wmcNHtj8Awu3,8Haz7duE2ycueaJsGdrGNnK79KGHwnzKBpoafC8RZGg2,True,2333351400,583337850,3615453,1807726,1807727,72FwbpFGoLEazJEdpqNtPNefsadUrimUqma9wSoy4qiS,144618121,623822629,-479204508,619
2021-12-05 01:50:36.504518,2021-12-04 06:24:28-05:00,422,3qyKG4juvhcDnhoSVAFibqJtk5i4q8vLVgvwzXtdk5KP,2ofR6Hdm8qgQfKnaNFouzzBs311xgPcxny4ViS7g2Wxo,True,65718600,16429650,100751,50375,50376,4BnQKPLuE3DMTtxp8MjUBytgnhvxqq3ZTqZHTVZo4JJh,4030040,17074195,-13044155,613
2021-12-05 01:50:36.504518,2021-12-04 06:24:33-05:00,423,BCGo6RhFcVnLCzZxtEh5YDyfq59nEWXPyJ5STC9PkzA1,24ShUfs1AB1n5NUus99sZ58kuSvMPhVgpiiT56rcLHRk,True,373618200,93404550,577849,288924,288925,4BnQKPLuE3DMTtxp8MjUBytgnhvxqq3ZTqZHTVZo4JJh,23113979,84566485,-61452506,618
2021-12-05 01:50:36.504518,2021-12-04 06:32:23-05:00,424,C8P84Hs3ARCuQNvkRo8F9UcGMeYeZbNW4UUy4cfW3mV7,8XT1CpJzma29EiwATKe8qe9MAuZwcUoV9skvCjjfyeBJ,True,108924600,27231150,170233,85116,85117,72FwbpFGoLEazJEdpqNtPNefsadUrimUqma9wSoy4qiS,6809328,29533164,-22723836,625
2021-12-05 01:50:36.504518,2021-12-04 06:32:23-05:00,425,6woJkgUd2cpQQQBEp1C2G9NsYAvPwYmZXXTd6AxhieMy,E6xCdLJbDq5qFsvHEffD1Qfqrsj19H81mbj7XMUXUPnr,True,1616984550,404246137,2421251,1210625,1210626,72FwbpFGoLEazJEdpqNtPNefsadUrimUqma9wSoy4qiS,96850061,429599589,-332749528,598
2021-12-05 01:50:36.504518,2021-12-04 06:32:28-05:00,426,DH2tcZVt4nHQbph6znZRrwcyhjwiNYtgeamu72vcC6nR,ACsbP5BDFQEHQHTsdrWTBShhEUh9HeAKsE7iwyK72v2p,True,78168750,19542187,116708,58354,58354,72FwbpFGoLEazJEdpqNtPNefsadUrimUqma9wSoy4qiS,4668351,21071089,-16402738,597
2021-12-05 01:50:36.504518,2021-12-04 06:43:10-05:00,427,UJ6ntLsLvDndrqeHcW18GApMs1smigx1yM1RRPrw5cP,HY1KY2jXT1fU6HrS2DySXFsLgykZzhR6AxdLYScU7giX,False,3069900,3069900,152253,7612,144641,72FwbpFGoLEazJEdpqNtPNefsadUrimUqma9wSoy4qiS,152253,848659,-696406,495
2021-12-05 01:50:36.504518,2021-12-04 06:43:10-05:00,428,GKNBtZbwK4w9hyXD1r38NTGcTJhpjt8R9WFCzdXup9Tk,7RLaL2XoFuqrcCcPEB6FzPJzLnAhjQpwcRmDfdpRXFgB,True,2095888950,523972237,3229311,1614655,1614656,72FwbpFGoLEazJEdpqNtPNefsadUrimUqma9wSoy4qiS,129172452,564559481,-435387029,616
2021-12-05 01:50:36.504518,2021-12-04 06:43:32-05:00,429,4gzW9gBbEMnNm1epY6MMJ1XfxGMtvn2mKFyKPQ2Gyb79,G6x862hmMJ2PLpyyPDwVPGapXjvEeNkqFRTAS3jWVozB,True,210799800,52699950,328078,164039,164039,72FwbpFGoLEazJEdpqNtPNefsadUrimUqma9wSoy4qiS,13123158,58788656,-45665498,622
2021-12-05 15:45:56.119212,2021-12-05 10:43:22-05:00,430,C66xkhG3GSswFRqZ8BHATwPbPhyGsWxJ1ymMaDerKbLX,HkJXe2vivbt9aVuJkmA11w9uz8Kbg4fB9sdL2fUmJcQR,False,63443262,63443262,2071940,103597,1968343,72FwbpFGoLEazJEdpqNtPNefsadUrimUqma9wSoy4qiS,2071940,22866816,-20794876,326
2021-12-05 15:45:56.119212,2021-12-05 10:43:23-05:00,431,GSaQj6w7ssfDpMGzMQd4pyhZvLeGvYc1Vc9Qcsx1t69g,HSNX4PwuAAuUncgs11suc9rFJ6ntB8BRN7ViFYT9RATM,False,1261361076,1261361076,51923929,2596196,49327733,72FwbpFGoLEazJEdpqNtPNefsadUrimUqma9wSoy4qiS,51923929,381548439,-329624510,411
2021-12-05 15:45:56.119212,2021-12-05 10:43:23-05:00,432,FEWgesdpjtMv15TjLLY1LHjzXjZDaLENFTdjuhbwdBg9,4J2YMa9XUzLMfjYDwHeD4GRmXHFBGywYsmcVFvCDYW6T,False,374185478,374185478,11140169,557008,10583161,72FwbpFGoLEazJEdpqNtPNefsadUrimUqma9wSoy4qiS,11140169,125395244,-114255075,297
2021-12-05 15:45:56.119212,2021-12-05 10:43:23-05:00,433,CUhCSd7jHvycC89L6EqMoDWcWVTXXHhAeXVyB4362qZg,J7B9JBV1xR8a7DKKrw3JwGusY4H2bSQuyHtod2Fzf4jq,True,85262141,21315535,114720,57360,57360,72FwbpFGoLEazJEdpqNtPNefsadUrimUqma9wSoy4qiS,4588804,31071932,-26483128,538
2021-12-05 15:45:56.119212,2021-12-05 10:43:24-05:00,434,FFsQo78UMHAfXc8F38txcR3sjWCqEjLT9AGoCvtuWbh6,Bn1dsirxXSzuWVCz8rSnGXDz7UTUV2yLqfa8QNa7QgcR,False,4526230,4526230,200470,10023,190447,72FwbpFGoLEazJEdpqNtPNefsadUrimUqma9wSoy4qiS,200470,1299340,-1098870,442
2021-12-05 15:45:56.119212,2021-12-05 10:43:25-05:00,435,E5KDZriZ89a5D4VsMaWxndMMG68RT4weruJ1tCEc6tSx,CaSwkUocpbyyGCQBgKjJZJgcexbyqs2GTrGJH6EMWXAz,True,4075724256,1018931064,5692804,2846402,2846402,72FwbpFGoLEazJEdpqNtPNefsadUrimUqma9wSoy4qiS,227712160,1391695748,-1163983588,558
2021-12-05 15:45:56.119212,2021-12-05 10:43:25-05:00,436,3Ek5j2ea8wS2nCxsNgn2AbovxzJwGK7zc6xarkigSA3u,DEWmTn3Ah4F3nNXpoQLt1GG65Dsf4ZmGjn7FZUJyK6rP,True,1502976916,375744229,2032054,1016027,1016027,72FwbpFGoLEazJEdpqNtPNefsadUrimUqma9wSoy4qiS,81282194,602777249,-521495055,540
2021-12-05 15:45:56.119212,2021-12-05 10:43:25-05:00,437,8w1hzDtCFuTJqWAtwihztrPzxwa7YrJH5uPk877SJnNj,D3gnctosqTZxTQNfLJQRdPgCvGx2JLLHHDmcvW5UX1QN,True,700417992,175104498,976041,488020,488021,72FwbpFGoLEazJEdpqNtPNefsadUrimUqma9wSoy4qiS,39041647,212065769,-173024122,557
2021-12-05 15:45:56.119212,2021-12-05 10:43:25-05:00,438,3LfgumhfN7fRDEPhEN8SfVWXVnmSj6wuWQ1qYxKv6Eup,BYDZyXhUyMKvQnsnVLT8RqNYqUtf5SAFZGZx99E5dUmW,False,1666659,1666659,72350,3617,68733,72FwbpFGoLEazJEdpqNtPNefsadUrimUqma9wSoy4qiS,72350,515144,-442794,434
2021-12-05 15:45:56.119212,2021-12-05 10:43:25-05:00,439,J2gTwrYpzezkRupgBtgudQn5D33x6WjeBhTHnrA1qgqa,FBzoHRwqGRjnMvPEpiZVjtGZYJmAbneE4dpToXPzy8bv,False,3849153381,3849153381,171488072,8574403,162913669,72FwbpFGoLEazJEdpqNtPNefsadUrimUqma9wSoy4qiS,171488072,1397268112,-1225780040,445
2021-12-05 15:45:56.119212,2021-12-05 10:43:25-05:00,440,DSEgVqfxXp5wxjn3gNZtmb4E6rJeBm3VcbqdwDnsuzSq,6YVCWznUKheSMPuywSRJgCes7wghPGJXgxfrVfnjN4mB,True,1043489290,260872322,1408476,704238,704238,72FwbpFGoLEazJEdpqNtPNefsadUrimUqma9wSoy4qiS,56339044,262917964,-206578920,539
2021-12-05 15:45:56.119212,2021-12-05 10:43:25-05:00,441,3TTUCUbDMr98vbwUidKDsmkVdLavhTsypKwMvn7s3De6,53PNcr23uUHeNEQWzez9BZdSDMvqMw3DR5NcMAQvDhrq,False,11653750882,11653750882,556316388,27815819,528500569,72FwbpFGoLEazJEdpqNtPNefsadUrimUqma9wSoy4qiS,556316388,3246033028,-2689716640,477
2021-12-05 15:45:56.119212,2021-12-05 10:43:25-05:00,442,E3uCNxXMRHD2ayCY48Kafwy55443r3p1EijT92ug26yd,AMqLEmYQZRhhE7dRQQ21QYfBbthnAVQvmPh9PNbyavta,False,3697813,3697813,141776,7088,134688,72FwbpFGoLEazJEdpqNtPNefsadUrimUqma9wSoy4qiS,141776,1195785,-1054009,383
2021-12-05 15:45:56.119212,2021-12-05 10:43:25-05:00,443,8Xdf67Q5jXKwS52e492xUBu1tMUgS14jJg7V4R2Q28EP,GAPL3bsXP4xcukhgzyqrbDntGwUSm5BfuwJ8TLKkRaZc,True,496692928,124173232,650441,325220,325221,72FwbpFGoLEazJEdpqNtPNefsadUrimUqma9wSoy4qiS,26017666,135140538,-109122872,523
2021-12-05 15:45:56.119212,2021-12-05 10:43:25-05:00,444,8GuH7tofwd6okCa9CPV4kbZ1RdpjPAS14kzKgJrUhbP5,DW3PVKVSBEswSoyfFsne169qSSt9Z3JFXcaLqFVSiYfY,False,141949630,141949630,5667643,283382,5384261,72FwbpFGoLEazJEdpqNtPNefsadUrimUqma9wSoy4qiS,5667643,54160561,-48492918,399
2021-12-05 15:45:56.119212,2021-12-05 10:43:25-05:00,445,7ckvB1uchDPcA5vkjJvu4DHCkgGq81qbJrd4P2CwPDV8,pVjScFyTQfYJ74uA9JLEsChSrtY8fRi2dCM3jtWC6bp,False,41274160,41274160,1559461,77973,1481488,72FwbpFGoLEazJEdpqNtPNefsadUrimUqma9wSoy4qiS,1559461,13218140,-11658679,377
2021-12-05 15:45:56.119212,2021-12-05 10:43:25-05:00,446,8Xt3qHjZG3zLxozgM5vPHMVxp8eYFMg89kaVW7vdHKoA,2i8riSsQpfADD9LUVpiBJBfX5qjVAgmZegzfKx6RG9dW,False,20033606,20033606,991292,49564,941728,72FwbpFGoLEazJEdpqNtPNefsadUrimUqma9wSoy4qiS,991292,5893224,-4901932,494
2021-12-05 15:45:56.119212,2021-12-05 10:43:25-05:00,447,6oRHRnLX93bYeTN5YD2XHqskhbv8wN2pgSia9Kz3QkED,D6QG2KYp9vYZZe8tTZux5tDR6fXgm8k4SVWbpaPvEmZ1,True,103242602,25810650,149607,74803,74804,72FwbpFGoLEazJEdpqNtPNefsadUrimUqma9wSoy4qiS,5984309,26290444,-20306135,579
2021-12-05 15:45:56.119212,2021-12-05 10:43:26-05:00,448,Gq7fPzML38eX6tSedGqCMhmbw7WsaSEYoEZM3BucjZh8,AvEB59ycFk7Y74Wt79cUV9B49GJqwc5c26GCGc29i5zC,False,45463035,45463035,2174949,108747,2066202,72FwbpFGoLEazJEdpqNtPNefsadUrimUqma9wSoy4qiS,2174949,16033924,-13858975,478
2021-12-05 15:45:56.119212,2021-12-05 10:43:27-05:00,449,FP6SmbXDbcb6c8Pi8uZMn6hnQDUbvbdCfzd5pEqyBgTm,53A9dhER1x3JjdceGMQmjujvWht7uemsoB3ngQLdo6Ub,True,1009718842,252429710,1435365,717682,717683,72FwbpFGoLEazJEdpqNtPNefsadUrimUqma9wSoy4qiS,57414605,323521162,-266106557,568
2021-12-05 15:45:56.119212,2021-12-05 10:43:27-05:00,450,FV9CBGGTbppLnBKh79f2LzD1diTiS5g6u89FcpZHZmnK,Fe7mtmCUziFqbbYTvrhAcAq1Ub7YLfTJRtQ1hG7GzJD1,False,28737950,28737950,1362890,68144,1294746,72FwbpFGoLEazJEdpqNtPNefsadUrimUqma9wSoy4qiS,1362890,7940833,-6577943,474
2021-12-05 15:45:56.119212,2021-12-05 10:43:27-05:00,451,9hzdQrYGDWaS9vDhDZGjh79WxE1urqR4ubNacHddr4Us,971fdspGqjQBdVuG7D5JGvxsRYDJPtAMHaJrQQzDuBUg,False,50879913,50879913,2393577,119678,2273899,72FwbpFGoLEazJEdpqNtPNefsadUrimUqma9wSoy4qiS,2393577,17874960,-15481383,470
2021-12-05 15:45:56.119212,2021-12-05 10:43:27-05:00,452,FAGKyc6XrDNSchaaYGW6rv48p32ipYZNdGTYRYNekwh2,55oJXDZLx8Vv1HA1GYiS65Zmt4tHr9yuji63SEkiEumS,False,16941723,16941723,833720,41686,792034,72FwbpFGoLEazJEdpqNtPNefsadUrimUqma9wSoy4qiS,833720,3889977,-3056257,492
2021-12-05 15:45:56.119212,2021-12-05 10:43:27-05:00,453,BELLbzmdx1SYke9kZUxFi9VcdvwaHmkZyv24FArQ1J2f,5a5LfKakAaFEVkavVHgExKaUr25RWYpzFic6MUQQ62uc,True,1971941856,492985464,2865160,1432580,1432580,72FwbpFGoLEazJEdpqNtPNefsadUrimUqma9wSoy4qiS,114606411,784815160,-670208749,581
2021-12-05 15:45:56.119212,2021-12-05 10:43:28-05:00,454,DSnvQca2ReL3mzwucUGzXTqhxqX5BABy4XvoWDLUfKCU,GfRyJVAx5ckPZn4iJ9ZW9yrLVsw3a2nzwg8QVWaQ6qkF,False,611455931,611455931,25994802,1299740,24695062,72FwbpFGoLEazJEdpqNtPNefsadUrimUqma9wSoy4qiS,25994802,201334770,-175339968,425
2021-12-05 15:45:56.119212,2021-12-05 10:43:28-05:00,455,Hp4bpHhSds7eMRmW1wpCg8HPUKk5vdRJt9Wm1axJgbcG,5sPxP3PAUqWr5FuHY1kUTz5u1J4pvVB95L1rbxepS2S6,True,934396,233599,1234,617,617,72FwbpFGoLEazJEdpqNtPNefsadUrimUqma9wSoy4qiS,49390,218342,-168952,528
2021-12-05 15:45:56.119212,2021-12-05 10:43:28-05:00,456,2qsrQ75TWz5g3KVoWbKKa9DsLQ5uCAndmfjqPsWzwExJ,Bj7LHrHSg9M3H9ZxFCxqdw8u79iw8K2awJHzk7QNdayy,False,1799075,1799075,86445,4322,82123,72FwbpFGoLEazJEdpqNtPNefsadUrimUqma9wSoy4qiS,86445,537448,-451003,480
2021-12-05 15:45:56.119212,2021-12-05 10:43:29-05:00,457,81GV2H9ipJSZD6YpJGj2XQNfoUroWWnKfwMHGSwvhixd,7cLHoNuNVj8qkn3QmBYLFwja37f1MWEo4e3ZcNSpXTPw,True,3037237860,759309465,4150592,2075296,2075296,72FwbpFGoLEazJEdpqNtPNefsadUrimUqma9wSoy4qiS,166023687,745755836,-579732149,546
2021-12-05 15:45:56.119212,2021-12-05 10:43:30-05:00,458,2JH43pKUeXTXPd6LnL4BWgGQpwZHhX8EqyohKCFLAS4i,Bir3EKnDWkv6XX7KmoqAi1y6rxSaC5RfVV6Hwvnkfr2i,True,32217488,8054372,43965,21982,21983,72FwbpFGoLEazJEdpqNtPNefsadUrimUqma9wSoy4qiS,1758625,9615608,-7856983,545
2021-12-05 15:45:56.119212,2021-12-05 10:43:32-05:00,459,HnUkyFhntoajDEgXMKeoh4nAuY5y7osLYwmYAApyLSNs,GntEkHxrGpcHFCVLQGjKiXWdenbsqfQgxddpEpxpE65z,True,34826498,8706624,48555,24277,24278,72FwbpFGoLEazJEdpqNtPNefsadUrimUqma9wSoy4qiS,1942237,11408882,-9466645,557
2021-12-05 15:45:56.119212,2021-12-05 10:43:32-05:00,460,2bjiHeP82LQ56fEsqR7xEZ9xyyE8LLeeNc7LBvSQm54r,6wdVmvunXFaPuCAXiDdYNmoumYkXz8M5C5vRnBZ9HSXT,True,294648093,73662023,434334,217167,217167,72FwbpFGoLEazJEdpqNtPNefsadUrimUqma9wSoy4qiS,17373366,73548322,-56174956,589
2021-12-05 15:45:56.119212,2021-12-05 10:43:36-05:00,461,9kK2PuehQxgcXtnYnPNmukmzfDTsVHv15pE86xwi7vYt,DtbCSCur1w6ZMGu56auQaHf8c6gVDJoD1iEwiUyCBcYJ,True,12219208,3054802,17597,8798,8799,72FwbpFGoLEazJEdpqNtPNefsadUrimUqma9wSoy4qiS,703886,4501455,-3797569,576
2021-12-06 09:39:36.476810,2021-12-06 04:35:22-05:00,462,DVV4Vhk44E5YvVzpXgjJMepYgUB5uKXmAhEbFg6R5vWJ,8CS7rCKNx7AQ5yaEA2rHrYx4PHnC9mK3DtSQmiKW2nUb,True,207920723,51980180,325312,162656,162656,9S3tZN1dKmwsMw7We6YNFamHgC8GttWEJU54tAHEaJPC,13012510,72402841,-59390331,625
2021-12-06 09:39:36.476810,2021-12-06 04:36:19-05:00,463,CQSb6ZVY1KVNXFAg8pxm8RvBBGGqRSU7FMvwHJPy46u8,FRBv3b5VTfKN1bK4DXFY4329LFbvm882P47edrgpuSM,True,970907004,242726751,1484583,742291,742292,9S3tZN1dKmwsMw7We6YNFamHgC8GttWEJU54tAHEaJPC,59383344,319987081,-260603737,611
2021-12-06 09:39:36.476810,2021-12-06 04:36:21-05:00,464,DE8KcmECtrF8XoCzuiTJLDFgm4cTSjQFJYSP81WHfr8L,J9GYsnRjDbkwrcqa1XfBmVNXqa9pgzzRymdntFZu1PCv,True,62633795,15658448,97855,48927,48928,9S3tZN1dKmwsMw7We6YNFamHgC8GttWEJU54tAHEaJPC,3914217,23191163,-19276946,624
2021-12-06 09:39:36.476810,2021-12-06 04:36:21-05:00,465,94KFzzXCAvEfSf3jrnUpyN3pne8Xfc6nroB7UxTVqeyB,ERQEKcL8qV9WEzLwi5WFjh2wN97q9GD9pqd9umcTypxy,True,4614663,1153665,7193,3596,3597,9S3tZN1dKmwsMw7We6YNFamHgC8GttWEJU54tAHEaJPC,287733,1588246,-1300513,623
2021-12-06 09:39:36.476810,2021-12-06 04:36:22-05:00,466,EvSdLa5PeJiaaaE3omJNG7cw1tptZnHTituYswVHSwm3,68ESX2mBsfxQo2U9jsbmHo7TzPTxr9mGH5Y11ZLR7E3A,True,42388464,10597116,66185,33092,33093,9S3tZN1dKmwsMw7We6YNFamHgC8GttWEJU54tAHEaJPC,2647413,16582396,-13934983,624
2021-12-06 09:39:36.476810,2021-12-06 04:36:40-05:00,467,8soQsYfQCngqJ5gLpWSuuzDUo1YLg53mU6GBF5RBizNn,HdsRtpasJYyFdS3sKqFAwJespt8x7cKUfGuvEuxmWdxV,True,53877047,13469261,82957,41478,41479,9S3tZN1dKmwsMw7We6YNFamHgC8GttWEJU54tAHEaJPC,3318310,12036820,-8718510,615
2021-12-06 09:39:36.476810,2021-12-06 04:37:59-05:00,468,J5WcVsKNHbfioai1LRowvjvtEmUJBEkeoBim1ThshpoP,Ajh7SWBq3zJR4vb6AFoBS6C9D99wC6YF1sVN22qC1vCA,True,483843926,120960981,750546,375273,375273,9S3tZN1dKmwsMw7We6YNFamHgC8GttWEJU54tAHEaJPC,30021872,92070750,-62048878,620
2021-12-06 09:39:36.476810,2021-12-06 04:38:18-05:00,469,6Rk6wVu6pCDFwEWDbiY8wS93nDghyHP9kzdUEa6eFRRq,B5v7eFjSX6dDt1kt84Uvtqmrn7STbQPMbFMvjH6WGXJg,True,816638503,204159625,1268979,634489,634490,72FwbpFGoLEazJEdpqNtPNefsadUrimUqma9wSoy4qiS,50759195,328749045,-277989850,621
2021-12-06 09:39:36.476810,2021-12-06 04:38:45-05:00,470,HnUkyFhntoajDEgXMKeoh4nAuY5y7osLYwmYAApyLSNs,GntEkHxrGpcHFCVLQGjKiXWdenbsqfQgxddpEpxpE65z,True,25890310,6472577,39893,19946,19947,9S3tZN1dKmwsMw7We6YNFamHgC8GttWEJU54tAHEaJPC,1595750,8925407,-7329657,616
2021-12-06 09:47:38.387849,2021-12-06 04:44:02-05:00,471,2bjiHeP82LQ56fEsqR7xEZ9xyyE8LLeeNc7LBvSQm54r,6wdVmvunXFaPuCAXiDdYNmoumYkXz8M5C5vRnBZ9HSXT,True,217710126,54427531,327115,163557,163558,4BnQKPLuE3DMTtxp8MjUBytgnhvxqq3ZTqZHTVZo4JJh,13084633,58494961,-45410328,601
2021-12-06 09:47:38.387849,2021-12-06 04:44:04-05:00,472,A9BZ5kjh7iKu7SMzA5WUF31Zst9V7fehwDZaoKs4NpSi,3FzwTaT5LYucvoGGcRVXu5AUDnGHADv6yGqrBT6jEtvH,True,353707601,88426900,541434,270717,270717,72FwbpFGoLEazJEdpqNtPNefsadUrimUqma9wSoy4qiS,21657395,113081774,-91424379,612
2021-12-06 09:47:38.387849,2021-12-06 04:44:07-05:00,473,7gxTghaVZPNNwaNEdtQHh4QDCJ4JgigYMd4MMCC9VtFo,4ZZTUrm4jX1jqqTYVFJ9TJQ2BLx2eZgXesmoon1LBa1a,True,9319398,2329849,14564,7282,7282,72FwbpFGoLEazJEdpqNtPNefsadUrimUqma9wSoy4qiS,582575,2505716,-1923141,625
2021-12-06 09:47:38.387849,2021-12-06 04:44:07-05:00,474,BpvWyveup3q7q6Cws5TWkFYiZ8bQXRrfdxvzrN9FnYo6,2CWjropYSn9fJ66FT4zqUcwTrEaPp3CjGgoRATixyca1,True,102027934,25506983,154596,77298,77298,72FwbpFGoLEazJEdpqNtPNefsadUrimUqma9wSoy4qiS,6183871,27905680,-21721809,606
2021-12-06 09:47:38.387849,2021-12-06 04:44:07-05:00,475,CBEv8v9XZrgFT8UdEdd813XnRVv9R7GB5PLMyG8UWGC8,4uNcMEcQpJdThpisgNrttkQJTUFTsjEr25qgjkm4titC,True,248959296,62239824,360621,180310,180311,72FwbpFGoLEazJEdpqNtPNefsadUrimUqma9wSoy4qiS,14424869,115130626,-100705757,579
2021-12-06 09:47:38.387849,2021-12-06 04:44:07-05:00,476,6meAnGTy2XNUDk9qSJZGT6BBRinA5iGiDYEy2T88LXuX,BCzNQCn3J1381yNH5xp5ky9QmVKVdSofSUaLHtxKxPBW,True,663716,165929,1009,504,505,72FwbpFGoLEazJEdpqNtPNefsadUrimUqma9wSoy4qiS,40385,266526,-226141,608
2021-12-06 09:47:38.387849,2021-12-06 04:44:07-05:00,477,9kK2PuehQxgcXtnYnPNmukmzfDTsVHv15pE86xwi7vYt,DtbCSCur1w6ZMGu56auQaHf8c6gVDJoD1iEwiUyCBcYJ,True,9026258,2256564,13104,6552,6552,72FwbpFGoLEazJEdpqNtPNefsadUrimUqma9wSoy4qiS,524167,3510555,-2986388,580
2021-12-06 09:47:38.387849,2021-12-06 04:44:07-05:00,478,Hp4bpHhSds7eMRmW1wpCg8HPUKk5vdRJt9Wm1axJgbcG,5sPxP3PAUqWr5FuHY1kUTz5u1J4pvVB95L1rbxepS2S6,True,697171,174292,1066,533,533,72FwbpFGoLEazJEdpqNtPNefsadUrimUqma9wSoy4qiS,42679,173038,-130359,612
2021-12-06 09:47:38.387849,2021-12-06 04:44:07-05:00,479,FpqCxvTkSiwDwD5qEt6hXJxzFDLFLAQ8VevK8zwRqYun,A3p6YQisCJKpNkF7vkjZRbEfbnUt7vTZdR2zPBUSdTkk,True,63847996,15961999,96237,48118,48119,72FwbpFGoLEazJEdpqNtPNefsadUrimUqma9wSoy4qiS,3849505,25756543,-21907038,602
2021-12-06 09:47:38.387849,2021-12-06 04:44:07-05:00,480,3fB955q6xxxZcgnCyguLwkSa7egxgBoksPQVQ3U8HRHL,GK7cTdhfSpapJB8dFzEkV8c1UFkJPj281DwztnpKjxLx,True,84236270,21059067,125935,62967,62968,72FwbpFGoLEazJEdpqNtPNefsadUrimUqma9wSoy4qiS,5037403,38957825,-33920422,598
2021-12-06 09:47:38.387849,2021-12-06 04:44:07-05:00,481,66SjFhmiNYz8tLRnBhZUbowWGTbM16G52X3AT2hma2wN,3wVy8nk24HCFZWMiacGe8QsJquYaadZ9pQg44bGRwdE3,True,26096186,6524046,40785,20392,20393,72FwbpFGoLEazJEdpqNtPNefsadUrimUqma9wSoy4qiS,1631416,11636040,-10004624,625
2021-12-06 09:47:38.387849,2021-12-06 04:44:08-05:00,482,EDE1swNYZ99y9idZacAw5Ncwz2DyD78SqvKMUXA2Dbw4,HSmYYMpNQNr1F2zjvysGRrC57FyusAJNsaXWfbmCfZh4,True,18880934,4720233,28820,14410,14410,72FwbpFGoLEazJEdpqNtPNefsadUrimUqma9wSoy4qiS,1152829,8780953,-7628124,610
2021-12-06 11:15:22.297270,2021-12-06 06:13:20-05:00,483,57GUgfEp9ZQ5iAU2nx1Z2Tiz3gqq7yBNaqfE1cvxjFYt,98upivFa9Tdy3RZHGM1i2k5zeczaGqioq3rTzc3DMf4x,True,93796871,23449217,146329,73164,73165,4BnQKPLuE3DMTtxp8MjUBytgnhvxqq3ZTqZHTVZo4JJh,5853188,38079209,-32226021,624
2021-12-06 11:15:22.297270,2021-12-06 06:13:23-05:00,484,FZhvN1RjLoBK9EpCeyEobYsvdHirtbTXV82c9EV9nn2u,FSeHqYNof79JYrRb7ZkJWEb4TfS5wx7HTdvT1kLCexHM,True,36079535,9019883,55234,27617,27617,9S3tZN1dKmwsMw7We6YNFamHgC8GttWEJU54tAHEaJPC,2209373,12452272,-10242899,612
2021-12-06 11:15:22.297270,2021-12-06 06:13:28-05:00,485,EQYUWtYbtvN9C9ixiupXPjHyFWHsYa7dUh4DSd6rxbzt,iS616uGNCwCxP1taAvvdvA2KdqfXRSjcQWwZRUgBkLb,True,8461737,2115434,13124,6562,6562,72FwbpFGoLEazJEdpqNtPNefsadUrimUqma9wSoy4qiS,524980,3527379,-3002399,620
2021-12-06 11:15:22.297270,2021-12-06 06:13:28-05:00,486,81GV2H9ipJSZD6YpJGj2XQNfoUroWWnKfwMHGSwvhixd,7cLHoNuNVj8qkn3QmBYLFwja37f1MWEo4e3ZcNSpXTPw,True,2263837294,565959323,3526695,1763347,1763348,72FwbpFGoLEazJEdpqNtPNefsadUrimUqma9wSoy4qiS,141067825,590290754,-449222929,623
2021-12-06 11:15:22.297270,2021-12-06 06:13:28-05:00,487,2JH43pKUeXTXPd6LnL4BWgGQpwZHhX8EqyohKCFLAS4i,Bir3EKnDWkv6XX7KmoqAi1y6rxSaC5RfVV6Hwvnkfr2i,True,24001164,6000291,37038,18519,18519,72FwbpFGoLEazJEdpqNtPNefsadUrimUqma9wSoy4qiS,1481537,7536305,-6054768,617
2021-12-06 11:15:22.297270,2021-12-06 06:13:32-05:00,488,7aKxZg1aoLuB51JUw7fruF77ts7SWoB7pcLBZKHZMynr,AAnbLY82UGULqaDNdyJHrYu7X3hGaBuiTkGWmh8qKTc,True,9272286802,2318071700,14307179,7153589,7153590,72FwbpFGoLEazJEdpqNtPNefsadUrimUqma9wSoy4qiS,572287167,2111592247,-1539305080,617
2021-12-06 11:15:22.297270,2021-12-06 06:13:32-05:00,489,E5KDZriZ89a5D4VsMaWxndMMG68RT4weruJ1tCEc6tSx,CaSwkUocpbyyGCQBgKjJZJgcexbyqs2GTrGJH6EMWXAz,True,3032100349,758025087,4694561,2347280,2347281,72FwbpFGoLEazJEdpqNtPNefsadUrimUqma9wSoy4qiS,187782479,1085914228,-898131749,619
2021-12-06 11:15:22.297270,2021-12-06 06:13:42-05:00,490,4xsYjVsPm2C2itNtJb3NYkBp4WySHUwtSbWdu9fge8wz,8zu2jMoTndZpf9khY9PMhve88LRwrKNTuVuLpa5ss8qo,True,334892406,83723101,521046,260523,260523,72FwbpFGoLEazJEdpqNtPNefsadUrimUqma9wSoy4qiS,20841848,131081301,-110239453,622
2021-12-06 11:15:22.297270,2021-12-06 06:13:42-05:00,491,7WB5fc5DQAWYBSgc11KfWa4kpThfyaoxp49kFGELCQMj,4qD4BkxDzJ6uZ2iKgsXZtghNbNsnHmaKyjGWLZW9YTdU,True,45017360,11254340,70024,35012,35012,72FwbpFGoLEazJEdpqNtPNefsadUrimUqma9wSoy4qiS,2800992,10418315,-7617323,622
2021-12-06 11:15:22.297270,2021-12-06 06:13:44-05:00,492,C24que1C7tC3ysDSKhcBTF9NUnjiNhSanWp8Go5FRRb8,hgm3qRRG2njhNPWcUp9UnEU8pyg4gLaR2K13r4Lsqxm,True,359586062,89896515,553795,276897,276898,72FwbpFGoLEazJEdpqNtPNefsadUrimUqma9wSoy4qiS,22151805,112597001,-90445196,616
2021-12-06 11:15:22.297270,2021-12-06 06:13:55-05:00,493,8w4uRzN81cghupkF7jNLinGLtCqYwNQFgQtdJfC5so7z,BbbRkq85fYEBGmuxBEEPbt6up4GNB7WQ83VSXwe4ro98,True,3819648777,954912194,5862360,2931180,2931180,4BnQKPLuE3DMTtxp8MjUBytgnhvxqq3ZTqZHTVZo4JJh,234494412,1213999721,-979505309,613
2021-12-06 11:15:22.297270,2021-12-06 06:14:07-05:00,494,2XFYFxNQbCr5ao4cVzRZt45fsAwZc4jD9XTABmdqaJWd,CvpzBuDjyimaYFGWFkkBcaZGSRtAvtF6MtRV54mqZ74k,True,491996,122999,760,380,380,72FwbpFGoLEazJEdpqNtPNefsadUrimUqma9wSoy4qiS,30422,205853,-175431,618
2021-12-06 11:15:22.297270,2021-12-06 06:14:07-05:00,495,DVV4Vhk44E5YvVzpXgjJMepYgUB5uKXmAhEbFg6R5vWJ,8CS7rCKNx7AQ5yaEA2rHrYx4PHnC9mK3DtSQmiKW2nUb,True,152767478,38191869,236683,118341,118342,72FwbpFGoLEazJEdpqNtPNefsadUrimUqma9wSoy4qiS,9467357,57184886,-47717529,619
2021-12-06 11:15:22.297270,2021-12-06 06:14:08-05:00,496,FP6SmbXDbcb6c8Pi8uZMn6hnQDUbvbdCfzd5pEqyBgTm,53A9dhER1x3JjdceGMQmjujvWht7uemsoB3ngQLdo6Ub,True,750326077,187581519,1169627,584813,584814,72FwbpFGoLEazJEdpqNtPNefsadUrimUqma9wSoy4qiS,46785095,253367101,-206582006,623
2021-12-06 11:15:22.297270,2021-12-06 06:14:09-05:00,497,3XzkSrNTGd3Fhd4M3gYzvz2utbQpFN1fhtbAaZu7C39R,GMsZGGfktTzYi7GhD3W6HY9QY9bznqTKfeArksikLE71,True,4416508,1104127,6814,3407,3407,72FwbpFGoLEazJEdpqNtPNefsadUrimUqma9wSoy4qiS,272596,1669933,-1397337,617
2021-12-06 11:15:22.297270,2021-12-06 06:14:09-05:00,498,3Ek5j2ea8wS2nCxsNgn2AbovxzJwGK7zc6xarkigSA3u,DEWmTn3Ah4F3nNXpoQLt1GG65Dsf4ZmGjn7FZUJyK6rP,True,1120595467,280148866,1732010,866005,866005,72FwbpFGoLEazJEdpqNtPNefsadUrimUqma9wSoy4qiS,69280432,467131295,-397850863,618
2021-12-07 13:12:32.505732,2021-12-07 07:49:35-05:00,499,EntLemtuTqmuHY9F4pycmGmNwBNeUghf9R6QHHd7ZTYw,EdMJPDmD6f3T9FtjdUZ433z1w8JHZVwQqYVkzmrG2ToK,False,560803117632,560803117632,0,0,0,72FwbpFGoLEazJEdpqNtPNefsadUrimUqma9wSoy4qiS,0,139743715395,-212926529347,0
2021-12-07 13:12:32.505732,2021-12-07 07:57:36-05:00,500,D3o7CSh2zCAQ93BDomDCitZ4vuxC83wGPMwJEEyBJK4C,A4nDfpUZkdtuWRRWZkoNXc5Ux7JU1UJA2JTHgkHAfYyP,False,131143811549,131143811549,0,0,0,72FwbpFGoLEazJEdpqNtPNefsadUrimUqma9wSoy4qiS,0,80799610730,-140718271110,0
2021-12-10 05:13:23.268423,2021-12-10 00:03:20-05:00,501,8d333AWdyiVhvkAdiKCTwhgzaPBMbn8mtucwUC1SAbZZ,3BM8UNLN7XGRaYRjezAqFVMr1z4PS3VRXiN1NAtvBuD9,True,78851677,19712919,123161,61580,61581,GmqQKnMfFxkv6ChqGaZ2wmSFDow7R1x7WeRfU58GVvfw,4926443,30201844,-25275401,624
2021-12-10 05:13:23.268423,2021-12-10 00:03:26-05:00,502,DSEgVqfxXp5wxjn3gNZtmb4E6rJeBm3VcbqdwDnsuzSq,6YVCWznUKheSMPuywSRJgCes7wghPGJXgxfrVfnjN4mB,True,784934067,196233516,1228349,614174,614175,4BnQKPLuE3DMTtxp8MjUBytgnhvxqq3ZTqZHTVZo4JJh,49133962,201790667,-152656705,625
2021-12-10 05:28:06.562420,2021-12-10 00:27:46-05:00,503,DCxghVXCXzEar41CPGichdzvtjwmf4NW7uHtKTj57BNN,Fmh5FPdnFb1KpFkoL6eNfWFGxN78GLdaJgPcVpCoCnkh,True,310312917,77578229,485505,242752,242753,4BnQKPLuE3DMTtxp8MjUBytgnhvxqq3ZTqZHTVZo4JJh,19420232,93963606,-74543374,625
2021-12-10 05:35:47.687446,2021-12-10 00:28:19-05:00,504,8w1hzDtCFuTJqWAtwihztrPzxwa7YrJH5uPk877SJnNj,D3gnctosqTZxTQNfLJQRdPgCvGx2JLLHHDmcvW5UX1QN,True,525553936,131388484,821683,410841,410842,4BnQKPLuE3DMTtxp8MjUBytgnhvxqq3ZTqZHTVZo4JJh,32867326,162413599,-129546273,625
2021-12-10 05:35:47.687446,2021-12-10 00:28:22-05:00,505,BELLbzmdx1SYke9kZUxFi9VcdvwaHmkZyv24FArQ1J2f,5a5LfKakAaFEVkavVHgExKaUr25RWYpzFic6MUQQ62uc,True,1474800914,368700228,2308029,1154014,1154015,4BnQKPLuE3DMTtxp8MjUBytgnhvxqq3ZTqZHTVZo4JJh,92321190,599291062,-506969872,625
2021-12-10 05:35:47.687446,2021-12-10 00:28:40-05:00,506,CQSb6ZVY1KVNXFAg8pxm8RvBBGGqRSU7FMvwHJPy46u8,FRBv3b5VTfKN1bK4DXFY4329LFbvm882P47edrgpuSM,True,720903589,180225897,1126771,563385,563386,4BnQKPLuE3DMTtxp8MjUBytgnhvxqq3ZTqZHTVZo4JJh,45070859,247836480,-202765621,625
2021-12-10 05:35:47.687446,2021-12-10 00:28:49-05:00,507,8Xdf67Q5jXKwS52e492xUBu1tMUgS14jJg7V4R2Q28EP,GAPL3bsXP4xcukhgzyqrbDntGwUSm5BfuwJ8TLKkRaZc,True,374377551,93594387,583712,291856,291856,4BnQKPLuE3DMTtxp8MjUBytgnhvxqq3ZTqZHTVZo4JJh,23348501,103342002,-79993501,623
2021-12-10 05:42:22.174092,2021-12-10 00:38:55-05:00,508,94KFzzXCAvEfSf3jrnUpyN3pne8Xfc6nroB7UxTVqeyB,ERQEKcL8qV9WEzLwi5WFjh2wN97q9GD9pqd9umcTypxy,True,3419647,854911,5320,2660,2660,4BnQKPLuE3DMTtxp8MjUBytgnhvxqq3ZTqZHTVZo4JJh,212807,1229564,-1016757,622
2021-12-10 05:42:22.174092,2021-12-10 00:38:58-05:00,509,EvSdLa5PeJiaaaE3omJNG7cw1tptZnHTituYswVHSwm3,68ESX2mBsfxQo2U9jsbmHo7TzPTxr9mGH5Y11ZLR7E3A,True,31411296,7852824,48971,24485,24486,4BnQKPLuE3DMTtxp8MjUBytgnhvxqq3ZTqZHTVZo4JJh,1958841,12790242,-10831401,623
2021-12-10 05:42:22.174092,2021-12-10 00:40:32-05:00,510,8soQsYfQCngqJ5gLpWSuuzDUo1YLg53mU6GBF5RBizNn,HdsRtpasJYyFdS3sKqFAwJespt8x7cKUfGuvEuxmWdxV,True,39980183,9995045,62479,31239,31240,4BnQKPLuE3DMTtxp8MjUBytgnhvxqq3ZTqZHTVZo4JJh,2499165,9465792,-6966627,625
2021-12-10 06:48:33.241074,2021-12-10 01:43:32-05:00,511,J5WcVsKNHbfioai1LRowvjvtEmUJBEkeoBim1ThshpoP,Ajh7SWBq3zJR4vb6AFoBS6C9D99wC6YF1sVN22qC1vCA,True,358662662,89665665,555389,277694,277695,72FwbpFGoLEazJEdpqNtPNefsadUrimUqma9wSoy4qiS,22215586,72980566,-50764980,619
2021-12-10 06:56:49.614187,2021-12-10 01:56:43-05:00,512,7TBoPCDA6BACBPJvpwHVHQh1EeydCHD2KT4TaQ4NWrc3,6GLRsMGMNBA8qf27VGfXyXtTt31J9GUVrqqJM7H2RhwK,True,205273110,51318277,318104,159052,159052,72FwbpFGoLEazJEdpqNtPNefsadUrimUqma9wSoy4qiS,12724179,44586161,-31861982,619
2021-12-10 07:08:46.041107,2021-12-10 02:00:19-05:00,513,EFHg5FatMRRSZnKJPJF9e1iw2cjPJRmwTTZYtkHno9DP,84LnLKhZDJgWFnbBYnYjqWkjymemXfidecPFwnUAvuFj,True,2741191214,685297803,4279749,2139874,2139875,72FwbpFGoLEazJEdpqNtPNefsadUrimUqma9wSoy4qiS,171189968,897966027,-726776059,624
2021-12-10 07:08:46.041107,2021-12-10 02:03:20-05:00,514,HnUkyFhntoajDEgXMKeoh4nAuY5y7osLYwmYAApyLSNs,GntEkHxrGpcHFCVLQGjKiXWdenbsqfQgxddpEpxpE65z,True,19218992,4804748,30042,15021,15021,72FwbpFGoLEazJEdpqNtPNefsadUrimUqma9wSoy4qiS,1201693,6897756,-5696063,625
2021-12-10 07:08:46.041107,2021-12-10 02:04:33-05:00,515,CBEv8v9XZrgFT8UdEdd813XnRVv9R7GB5PLMyG8UWGC8,4uNcMEcQpJdThpisgNrttkQJTUFTsjEr25qgjkm4titC,True,185762382,46440595,290096,145048,145048,72FwbpFGoLEazJEdpqNtPNefsadUrimUqma9wSoy4qiS,11603873,88092977,-76489104,624
2021-12-10 07:08:46.041107,2021-12-10 02:07:56-05:00,516,9kK2PuehQxgcXtnYnPNmukmzfDTsVHv15pE86xwi7vYt,DtbCSCur1w6ZMGu56auQaHf8c6gVDJoD1iEwiUyCBcYJ,True,6731911,1682977,10469,5234,5235,72FwbpFGoLEazJEdpqNtPNefsadUrimUqma9wSoy4qiS,418778,2696418,-2277640,622
2021-12-10 07:08:46.041107,2021-12-10 02:07:56-05:00,517,6oRHRnLX93bYeTN5YD2XHqskhbv8wN2pgSia9Kz3QkED,D6QG2KYp9vYZZe8tTZux5tDR6fXgm8k4SVWbpaPvEmZ1,True,77240464,19310116,120288,60144,60144,72FwbpFGoLEazJEdpqNtPNefsadUrimUqma9wSoy4qiS,4811544,20233027,-15421483,622
2021-12-10 07:25:03.500292,2021-12-10 02:11:20-05:00,518,FSduW743jAGyyn8HTifEJitgb89Spp5gEeMXDE59aEHF,HjojGNpR3ACtLCP2mP8DKGyXj6SeqWPKjcCAofcyQpsm,True,886132181,221533045,1377083,688541,688542,72FwbpFGoLEazJEdpqNtPNefsadUrimUqma9wSoy4qiS,55083353,224428515,-169345162,621
2021-12-10 07:25:03.500292,2021-12-10 02:11:20-05:00,519,3fB955q6xxxZcgnCyguLwkSa7egxgBoksPQVQ3U8HRHL,GK7cTdhfSpapJB8dFzEkV8c1UFkJPj281DwztnpKjxLx,True,62666314,15666578,97298,48649,48649,72FwbpFGoLEazJEdpqNtPNefsadUrimUqma9wSoy4qiS,3891940,29843511,-25951571,621
2021-12-10 07:25:03.500292,2021-12-10 02:19:58-05:00,520,FpqCxvTkSiwDwD5qEt6hXJxzFDLFLAQ8VevK8zwRqYun,A3p6YQisCJKpNkF7vkjZRbEfbnUt7vTZdR2zPBUSdTkk,True,47487171,11871792,74222,37111,37111,72FwbpFGoLEazJEdpqNtPNefsadUrimUqma9wSoy4qiS,2968916,19798256,-16829340,625
2021-12-10 07:47:05.695155,2021-12-10 02:41:19-05:00,521,6meAnGTy2XNUDk9qSJZGT6BBRinA5iGiDYEy2T88LXuX,BCzNQCn3J1381yNH5xp5ky9QmVKVdSofSUaLHtxKxPBW,True,492932,123233,762,381,381,72FwbpFGoLEazJEdpqNtPNefsadUrimUqma9wSoy4qiS,30512,205047,-174535,618
2021-12-10 07:47:05.695155,2021-12-10 02:41:19-05:00,522,Hp4bpHhSds7eMRmW1wpCg8HPUKk5vdRJt9Wm1axJgbcG,5sPxP3PAUqWr5FuHY1kUTz5u1J4pvVB95L1rbxepS2S6,True,517497,129374,800,400,400,72FwbpFGoLEazJEdpqNtPNefsadUrimUqma9wSoy4qiS,32021,135202,-103181,618
2021-12-10 07:47:05.695155,2021-12-10 02:41:20-05:00,523,A9BZ5kjh7iKu7SMzA5WUF31Zst9V7fehwDZaoKs4NpSi,3FzwTaT5LYucvoGGcRVXu5AUDnGHADv6yGqrBT6jEtvH,True,262693330,65673332,409803,204901,204902,72FwbpFGoLEazJEdpqNtPNefsadUrimUqma9wSoy4qiS,16392149,87552657,-71160508,624
2021-12-10 07:47:05.695155,2021-12-10 02:41:20-05:00,524,EDE1swNYZ99y9idZacAw5Ncwz2DyD78SqvKMUXA2Dbw4,HSmYYMpNQNr1F2zjvysGRrC57FyusAJNsaXWfbmCfZh4,True,14017582,3504395,21672,10836,10836,72FwbpFGoLEazJEdpqNtPNefsadUrimUqma9wSoy4qiS,866889,6731198,-5864309,618
2021-12-10 07:53:38.950437,2021-12-10 02:48:57-05:00,525,FZhvN1RjLoBK9EpCeyEobYsvdHirtbTXV82c9EV9nn2u,FSeHqYNof79JYrRb7ZkJWEb4TfS5wx7HTdvT1kLCexHM,True,26788210,6697052,41820,20910,20910,72FwbpFGoLEazJEdpqNtPNefsadUrimUqma9wSoy4qiS,1672833,9626508,-7953675,624
2021-12-10 15:01:33.115464,2021-12-10 10:00:04-05:00,526,66SjFhmiNYz8tLRnBhZUbowWGTbM16G52X3AT2hma2wN,3wVy8nk24HCFZWMiacGe8QsJquYaadZ9pQg44bGRwdE3,True,19372697,4843174,30306,15153,15153,GmqQKnMfFxkv6ChqGaZ2wmSFDow7R1x7WeRfU58GVvfw,1212274,8915291,-7703017,625
2021-12-10 15:01:33.115464,2021-12-10 10:00:12-05:00,527,7gxTghaVZPNNwaNEdtQHh4QDCJ4JgigYMd4MMCC9VtFo,4ZZTUrm4jX1jqqTYVFJ9TJQ2BLx2eZgXesmoon1LBa1a,True,6917433,1729358,10800,5400,5400,72FwbpFGoLEazJEdpqNtPNefsadUrimUqma9wSoy4qiS,432005,1946494,-1514489,624
2021-12-10 15:21:28.133999,2021-12-10 10:01:40-05:00,528,57GUgfEp9ZQ5iAU2nx1Z2Tiz3gqq7yBNaqfE1cvxjFYt,98upivFa9Tdy3RZHGM1i2k5zeczaGqioq3rTzc3DMf4x,True,69562693,17390673,107501,53750,53751,4BnQKPLuE3DMTtxp8MjUBytgnhvxqq3ZTqZHTVZo4JJh,4300051,29254928,-24954877,618
2021-12-10 15:21:28.133999,2021-12-10 10:01:48-05:00,529,EQYUWtYbtvN9C9ixiupXPjHyFWHsYa7dUh4DSd6rxbzt,iS616uGNCwCxP1taAvvdvA2KdqfXRSjcQWwZRUgBkLb,True,6281089,1570272,9762,4881,4881,4BnQKPLuE3DMTtxp8MjUBytgnhvxqq3ZTqZHTVZo4JJh,390494,2707579,-2317085,621
2021-12-10 15:21:28.133999,2021-12-10 10:01:53-05:00,530,2JH43pKUeXTXPd6LnL4BWgGQpwZHhX8EqyohKCFLAS4i,Bir3EKnDWkv6XX7KmoqAi1y6rxSaC5RfVV6Hwvnkfr2i,True,17819035,4454758,27584,13792,13792,72FwbpFGoLEazJEdpqNtPNefsadUrimUqma9wSoy4qiS,1103372,5826363,-4722991,619
2021-12-10 15:21:28.133999,2021-12-10 10:02:42-05:00,531,C24que1C7tC3ysDSKhcBTF9NUnjiNhSanWp8Go5FRRb8,hgm3qRRG2njhNPWcUp9UnEU8pyg4gLaR2K13r4Lsqxm,True,266850622,66712655,409249,204624,204625,72FwbpFGoLEazJEdpqNtPNefsadUrimUqma9wSoy4qiS,16369988,87047732,-70677744,613
2021-12-10 15:21:28.133999,2021-12-10 10:02:44-05:00,532,7aKxZg1aoLuB51JUw7fruF77ts7SWoB7pcLBZKHZMynr,AAnbLY82UGULqaDNdyJHrYu7X3hGaBuiTkGWmh8qKTc,True,6879885560,1719971390,10549946,5274973,5274973,72FwbpFGoLEazJEdpqNtPNefsadUrimUqma9wSoy4qiS,421997853,1653852739,-1231854886,613
2021-12-10 15:21:28.133999,2021-12-10 10:02:44-05:00,533,81GV2H9ipJSZD6YpJGj2XQNfoUroWWnKfwMHGSwvhixd,7cLHoNuNVj8qkn3QmBYLFwja37f1MWEo4e3ZcNSpXTPw,True,1677443725,419360931,2551962,1275981,1275981,72FwbpFGoLEazJEdpqNtPNefsadUrimUqma9wSoy4qiS,102078499,459616576,-357538077,608
2021-12-10 15:21:28.133999,2021-12-10 10:02:46-05:00,534,7WB5fc5DQAWYBSgc11KfWa4kpThfyaoxp49kFGELCQMj,4qD4BkxDzJ6uZ2iKgsXZtghNbNsnHmaKyjGWLZW9YTdU,True,33422798,8355699,52291,26145,26146,72FwbpFGoLEazJEdpqNtPNefsadUrimUqma9wSoy4qiS,2091669,8145009,-6053340,625
2021-12-10 15:21:28.133999,2021-12-10 10:03:03-05:00,535,4xsYjVsPm2C2itNtJb3NYkBp4WySHUwtSbWdu9fge8wz,8zu2jMoTndZpf9khY9PMhve88LRwrKNTuVuLpa5ss8qo,True,248472914,62118228,384986,192493,192493,72FwbpFGoLEazJEdpqNtPNefsadUrimUqma9wSoy4qiS,15399457,100780019,-85380562,619
2021-12-10 15:21:28.133999,2021-12-10 10:03:12-05:00,536,8w4uRzN81cghupkF7jNLinGLtCqYwNQFgQtdJfC5so7z,BbbRkq85fYEBGmuxBEEPbt6up4GNB7WQ83VSXwe4ro98,True,2838903005,709725751,4434256,2217128,2217128,72FwbpFGoLEazJEdpqNtPNefsadUrimUqma9wSoy4qiS,177370252,938390430,-761020178,624
2021-12-10 15:21:28.133999,2021-12-10 10:04:37-05:00,537,3Ek5j2ea8wS2nCxsNgn2AbovxzJwGK7zc6xarkigSA3u,DEWmTn3Ah4F3nNXpoQLt1GG65Dsf4ZmGjn7FZUJyK6rP,True,832215362,208053840,1296459,648229,648230,72FwbpFGoLEazJEdpqNtPNefsadUrimUqma9wSoy4qiS,51858390,358529614,-306671224,623
2021-12-10 15:21:28.133999,2021-12-10 10:04:37-05:00,538,7UwBQLT7uc8DFabDUwRBgTCjm2Tprh79HoDwhPCap6v7,CdWQHx3cRLC7ApxXSbVD3D6y2V6vtqQJLMjuhFcdbp4X,True,218901868,54725467,339478,169739,169739,72FwbpFGoLEazJEdpqNtPNefsadUrimUqma9wSoy4qiS,13579157,101631626,-88052469,620
2021-12-10 15:21:28.133999,2021-12-10 10:04:38-05:00,539,2XFYFxNQbCr5ao4cVzRZt45fsAwZc4jD9XTABmdqaJWd,CvpzBuDjyimaYFGWFkkBcaZGSRtAvtF6MtRV54mqZ74k,True,365195,91298,564,282,282,72FwbpFGoLEazJEdpqNtPNefsadUrimUqma9wSoy4qiS,22586,158007,-135421,618
2021-12-10 15:21:28.133999,2021-12-10 10:04:39-05:00,540,3XzkSrNTGd3Fhd4M3gYzvz2utbQpFN1fhtbAaZu7C39R,GMsZGGfktTzYi7GhD3W6HY9QY9bznqTKfeArksikLE71,True,3279277,819819,5082,2541,2541,72FwbpFGoLEazJEdpqNtPNefsadUrimUqma9wSoy4qiS,203288,1284399,-1081111,619
2021-12-10 15:21:28.133999,2021-12-10 10:04:42-05:00,541,DVV4Vhk44E5YvVzpXgjJMepYgUB5uKXmAhEbFg6R5vWJ,8CS7rCKNx7AQ5yaEA2rHrYx4PHnC9mK3DtSQmiKW2nUb,True,113425744,28356436,176606,88303,88303,72FwbpFGoLEazJEdpqNtPNefsadUrimUqma9wSoy4qiS,7064249,44003195,-36938946,622
2021-12-10 15:21:28.133999,2021-12-10 10:05:11-05:00,542,FP6SmbXDbcb6c8Pi8uZMn6hnQDUbvbdCfzd5pEqyBgTm,53A9dhER1x3JjdceGMQmjujvWht7uemsoB3ngQLdo6Ub,True,556695254,139173813,864315,432157,432158,72FwbpFGoLEazJEdpqNtPNefsadUrimUqma9wSoy4qiS,34572601,195580300,-161007699,621
2021-12-10 15:21:28.133999,2021-12-10 10:06:01-05:00,543,8fVwuVA2CL5sZoHh6Dg4MBpcX3cvoUm7mnitnpQSdPBD,4F4ccaNm1KQu29XvsKvdjFkmpsbWqNvXkV41851EYQyu,True,44447458,11111864,69443,34721,34722,72FwbpFGoLEazJEdpqNtPNefsadUrimUqma9wSoy4qiS,2777729,15248888,-12471159,624
2021-12-10 15:21:28.133999,2021-12-10 10:06:01-05:00,544,DSEgVqfxXp5wxjn3gNZtmb4E6rJeBm3VcbqdwDnsuzSq,6YVCWznUKheSMPuywSRJgCes7wghPGJXgxfrVfnjN4mB,True,577613192,144403298,899522,449761,449761,72FwbpFGoLEazJEdpqNtPNefsadUrimUqma9wSoy4qiS,35980902,161579681,-125598779,622
2021-12-10 15:21:28.133999,2021-12-10 10:06:01-05:00,545,8d333AWdyiVhvkAdiKCTwhgzaPBMbn8mtucwUC1SAbZZ,3BM8UNLN7XGRaYRjezAqFVMr1z4PS3VRXiN1NAtvBuD9,True,58019600,14504900,90000,45000,45000,72FwbpFGoLEazJEdpqNtPNefsadUrimUqma9wSoy4qiS,3600017,23675980,-20075963,620
2021-12-10 15:21:28.133999,2021-12-10 10:07:24-05:00,546,CQSb6ZVY1KVNXFAg8pxm8RvBBGGqRSU7FMvwHJPy46u8,FRBv3b5VTfKN1bK4DXFY4329LFbvm882P47edrgpuSM,True,530595324,132648831,827289,413644,413645,72FwbpFGoLEazJEdpqNtPNefsadUrimUqma9wSoy4qiS,33091564,195265279,-162173715,623
2021-12-10 15:21:28.133999,2021-12-10 10:07:24-05:00,547,DCxghVXCXzEar41CPGichdzvtjwmf4NW7uHtKTj57BNN,Fmh5FPdnFb1KpFkoL6eNfWFGxN78GLdaJgPcVpCoCnkh,True,228208399,57052099,351929,175964,175965,72FwbpFGoLEazJEdpqNtPNefsadUrimUqma9wSoy4qiS,14077197,74514087,-60436890,616
2021-12-10 15:21:28.133999,2021-12-10 10:07:24-05:00,548,BELLbzmdx1SYke9kZUxFi9VcdvwaHmkZyv24FArQ1J2f,5a5LfKakAaFEVkavVHgExKaUr25RWYpzFic6MUQQ62uc,True,1085207956,271301989,1688626,844313,844313,72FwbpFGoLEazJEdpqNtPNefsadUrimUqma9wSoy4qiS,67545055,468740322,-401195267,622
2021-12-10 15:21:28.133999,2021-12-10 10:07:24-05:00,549,8Xdf67Q5jXKwS52e492xUBu1tMUgS14jJg7V4R2Q28EP,GAPL3bsXP4xcukhgzyqrbDntGwUSm5BfuwJ8TLKkRaZc,True,275598012,68899503,429489,214744,214745,72FwbpFGoLEazJEdpqNtPNefsadUrimUqma9wSoy4qiS,17179571,82364258,-65184687,623
2021-12-10 15:21:28.133999,2021-12-10 10:07:33-05:00,550,8w1hzDtCFuTJqWAtwihztrPzxwa7YrJH5uPk877SJnNj,D3gnctosqTZxTQNfLJQRdPgCvGx2JLLHHDmcvW5UX1QN,True,386644486,96661121,599084,299542,299542,72FwbpFGoLEazJEdpqNtPNefsadUrimUqma9wSoy4qiS,23963394,128652977,-104689583,619
2021-12-10 15:50:04.369166,2021-12-10 10:48:33-05:00,551,9WoXgsHByBW41nJtgCBoLS1ZP2GredkysgyZeNRWx13u,26Hb8DNrxtVBHcThu71DJ3pTbhXRcGApnTrgk6iAVTau,True,209907564,52476891,326496,163248,163248,4BnQKPLuE3DMTtxp8MjUBytgnhvxqq3ZTqZHTVZo4JJh,13059840,48127531,-35067691,622
2021-12-10 15:56:26.818682,2021-12-10 10:54:32-05:00,552,94KFzzXCAvEfSf3jrnUpyN3pne8Xfc6nroB7UxTVqeyB,ERQEKcL8qV9WEzLwi5WFjh2wN97q9GD9pqd9umcTypxy,True,2518471,629617,3939,1969,1970,4BnQKPLuE3DMTtxp8MjUBytgnhvxqq3ZTqZHTVZo4JJh,157562,966405,-808843,625
2021-12-10 15:56:26.818682,2021-12-10 10:54:51-05:00,553,9WoXgsHByBW41nJtgCBoLS1ZP2GredkysgyZeNRWx13u,26Hb8DNrxtVBHcThu71DJ3pTbhXRcGApnTrgk6iAVTau,True,153949519,38487379,231304,115652,115652,72FwbpFGoLEazJEdpqNtPNefsadUrimUqma9wSoy4qiS,9252190,39039700,-29787510,600
2021-12-10 15:56:26.818682,2021-12-10 10:56:02-05:00,554,E5KDZriZ89a5D4VsMaWxndMMG68RT4weruJ1tCEc6tSx,CaSwkUocpbyyGCQBgKjJZJgcexbyqs2GTrGJH6EMWXAz,True,2252985430,563246357,3516083,1758041,1758042,72FwbpFGoLEazJEdpqNtPNefsadUrimUqma9wSoy4qiS,140643356,835585217,-694941861,624
2021-12-10 16:11:26.631385,2021-12-10 10:56:31-05:00,555,EvSdLa5PeJiaaaE3omJNG7cw1tptZnHTituYswVHSwm3,68ESX2mBsfxQo2U9jsbmHo7TzPTxr9mGH5Y11ZLR7E3A,True,23118237,5779559,35900,17950,17950,GmqQKnMfFxkv6ChqGaZ2wmSFDow7R1x7WeRfU58GVvfw,1436016,9999886,-8563870,621
2021-12-10 16:11:26.631385,2021-12-10 10:57:04-05:00,556,8soQsYfQCngqJ5gLpWSuuzDUo1YLg53mU6GBF5RBizNn,HdsRtpasJYyFdS3sKqFAwJespt8x7cKUfGuvEuxmWdxV,True,29416873,7354218,45640,22820,22820,GmqQKnMfFxkv6ChqGaZ2wmSFDow7R1x7WeRfU58GVvfw,1825611,7618942,-5793331,620
2021-12-10 16:11:26.631385,2021-12-10 10:57:28-05:00,557,J5WcVsKNHbfioai1LRowvjvtEmUJBEkeoBim1ThshpoP,Ajh7SWBq3zJR4vb6AFoBS6C9D99wC6YF1sVN22qC1vCA,True,264079484,66019871,410091,205045,205046,GmqQKnMfFxkv6ChqGaZ2wmSFDow7R1x7WeRfU58GVvfw,16403662,59398742,-42995080,621
2021-12-10 16:11:26.631385,2021-12-10 10:57:33-05:00,558,64w7jdrK2Kv8Wc55SfKBt7U6paGQ2NRGf31zPFC6Qk8G,3t6zWvFwvvfSFLaEdUoEzZZSW4ykWScvQnQDkTatKKg1,True,8582923,2145730,13267,6633,6634,GmqQKnMfFxkv6ChqGaZ2wmSFDow7R1x7WeRfU58GVvfw,530706,1947783,-1417077,618
2021-12-10 16:11:26.631385,2021-12-10 10:57:34-05:00,559,BtUb2aiZEXz89D8KgduJDt4SeLDuQeociXcAfey3sK7r,B4ZCTjVxHvAqSb4GqVWdan6qoSLVnYdq8KbUPbYMiz6v,True,5781226930,1445306732,8899082,4449541,4449541,GmqQKnMfFxkv6ChqGaZ2wmSFDow7R1x7WeRfU58GVvfw,355963290,1487624681,-1131661391,615
2021-12-10 16:11:26.631385,2021-12-10 10:57:34-05:00,560,7TBoPCDA6BACBPJvpwHVHQh1EeydCHD2KT4TaQ4NWrc3,6GLRsMGMNBA8qf27VGfXyXtTt31J9GUVrqqJM7H2RhwK,True,150997880,37749470,231373,115686,115687,GmqQKnMfFxkv6ChqGaZ2wmSFDow7R1x7WeRfU58GVvfw,9254955,36109650,-26854695,612
2021-12-10 16:11:26.631385,2021-12-10 10:57:36-05:00,561,EFHg5FatMRRSZnKJPJF9e1iw2cjPJRmwTTZYtkHno9DP,84LnLKhZDJgWFnbBYnYjqWkjymemXfidecPFwnUAvuFj,True,2015394326,503848581,3104022,1552011,1552011,GmqQKnMfFxkv6ChqGaZ2wmSFDow7R1x7WeRfU58GVvfw,124160914,709986935,-585826021,616
2021-12-10 16:11:26.631385,2021-12-10 10:57:36-05:00,562,G7kJUwq3DhEH6zhaeToRFMTKBEH3ME45hbqmrHbQD1nP,JmGGddHjC5bSieVcDn3sMeRBLryEhQKJmmtnkWza66L,True,356883706,89220926,549009,274504,274505,GmqQKnMfFxkv6ChqGaZ2wmSFDow7R1x7WeRfU58GVvfw,21960390,77281742,-55321352,615
2021-12-10 16:11:26.631385,2021-12-10 10:57:38-05:00,563,7uzNVopRjtoGCPz2CZPd88S6iLaXox1s1j3DAJE3YLSY,4HBjxtkRLW4bL6R6s5HpyUfk5FqQoQUsy9mLq3zKdc2M,True,11329675387,2832418846,17556595,8778297,8778298,4BnQKPLuE3DMTtxp8MjUBytgnhvxqq3ZTqZHTVZo4JJh,702263806,2530269335,-1828005529,619
2021-12-10 16:11:26.631385,2021-12-10 10:57:39-05:00,564,HnUkyFhntoajDEgXMKeoh4nAuY5y7osLYwmYAApyLSNs,GntEkHxrGpcHFCVLQGjKiXWdenbsqfQgxddpEpxpE65z,True,14132451,3533112,21851,10925,10926,GmqQKnMfFxkv6ChqGaZ2wmSFDow7R1x7WeRfU58GVvfw,874073,5427950,-4553877,618
2021-12-10 16:11:26.631385,2021-12-10 10:57:39-05:00,565,9kK2PuehQxgcXtnYnPNmukmzfDTsVHv15pE86xwi7vYt,DtbCSCur1w6ZMGu56auQaHf8c6gVDJoD1iEwiUyCBcYJ,True,4952253,1238063,7652,3826,3826,4BnQKPLuE3DMTtxp8MjUBytgnhvxqq3ZTqZHTVZo4JJh,306093,2111024,-1804931,618
2021-12-10 16:11:26.631385,2021-12-10 10:57:40-05:00,566,CBEv8v9XZrgFT8UdEdd813XnRVv9R7GB5PLMyG8UWGC8,4uNcMEcQpJdThpisgNrttkQJTUFTsjEr25qgjkm4titC,True,136592877,34148219,210804,105402,105402,4BnQKPLuE3DMTtxp8MjUBytgnhvxqq3ZTqZHTVZo4JJh,8432185,68529224,-60097039,617
2021-12-10 16:11:26.631385,2021-12-10 10:57:41-05:00,567,6oRHRnLX93bYeTN5YD2XHqskhbv8wN2pgSia9Kz3QkED,D6QG2KYp9vYZZe8tTZux5tDR6fXgm8k4SVWbpaPvEmZ1,True,56821542,14205385,87973,43986,43987,4BnQKPLuE3DMTtxp8MjUBytgnhvxqq3ZTqZHTVZo4JJh,3518936,16194042,-12675106,619
2021-12-10 16:11:26.631385,2021-12-10 11:03:57-05:00,568,FSduW743jAGyyn8HTifEJitgb89Spp5gEeMXDE59aEHF,HjojGNpR3ACtLCP2mP8DKGyXj6SeqWPKjcCAofcyQpsm,True,652513688,163128422,1019956,509978,509978,GmqQKnMfFxkv6ChqGaZ2wmSFDow7R1x7WeRfU58GVvfw,40798263,179916746,-139118483,625
2021-12-10 16:11:26.631385,2021-12-10 11:03:57-05:00,569,3fB955q6xxxZcgnCyguLwkSa7egxgBoksPQVQ3U8HRHL,GK7cTdhfSpapJB8dFzEkV8c1UFkJPj281DwztnpKjxLx,True,46143128,11535782,71996,35998,35998,GmqQKnMfFxkv6ChqGaZ2wmSFDow7R1x7WeRfU58GVvfw,2879869,23200304,-20320435,624
2021-12-10 16:11:26.631385,2021-12-10 11:04:26-05:00,570,FpqCxvTkSiwDwD5qEt6hXJxzFDLFLAQ8VevK8zwRqYun,A3p6YQisCJKpNkF7vkjZRbEfbnUt7vTZdR2zPBUSdTkk,True,34949088,8737272,54607,27303,27304,GmqQKnMfFxkv6ChqGaZ2wmSFDow7R1x7WeRfU58GVvfw,2184316,15472720,-13288404,624
2021-12-10 16:11:26.631385,2021-12-10 11:04:34-05:00,571,EDE1swNYZ99y9idZacAw5Ncwz2DyD78SqvKMUXA2Dbw4,HSmYYMpNQNr1F2zjvysGRrC57FyusAJNsaXWfbmCfZh4,True,10327020,2581755,16150,8075,8075,GmqQKnMfFxkv6ChqGaZ2wmSFDow7R1x7WeRfU58GVvfw,646014,5230446,-4584432,625
2021-12-10 16:11:26.631385,2021-12-10 11:04:54-05:00,572,6meAnGTy2XNUDk9qSJZGT6BBRinA5iGiDYEy2T88LXuX,BCzNQCn3J1381yNH5xp5ky9QmVKVdSofSUaLHtxKxPBW,True,363090,90772,567,283,284,GmqQKnMfFxkv6ChqGaZ2wmSFDow7R1x7WeRfU58GVvfw,22683,160217,-137534,624
2021-12-10 16:11:26.631385,2021-12-10 11:05:42-05:00,573,Hp4bpHhSds7eMRmW1wpCg8HPUKk5vdRJt9Wm1axJgbcG,5sPxP3PAUqWr5FuHY1kUTz5u1J4pvVB95L1rbxepS2S6,True,381104,95276,593,296,297,GmqQKnMfFxkv6ChqGaZ2wmSFDow7R1x7WeRfU58GVvfw,23721,108193,-84472,622
2021-12-10 16:11:26.631385,2021-12-10 11:06:00-05:00,574,A9BZ5kjh7iKu7SMzA5WUF31Zst9V7fehwDZaoKs4NpSi,3FzwTaT5LYucvoGGcRVXu5AUDnGHADv6yGqrBT6jEtvH,True,193383771,48345942,302545,151272,151273,GmqQKnMfFxkv6ChqGaZ2wmSFDow7R1x7WeRfU58GVvfw,12101804,69110685,-57008881,625
2021-12-10 16:11:26.631385,2021-12-10 11:06:15-05:00,575,8jmTkoNA5LM3xnsV2E1RRUegxYb8TospBNRbupaCeLF8,36LmDVFR5fgAYxgqhAtToJmRmYqYt5sVtUBkDQ3xmXhT,True,3158558,789639,4888,2444,2444,GmqQKnMfFxkv6ChqGaZ2wmSFDow7R1x7WeRfU58GVvfw,195555,852484,-656929,619
2021-12-10 16:11:26.631385,2021-12-10 11:06:15-05:00,576,66SjFhmiNYz8tLRnBhZUbowWGTbM16G52X3AT2hma2wN,3wVy8nk24HCFZWMiacGe8QsJquYaadZ9pQg44bGRwdE3,True,14237495,3559373,22198,11099,11099,GmqQKnMfFxkv6ChqGaZ2wmSFDow7R1x7WeRfU58GVvfw,887925,6957280,-6069355,623
2021-12-10 16:11:26.631385,2021-12-10 11:06:15-05:00,577,FZhvN1RjLoBK9EpCeyEobYsvdHirtbTXV82c9EV9nn2u,FSeHqYNof79JYrRb7ZkJWEb4TfS5wx7HTdvT1kLCexHM,True,19708649,4927162,30589,15294,15295,GmqQKnMfFxkv6ChqGaZ2wmSFDow7R1x7WeRfU58GVvfw,1223560,7571354,-6347794,620
2021-12-10 16:11:26.631385,2021-12-10 11:06:15-05:00,578,7gxTghaVZPNNwaNEdtQHh4QDCJ4JgigYMd4MMCC9VtFo,4ZZTUrm4jX1jqqTYVFJ9TJQ2BLx2eZgXesmoon1LBa1a,True,5084201,1271050,7915,3957,3958,GmqQKnMfFxkv6ChqGaZ2wmSFDow7R1x7WeRfU58GVvfw,316612,1556361,-1239749,622
2021-12-10 16:11:26.631385,2021-12-10 11:06:41-05:00,579,EQYUWtYbtvN9C9ixiupXPjHyFWHsYa7dUh4DSd6rxbzt,iS616uGNCwCxP1taAvvdvA2KdqfXRSjcQWwZRUgBkLb,True,4617705,1154426,7174,3587,3587,GmqQKnMfFxkv6ChqGaZ2wmSFDow7R1x7WeRfU58GVvfw,286966,2117899,-1830933,621
2021-12-10 16:11:26.631385,2021-12-10 11:06:41-05:00,580,2JH43pKUeXTXPd6LnL4BWgGQpwZHhX8EqyohKCFLAS4i,Bir3EKnDWkv6XX7KmoqAi1y6rxSaC5RfVV6Hwvnkfr2i,True,13100264,3275066,20247,10123,10124,GmqQKnMfFxkv6ChqGaZ2wmSFDow7R1x7WeRfU58GVvfw,809919,4616256,-3806337,618
2021-12-10 16:11:26.631385,2021-12-10 11:06:41-05:00,581,81GV2H9ipJSZD6YpJGj2XQNfoUroWWnKfwMHGSwvhixd,7cLHoNuNVj8qkn3QmBYLFwja37f1MWEo4e3ZcNSpXTPw,True,1235824030,308956007,1927315,963657,963658,GmqQKnMfFxkv6ChqGaZ2wmSFDow7R1x7WeRfU58GVvfw,77092626,367593308,-290500682,623
2021-12-10 16:11:26.631385,2021-12-10 11:06:41-05:00,582,C24que1C7tC3ysDSKhcBTF9NUnjiNhSanWp8Go5FRRb8,hgm3qRRG2njhNPWcUp9UnEU8pyg4gLaR2K13r4Lsqxm,True,196463723,49115930,306466,153233,153233,GmqQKnMfFxkv6ChqGaZ2wmSFDow7R1x7WeRfU58GVvfw,12258653,68943564,-56684911,623
2021-12-10 16:11:26.631385,2021-12-10 11:06:52-05:00,583,57GUgfEp9ZQ5iAU2nx1Z2Tiz3gqq7yBNaqfE1cvxjFYt,98upivFa9Tdy3RZHGM1i2k5zeczaGqioq3rTzc3DMf4x,True,51136557,12784139,78746,39373,39373,GmqQKnMfFxkv6ChqGaZ2wmSFDow7R1x7WeRfU58GVvfw,3149841,22901675,-19751834,615
2021-12-10 16:11:26.631385,2021-12-10 11:07:01-05:00,584,4xsYjVsPm2C2itNtJb3NYkBp4WySHUwtSbWdu9fge8wz,8zu2jMoTndZpf9khY9PMhve88LRwrKNTuVuLpa5ss8qo,True,182802681,45700670,285913,142956,142957,GmqQKnMfFxkv6ChqGaZ2wmSFDow7R1x7WeRfU58GVvfw,11436537,79026145,-67589608,625
2021-12-10 16:11:26.631385,2021-12-10 11:07:01-05:00,585,7aKxZg1aoLuB51JUw7fruF77ts7SWoB7pcLBZKHZMynr,AAnbLY82UGULqaDNdyJHrYu7X3hGaBuiTkGWmh8qKTc,True,5063039452,1265759863,7846363,3923181,3923182,GmqQKnMfFxkv6ChqGaZ2wmSFDow7R1x7WeRfU58GVvfw,313854536,1336064840,-1022210304,619
2021-12-10 16:11:26.631385,2021-12-10 11:07:10-05:00,586,7WB5fc5DQAWYBSgc11KfWa4kpThfyaoxp49kFGELCQMj,4qD4BkxDzJ6uZ2iKgsXZtghNbNsnHmaKyjGWLZW9YTdU,True,24568259,6142064,38426,19213,19213,GmqQKnMfFxkv6ChqGaZ2wmSFDow7R1x7WeRfU58GVvfw,1537053,6575987,-5038934,625
2021-12-10 16:47:37.647782,2021-12-10 11:14:21-05:00,587,3XzkSrNTGd3Fhd4M3gYzvz2utbQpFN1fhtbAaZu7C39R,GMsZGGfktTzYi7GhD3W6HY9QY9bznqTKfeArksikLE71,True,2412492,603123,3772,1886,1886,4BnQKPLuE3DMTtxp8MjUBytgnhvxqq3ZTqZHTVZo4JJh,150898,1008720,-857822,625
2021-12-10 16:47:37.647782,2021-12-10 11:14:23-05:00,588,8w4uRzN81cghupkF7jNLinGLtCqYwNQFgQtdJfC5so7z,BbbRkq85fYEBGmuxBEEPbt6up4GNB7WQ83VSXwe4ro98,True,2086936704,521734176,3259977,1629988,1629989,GmqQKnMfFxkv6ChqGaZ2wmSFDow7R1x7WeRfU58GVvfw,130399084,743669320,-613270236,624
2021-12-10 16:47:37.647782,2021-12-10 11:14:31-05:00,589,7UwBQLT7uc8DFabDUwRBgTCjm2Tprh79HoDwhPCap6v7,CdWQHx3cRLC7ApxXSbVD3D6y2V6vtqQJLMjuhFcdbp4X,True,161019362,40254840,251494,125747,125747,GmqQKnMfFxkv6ChqGaZ2wmSFDow7R1x7WeRfU58GVvfw,10059777,79257948,-69198171,624
2021-12-10 16:47:37.647782,2021-12-10 11:16:47-05:00,590,2XFYFxNQbCr5ao4cVzRZt45fsAwZc4jD9XTABmdqaJWd,CvpzBuDjyimaYFGWFkkBcaZGSRtAvtF6MtRV54mqZ74k,True,268574,67143,416,208,208,GmqQKnMfFxkv6ChqGaZ2wmSFDow7R1x7WeRfU58GVvfw,16661,123627,-106966,620
2021-12-10 16:47:37.647782,2021-12-10 11:16:58-05:00,591,DVV4Vhk44E5YvVzpXgjJMepYgUB5uKXmAhEbFg6R5vWJ,8CS7rCKNx7AQ5yaEA2rHrYx4PHnC9mK3DtSQmiKW2nUb,True,83356618,20839154,129077,64538,64539,GmqQKnMfFxkv6ChqGaZ2wmSFDow7R1x7WeRfU58GVvfw,5163107,34580481,-29417374,619
2021-12-10 16:47:37.647782,2021-12-10 11:16:58-05:00,592,3Ek5j2ea8wS2nCxsNgn2AbovxzJwGK7zc6xarkigSA3u,DEWmTn3Ah4F3nNXpoQLt1GG65Dsf4ZmGjn7FZUJyK6rP,True,611578520,152894630,947300,473650,473650,GmqQKnMfFxkv6ChqGaZ2wmSFDow7R1x7WeRfU58GVvfw,37892004,280503002,-242610998,619
2021-12-10 16:47:37.647782,2021-12-10 11:17:00-05:00,593,FP6SmbXDbcb6c8Pi8uZMn6hnQDUbvbdCfzd5pEqyBgTm,53A9dhER1x3JjdceGMQmjujvWht7uemsoB3ngQLdo6Ub,True,409433789,102358447,639061,319530,319531,GmqQKnMfFxkv6ChqGaZ2wmSFDow7R1x7WeRfU58GVvfw,25562440,154416272,-128853832,624
2021-12-10 16:47:37.647782,2021-12-10 11:17:11-05:00,594,UW2CpVNGdbJggmssZki77W8jKUKzXG33UHMKpWHdan8,9XWQR558UZHBfGk17D7z69xH2PH9BTFe9kfxSa467sEW,True,137969673,34492418,215791,107895,107896,GmqQKnMfFxkv6ChqGaZ2wmSFDow7R1x7WeRfU58GVvfw,8631648,29915439,-21283791,625
2021-12-10 16:47:37.647782,2021-12-10 11:17:15-05:00,595,8d333AWdyiVhvkAdiKCTwhgzaPBMbn8mtucwUC1SAbZZ,3BM8UNLN7XGRaYRjezAqFVMr1z4PS3VRXiN1NAtvBuD9,True,42672480,10668120,66543,33271,33272,GmqQKnMfFxkv6ChqGaZ2wmSFDow7R1x7WeRfU58GVvfw,2661728,18561047,-15899319,623
2021-12-10 16:47:37.647782,2021-12-10 11:17:32-05:00,596,J1sBDjpdBZcsSBS5eg95SSRjRqmQUR9cXJCsLJu8yCUt,F5wRpD2senMkGbL8Uquqo8W9x5NQDDa268dHuVFAZCww,True,227282302,56820575,354389,177194,177195,GmqQKnMfFxkv6ChqGaZ2wmSFDow7R1x7WeRfU58GVvfw,14175591,56649392,-42473801,623
2021-12-10 16:47:37.647782,2021-12-10 11:17:41-05:00,597,DSEgVqfxXp5wxjn3gNZtmb4E6rJeBm3VcbqdwDnsuzSq,6YVCWznUKheSMPuywSRJgCes7wghPGJXgxfrVfnjN4mB,True,424478412,106119603,657236,328618,328618,GmqQKnMfFxkv6ChqGaZ2wmSFDow7R1x7WeRfU58GVvfw,26289470,129230593,-102941123,619
2021-12-10 16:47:37.647782,2021-12-10 11:17:41-05:00,598,9gPrKNWv1QtsESCPUw943xgbjkekLYzfQnByM3hDRw8v,DYYhdA6LaKnRhRP7ut5u9xvoecDSY2TSYnfc2oJjz2MZ,True,64197751,16049437,99393,49696,49697,GmqQKnMfFxkv6ChqGaZ2wmSFDow7R1x7WeRfU58GVvfw,3975739,13928223,-9952484,619
2021-12-10 16:47:37.647782,2021-12-10 11:17:41-05:00,599,DCxghVXCXzEar41CPGichdzvtjwmf4NW7uHtKTj57BNN,Fmh5FPdnFb1KpFkoL6eNfWFGxN78GLdaJgPcVpCoCnkh,True,167914103,41978525,261479,130739,130740,GmqQKnMfFxkv6ChqGaZ2wmSFDow7R1x7WeRfU58GVvfw,10459167,59030750,-48571583,622
2021-12-10 16:47:37.647782,2021-12-10 11:17:43-05:00,600,8fVwuVA2CL5sZoHh6Dg4MBpcX3cvoUm7mnitnpQSdPBD,4F4ccaNm1KQu29XvsKvdjFkmpsbWqNvXkV41851EYQyu,True,32660823,8165205,50721,25360,25361,GmqQKnMfFxkv6ChqGaZ2wmSFDow7R1x7WeRfU58GVvfw,2028866,12057074,-10028208,621
2021-12-10 16:47:37.647782,2021-12-10 11:18:30-05:00,601,8w1hzDtCFuTJqWAtwihztrPzxwa7YrJH5uPk877SJnNj,D3gnctosqTZxTQNfLJQRdPgCvGx2JLLHHDmcvW5UX1QN,True,284291361,71072840,440795,220397,220398,GmqQKnMfFxkv6ChqGaZ2wmSFDow7R1x7WeRfU58GVvfw,17631801,101845954,-84214153,620
2021-12-10 16:47:37.647782,2021-12-10 11:18:30-05:00,602,8Xdf67Q5jXKwS52e492xUBu1tMUgS14jJg7V4R2Q28EP,GAPL3bsXP4xcukhgzyqrbDntGwUSm5BfuwJ8TLKkRaZc,True,202631815,50657953,316362,158181,158181,GmqQKnMfFxkv6ChqGaZ2wmSFDow7R1x7WeRfU58GVvfw,12654518,65612227,-52957709,624
2021-12-10 16:47:37.647782,2021-12-10 11:18:33-05:00,603,BELLbzmdx1SYke9kZUxFi9VcdvwaHmkZyv24FArQ1J2f,5a5LfKakAaFEVkavVHgExKaUr25RWYpzFic6MUQQ62uc,True,797291306,199322826,1228201,614100,614101,GmqQKnMfFxkv6ChqGaZ2wmSFDow7R1x7WeRfU58GVvfw,49128078,366681049,-317552971,616
2021-12-10 16:47:37.647782,2021-12-10 11:18:40-05:00,604,CQSb6ZVY1KVNXFAg8pxm8RvBBGGqRSU7FMvwHJPy46u8,FRBv3b5VTfKN1bK4DXFY4329LFbvm882P47edrgpuSM,True,389765612,97441403,600695,300347,300348,GmqQKnMfFxkv6ChqGaZ2wmSFDow7R1x7WeRfU58GVvfw,24027816,153848541,-129820725,616
2021-12-10 16:47:37.647782,2021-12-10 11:19:10-05:00,605,6TWJ8huRvaHdb1Rr9TvV5oNA163kaV8o8dpXoZBrCotK,FB8yfdGootXBhsPpUB6i2cqjweFD2rjtUXg5KHM2zDPs,True,760856348,190214087,1092652,546326,546326,GmqQKnMfFxkv6ChqGaZ2wmSFDow7R1x7WeRfU58GVvfw,43706109,189369850,-145663741,574
2021-12-10 16:47:37.647782,2021-12-10 11:19:22-05:00,606,EvSdLa5PeJiaaaE3omJNG7cw1tptZnHTituYswVHSwm3,68ESX2mBsfxQo2U9jsbmHo7TzPTxr9mGH5Y11ZLR7E3A,True,17002316,4250579,26533,13266,13267,GmqQKnMfFxkv6ChqGaZ2wmSFDow7R1x7WeRfU58GVvfw,1061328,7820660,-6759332,624
2021-12-10 16:47:37.647782,2021-12-10 11:19:29-05:00,607,94KFzzXCAvEfSf3jrnUpyN3pne8Xfc6nroB7UxTVqeyB,ERQEKcL8qV9WEzLwi5WFjh2wN97q9GD9pqd9umcTypxy,True,1851012,462753,2887,1443,1444,GmqQKnMfFxkv6ChqGaZ2wmSFDow7R1x7WeRfU58GVvfw,115517,760016,-644499,624
2021-12-10 16:47:37.647782,2021-12-10 11:19:59-05:00,608,BgoKAyBNaJ1geeQ2FcGSHEQDWATVD3w3wmcNHtj8Awu3,8Haz7duE2ycueaJsGdrGNnK79KGHwnzKBpoafC8RZGg2,True,1766355279,441588819,2724682,1362341,1362341,GmqQKnMfFxkv6ChqGaZ2wmSFDow7R1x7WeRfU58GVvfw,108987294,452139158,-343151864,617
2021-12-10 16:47:37.647782,2021-12-10 11:19:59-05:00,609,6Q1rYCUFMg3Jf95EfDtPyK4cKFZ2t3koq64coK6haUjV,7JwejhxWxNP7yYB2utHcbFPz9UEGsEGszd7fvpwEwnq3,True,2038817400,509704350,3178321,1589160,1589161,GmqQKnMfFxkv6ChqGaZ2wmSFDow7R1x7WeRfU58GVvfw,127132851,896031843,-768898992,623
2021-12-10 16:47:37.647782,2021-12-10 11:23:03-05:00,610,8soQsYfQCngqJ5gLpWSuuzDUo1YLg53mU6GBF5RBizNn,HdsRtpasJYyFdS3sKqFAwJespt8x7cKUfGuvEuxmWdxV,True,21623764,5405941,33449,16724,16725,GmqQKnMfFxkv6ChqGaZ2wmSFDow7R1x7WeRfU58GVvfw,1337991,6121949,-4783958,618
2021-12-10 16:47:37.647782,2021-12-10 11:23:53-05:00,611,64w7jdrK2Kv8Wc55SfKBt7U6paGQ2NRGf31zPFC6Qk8G,3t6zWvFwvvfSFLaEdUoEzZZSW4ykWScvQnQDkTatKKg1,True,6312906,1578226,9806,4903,4903,GmqQKnMfFxkv6ChqGaZ2wmSFDow7R1x7WeRfU58GVvfw,392248,1579375,-1187127,621
2021-12-10 16:47:37.647782,2021-12-10 11:23:53-05:00,612,E5KDZriZ89a5D4VsMaWxndMMG68RT4weruJ1tCEc6tSx,CaSwkUocpbyyGCQBgKjJZJgcexbyqs2GTrGJH6EMWXAz,True,1654699545,413674886,2546193,1273096,1273097,GmqQKnMfFxkv6ChqGaZ2wmSFDow7R1x7WeRfU58GVvfw,101847741,658213994,-556366253,615
2021-12-10 16:47:37.647782,2021-12-10 11:23:54-05:00,613,7TBoPCDA6BACBPJvpwHVHQh1EeydCHD2KT4TaQ4NWrc3,6GLRsMGMNBA8qf27VGfXyXtTt31J9GUVrqqJM7H2RhwK,True,111074313,27768578,170839,85419,85420,GmqQKnMfFxkv6ChqGaZ2wmSFDow7R1x7WeRfU58GVvfw,6833578,29149402,-22315824,615
2021-12-10 16:47:37.647782,2021-12-10 11:23:54-05:00,614,J5WcVsKNHbfioai1LRowvjvtEmUJBEkeoBim1ThshpoP,Ajh7SWBq3zJR4vb6AFoBS6C9D99wC6YF1sVN22qC1vCA,True,193936595,48484148,296069,148034,148035,72FwbpFGoLEazJEdpqNtPNefsadUrimUqma9wSoy4qiS,11842778,48214233,-36371455,610
2021-12-10 17:34:34.847872,2021-12-10 12:19:51-05:00,615,FCrgF8s6BHP9Hho11yzZgbSaVXraUxJA3zSEzQK52DFQ,HAikgTkQvmKEseE5mXxVFKe1pyvVmTZePHh4M27YgFDg,True,4377373,1094343,6762,3381,3381,GmqQKnMfFxkv6ChqGaZ2wmSFDow7R1x7WeRfU58GVvfw,270511,893138,-622627,617
2021-12-10 17:34:34.847872,2021-12-10 12:19:51-05:00,616,BCGo6RhFcVnLCzZxtEh5YDyfq59nEWXPyJ5STC9PkzA1,24ShUfs1AB1n5NUus99sZ58kuSvMPhVgpiiT56rcLHRk,True,282312134,70578033,437898,218949,218949,GmqQKnMfFxkv6ChqGaZ2wmSFDow7R1x7WeRfU58GVvfw,17515934,61521395,-44005461,620
2021-12-10 17:34:34.847872,2021-12-10 12:19:51-05:00,617,3qyKG4juvhcDnhoSVAFibqJtk5i4q8vLVgvwzXtdk5KP,2ofR6Hdm8qgQfKnaNFouzzBs311xgPcxny4ViS7g2Wxo,True,49629177,12407294,75420,37710,37710,GmqQKnMfFxkv6ChqGaZ2wmSFDow7R1x7WeRfU58GVvfw,3016820,12468768,-9451948,607
2021-12-10 17:34:34.847872,2021-12-10 12:19:51-05:00,618,DH2tcZVt4nHQbph6znZRrwcyhjwiNYtgeamu72vcC6nR,ACsbP5BDFQEHQHTsdrWTBShhEUh9HeAKsE7iwyK72v2p,True,59236658,14809164,91688,45844,45844,GmqQKnMfFxkv6ChqGaZ2wmSFDow7R1x7WeRfU58GVvfw,3667543,15360509,-11692966,619
2021-12-10 17:34:34.847872,2021-12-10 12:19:51-05:00,619,6woJkgUd2cpQQQBEp1C2G9NsYAvPwYmZXXTd6AxhieMy,E6xCdLJbDq5qFsvHEffD1Qfqrsj19H81mbj7XMUXUPnr,True,1225778138,306444534,1913951,956975,956976,GmqQKnMfFxkv6ChqGaZ2wmSFDow7R1x7WeRfU58GVvfw,76558075,313132071,-236573996,624
2021-12-10 17:34:34.847872,2021-12-10 12:20:49-05:00,620,D58t4uTjFumsUeYFaKnpV8BRTEQEqKXBreFTdwGrott7,67p6kHDfVqQijfcwugvZK59c3aRRH9x3eHxruqH8WEqF,True,64975895,16243973,100292,50146,50146,72FwbpFGoLEazJEdpqNtPNefsadUrimUqma9wSoy4qiS,4011681,13355402,-9343721,617
2021-12-10 17:34:34.847872,2021-12-10 12:20:49-05:00,621,2hffMTM4DWHvJndYsT5pMMqS8PcyEyqVU9nGA73ozRRB,5BMxbZHCQaBxXcJvpZM33G2pyvp7pJMqAREooPWnMQdB,False,937106142,937106142,31067117,1553355,29513762,72FwbpFGoLEazJEdpqNtPNefsadUrimUqma9wSoy4qiS,31067117,207769355,-176702238,331
2021-12-10 17:34:34.847872,2021-12-10 12:20:49-05:00,622,FgQ1T5Jdtb9hGAv8VnArbNATkPnoNAE3kh89AuRAghmm,ZCcEop7zQrFmzrSVMTSJ64sabtjWNKYNmx5q8C68LZk,False,430545905,430545905,11536973,576848,10960125,72FwbpFGoLEazJEdpqNtPNefsadUrimUqma9wSoy4qiS,11536973,99455158,-87918185,267
2021-12-10 17:34:34.847872,2021-12-10 12:20:49-05:00,623,8soQsYfQCngqJ5gLpWSuuzDUo1YLg53mU6GBF5RBizNn,HdsRtpasJYyFdS3sKqFAwJespt8x7cKUfGuvEuxmWdxV,False,15513692,15513692,597352,29867,567485,72FwbpFGoLEazJEdpqNtPNefsadUrimUqma9wSoy4qiS,597352,4889488,-4292136,385
2021-12-10 17:34:34.847872,2021-12-10 12:20:49-05:00,624,7gxTghaVZPNNwaNEdtQHh4QDCJ4JgigYMd4MMCC9VtFo,4ZZTUrm4jX1jqqTYVFJ9TJQ2BLx2eZgXesmoon1LBa1a,False,3614059,3614059,108893,5444,103449,72FwbpFGoLEazJEdpqNtPNefsadUrimUqma9wSoy4qiS,108893,1237815,-1128922,301
2021-12-10 17:34:34.847872,2021-12-10 12:20:49-05:00,625,94KFzzXCAvEfSf3jrnUpyN3pne8Xfc6nroB7UxTVqeyB,ERQEKcL8qV9WEzLwi5WFjh2wN97q9GD9pqd9umcTypxy,False,1326262,1326262,50372,2518,47854,72FwbpFGoLEazJEdpqNtPNefsadUrimUqma9wSoy4qiS,50372,595745,-545373,379
2021-12-10 17:34:34.847872,2021-12-10 12:20:49-05:00,626,6HzCJnV3Z4psm7V64UpJBstZxK2XAxUySyuoX8RJaFwY,2AsimTXANwSRChLJWdLjdJG8X2gwGsrjPguqFZjuAeA9,False,844540921,844540921,37594706,1879735,35714971,72FwbpFGoLEazJEdpqNtPNefsadUrimUqma9wSoy4qiS,37594706,185217942,-147623236,445
2021-12-10 17:34:34.847872,2021-12-10 12:20:49-05:00,627,E4VbQS7DPAs2DEZQhJ3zmHyXQPC5juU7XqLmSabjiPxy,2Va5k3pVPrEAtcVTz37hKGyrS9uszw79ngrJVxkfo6w7,False,312088832,312088832,12559169,627958,11931211,72FwbpFGoLEazJEdpqNtPNefsadUrimUqma9wSoy4qiS,12559169,150469337,-137910168,402
2021-12-10 17:34:34.847872,2021-12-10 12:20:49-05:00,628,Hp4bpHhSds7eMRmW1wpCg8HPUKk5vdRJt9Wm1axJgbcG,5sPxP3PAUqWr5FuHY1kUTz5u1J4pvVB95L1rbxepS2S6,False,270212,270212,7459,372,7087,72FwbpFGoLEazJEdpqNtPNefsadUrimUqma9wSoy4qiS,7459,86461,-79002,276
2021-12-10 17:34:34.847872,2021-12-10 12:20:51-05:00,629,UW2CpVNGdbJggmssZki77W8jKUKzXG33UHMKpWHdan8,9XWQR558UZHBfGk17D7z69xH2PH9BTFe9kfxSa467sEW,False,98503009,98503009,3422190,171109,3251081,72FwbpFGoLEazJEdpqNtPNefsadUrimUqma9wSoy4qiS,3422190,24359882,-20937692,347
2021-12-10 17:34:34.847872,2021-12-10 12:20:52-05:00,630,7jvKp6onXyWgwsFrFWj4hYTXJsYYD6ot5mn6rPFuJriy,J7N6HiozevJVTiY9hDEUs2ud5BwT5QSE7wnMBS1w5ie2,True,2834528547,708632136,4295795,2147897,2147898,72FwbpFGoLEazJEdpqNtPNefsadUrimUqma9wSoy4qiS,171831839,712316774,-540484935,606
2021-12-10 17:34:34.847872,2021-12-10 12:20:52-05:00,631,3fB955q6xxxZcgnCyguLwkSa7egxgBoksPQVQ3U8HRHL,GK7cTdhfSpapJB8dFzEkV8c1UFkJPj281DwztnpKjxLx,False,32674392,32674392,868476,43423,825053,72FwbpFGoLEazJEdpqNtPNefsadUrimUqma9wSoy4qiS,868476,18041845,-17173369,265
2021-12-10 17:34:34.847872,2021-12-10 12:20:52-05:00,632,64w7jdrK2Kv8Wc55SfKBt7U6paGQ2NRGf31zPFC6Qk8G,3t6zWvFwvvfSFLaEdUoEzZZSW4ykWScvQnQDkTatKKg1,False,4540501,4540501,187368,9368,178000,72FwbpFGoLEazJEdpqNtPNefsadUrimUqma9wSoy4qiS,187368,1271948,-1084580,412
2021-12-10 17:34:34.847872,2021-12-10 12:20:52-05:00,633,9kK2PuehQxgcXtnYnPNmukmzfDTsVHv15pE86xwi7vYt,DtbCSCur1w6ZMGu56auQaHf8c6gVDJoD1iEwiUyCBcYJ,False,3501061,3501061,84099,4204,79895,72FwbpFGoLEazJEdpqNtPNefsadUrimUqma9wSoy4qiS,84099,1650969,-1566870,240
2021-12-10 17:34:34.847872,2021-12-10 12:20:52-05:00,634,DCTeYphaDsdFWZ61JXusR3dwLqKWkYgCjkxZSQvPzRuK,4jrC1EU7WC2vAPZdhnWyb39nK1XacNv32tPgsuK4MVn6,False,10538824257,10538824257,406158025,20307901,385850124,72FwbpFGoLEazJEdpqNtPNefsadUrimUqma9wSoy4qiS,406158025,2366071269,-1959913244,385
2021-12-10 17:34:34.847872,2021-12-10 12:20:52-05:00,635,CQSb6ZVY1KVNXFAg8pxm8RvBBGGqRSU7FMvwHJPy46u8,FRBv3b5VTfKN1bK4DXFY4329LFbvm882P47edrgpuSM,False,278292181,278292181,9340047,467002,8873045,72FwbpFGoLEazJEdpqNtPNefsadUrimUqma9wSoy4qiS,9340047,120742973,-111402926,335
2021-12-10 17:34:34.847872,2021-12-10 12:20:52-05:00,636,3cL7zgQV5KP7iv83P3xHMGQaPBFcf2p3gWHu7oWg2wAr,G8m6Tv9LKASkqYQdYJWzt7kFLrBQrRiCjHUCVsSCAL9w,False,84006532,84006532,3000351,150017,2850334,72FwbpFGoLEazJEdpqNtPNefsadUrimUqma9wSoy4qiS,3000351,18983719,-15983368,357
2021-12-10 17:34:34.847872,2021-12-10 12:20:52-05:00,637,FpqCxvTkSiwDwD5qEt6hXJxzFDLFLAQ8VevK8zwRqYun,A3p6YQisCJKpNkF7vkjZRbEfbnUt7vTZdR2zPBUSdTkk,False,24689211,24689211,602221,30111,572110,72FwbpFGoLEazJEdpqNtPNefsadUrimUqma9wSoy4qiS,602221,12091189,-11488968,243
2021-12-10 17:34:34.847872,2021-12-10 12:20:52-05:00,638,93ho4cgnpAJiJsG6uu2udkLVNU7rkz4QjCYfsqvpbPA5,45ouQn9gGwXqnTGfaP5CvU8fCKadBRA5kPwtfvJzykRU,True,744153306,186038326,980204,490102,490102,72FwbpFGoLEazJEdpqNtPNefsadUrimUqma9wSoy4qiS,39208193,192490460,-153282267,526
2021-12-10 17:34:34.847872,2021-12-10 12:20:53-05:00,639,6oRHRnLX93bYeTN5YD2XHqskhbv8wN2pgSia9Kz3QkED,D6QG2KYp9vYZZe8tTZux5tDR6fXgm8k4SVWbpaPvEmZ1,False,40046391,40046391,847277,42363,804914,72FwbpFGoLEazJEdpqNtPNefsadUrimUqma9wSoy4qiS,847277,12923493,-12076216,211
2021-12-10 17:34:34.847872,2021-12-10 12:20:53-05:00,640,DSEgVqfxXp5wxjn3gNZtmb4E6rJeBm3VcbqdwDnsuzSq,6YVCWznUKheSMPuywSRJgCes7wghPGJXgxfrVfnjN4mB,False,302535717,302535717,9749293,487464,9261829,72FwbpFGoLEazJEdpqNtPNefsadUrimUqma9wSoy4qiS,9749293,102784140,-93034847,322
2021-12-10 17:34:34.847872,2021-12-10 12:20:53-05:00,641,7TBoPCDA6BACBPJvpwHVHQh1EeydCHD2KT4TaQ4NWrc3,6GLRsMGMNBA8qf27VGfXyXtTt31J9GUVrqqJM7H2RhwK,False,79638217,79638217,2979466,148973,2830493,72FwbpFGoLEazJEdpqNtPNefsadUrimUqma9wSoy4qiS,2979466,23384272,-20404806,374
2021-12-10 17:34:34.847872,2021-12-10 12:20:53-05:00,642,6Q1rYCUFMg3Jf95EfDtPyK4cKFZ2t3koq64coK6haUjV,7JwejhxWxNP7yYB2utHcbFPz9UEGsEGszd7fvpwEwnq3,False,1457062591,1457062591,51615751,2580787,49034964,72FwbpFGoLEazJEdpqNtPNefsadUrimUqma9wSoy4qiS,51615751,700490529,-648874778,354
2021-12-10 17:34:34.847872,2021-12-10 12:20:53-05:00,643,7WB5fc5DQAWYBSgc11KfWa4kpThfyaoxp49kFGELCQMj,4qD4BkxDzJ6uZ2iKgsXZtghNbNsnHmaKyjGWLZW9YTdU,False,17440972,17440972,509953,25497,484456,72FwbpFGoLEazJEdpqNtPNefsadUrimUqma9wSoy4qiS,509953,5274457,-4764504,292
2021-12-10 17:34:34.847872,2021-12-10 12:20:53-05:00,644,B5CTBTggmGFvGFSunjbB4C9tLKcYcULehmEiEXRihY2J,FX3ebF8P89rZBWfR74PDWUzxnLuDkUDgGcPYCBD5sMUG,False,58457320,58457320,1885942,94297,1791645,72FwbpFGoLEazJEdpqNtPNefsadUrimUqma9wSoy4qiS,1885942,13440545,-11554603,322
2021-12-10 17:34:34.847872,2021-12-10 12:20:53-05:00,645,49hagnoMSB3ozBBMaTgeZ2nwEbKKS3NZWUuPShMBUwp9,6ivAhvY6bUr98jqBp4ye1w8Vz8NesEubqKDSn1jeqxmr,False,59083319,59083319,2480351,124017,2356334,72FwbpFGoLEazJEdpqNtPNefsadUrimUqma9wSoy4qiS,2480351,15690983,-13210632,419
2021-12-10 17:34:34.847872,2021-12-10 12:20:53-05:00,646,HnUkyFhntoajDEgXMKeoh4nAuY5y7osLYwmYAApyLSNs,GntEkHxrGpcHFCVLQGjKiXWdenbsqfQgxddpEpxpE65z,False,9947320,9947320,196744,9837,186907,72FwbpFGoLEazJEdpqNtPNefsadUrimUqma9wSoy4qiS,196744,4264254,-4067510,197
2021-12-10 17:34:34.847872,2021-12-10 12:20:53-05:00,647,3ufE8ZossNvypfLHuvbYMGyrAwKk7CUShTFqfpkjsCFB,DKF6tQstSHpxM9QTUCt6yU1iFZrRiXodRSZd9pSYBJN9,True,466563677,116640919,621535,310767,310768,72FwbpFGoLEazJEdpqNtPNefsadUrimUqma9wSoy4qiS,24861404,102770250,-77908846,532
2021-12-10 17:34:34.847872,2021-12-10 12:20:53-05:00,648,EvSdLa5PeJiaaaE3omJNG7cw1tptZnHTituYswVHSwm3,68ESX2mBsfxQo2U9jsbmHo7TzPTxr9mGH5Y11ZLR7E3A,False,12139665,12139665,420321,21016,399305,72FwbpFGoLEazJEdpqNtPNefsadUrimUqma9wSoy4qiS,420321,6101949,-5681628,346
2021-12-10 17:34:34.847872,2021-12-10 12:20:53-05:00,649,7uzNVopRjtoGCPz2CZPd88S6iLaXox1s1j3DAJE3YLSY,4HBjxtkRLW4bL6R6s5HpyUfk5FqQoQUsy9mLq3zKdc2M,False,7976688781,7976688781,161361796,8068089,153293707,72FwbpFGoLEazJEdpqNtPNefsadUrimUqma9wSoy4qiS,161361796,2056813071,-1895451275,202
2021-12-10 17:34:34.847872,2021-12-10 12:20:55-05:00,650,3XzkSrNTGd3Fhd4M3gYzvz2utbQpFN1fhtbAaZu7C39R,GMsZGGfktTzYi7GhD3W6HY9QY9bznqTKfeArksikLE71,False,1722105,1722105,59523,2976,56547,72FwbpFGoLEazJEdpqNtPNefsadUrimUqma9wSoy4qiS,59523,790183,-730660,345
2021-12-10 17:34:34.847872,2021-12-10 12:20:55-05:00,651,6H9q1kvPwD2ZxS5ir2EDWF4RjH31Qto5fj3KUjirPSXq,5a3JtjtVmE1UEiHs5cv9YVzWKyayj2SumGiB6YeDZKVh,False,131353567,131353567,4988113,249405,4738708,72FwbpFGoLEazJEdpqNtPNefsadUrimUqma9wSoy4qiS,4988113,28618891,-23630778,379
2021-12-10 17:34:34.847872,2021-12-10 12:20:56-05:00,652,BELLbzmdx1SYke9kZUxFi9VcdvwaHmkZyv24FArQ1J2f,5a5LfKakAaFEVkavVHgExKaUr25RWYpzFic6MUQQ62uc,False,571941074,571941074,21759869,1087993,20671876,72FwbpFGoLEazJEdpqNtPNefsadUrimUqma9wSoy4qiS,21759869,285975322,-264215453,380
2021-12-10 17:34:34.847872,2021-12-10 12:20:59-05:00,653,9gPrKNWv1QtsESCPUw943xgbjkekLYzfQnByM3hDRw8v,DYYhdA6LaKnRhRP7ut5u9xvoecDSY2TSYnfc2oJjz2MZ,False,45975854,45975854,1694835,84741,1610094,72FwbpFGoLEazJEdpqNtPNefsadUrimUqma9wSoy4qiS,1694835,11331811,-9636976,368
2021-12-10 17:34:34.847872,2021-12-10 12:20:59-05:00,654,G7kJUwq3DhEH6zhaeToRFMTKBEH3ME45hbqmrHbQD1nP,JmGGddHjC5bSieVcDn3sMeRBLryEhQKJmmtnkWza66L,False,252458954,252458954,6120228,306011,5814217,72FwbpFGoLEazJEdpqNtPNefsadUrimUqma9wSoy4qiS,6120228,62818907,-56698679,242
2021-12-10 17:34:34.847872,2021-12-10 12:20:59-05:00,655,EwXuWCu3Y5p2HUSHa6PvqDrtx84YCKnQ6qaMQ6ZX97y4,2Ah5UrJc8fJb3aouTH2Afv2zDsvQfJU2NoWiodepqWJV,False,31535335870,31535335870,1269217711,63460885,1205756826,72FwbpFGoLEazJEdpqNtPNefsadUrimUqma9wSoy4qiS,1269217711,9745439249,-8476221538,402
2021-12-10 17:34:34.847872,2021-12-10 12:20:59-05:00,656,EDE1swNYZ99y9idZacAw5Ncwz2DyD78SqvKMUXA2Dbw4,HSmYYMpNQNr1F2zjvysGRrC57FyusAJNsaXWfbmCfZh4,False,7270230,7270230,153385,7669,145716,72FwbpFGoLEazJEdpqNtPNefsadUrimUqma9wSoy4qiS,153385,4066767,-3913382,210
2021-12-10 17:34:34.847872,2021-12-10 12:20:59-05:00,657,BC5PbNKwQoyH6tU7HAX4iLnuG7zUHc2QjSDkYLCsdhGx,Eu38e4GbPPtqtHpXgy9cwTn8MBLBPBjprGv1wv4L2evR,False,373868710,373868710,9291315,464565,8826750,72FwbpFGoLEazJEdpqNtPNefsadUrimUqma9wSoy4qiS,9291315,86634158,-77342843,248
2021-12-10 17:34:34.847872,2021-12-10 12:20:59-05:00,658,8w4uRzN81cghupkF7jNLinGLtCqYwNQFgQtdJfC5so7z,BbbRkq85fYEBGmuxBEEPbt6up4GNB7WQ83VSXwe4ro98,False,1477350501,1477350501,38993541,1949677,37043864,72FwbpFGoLEazJEdpqNtPNefsadUrimUqma9wSoy4qiS,38993541,586945592,-547952051,263
2021-12-10 17:34:34.847872,2021-12-10 12:20:59-05:00,659,EDSf2w1UyGvbgMuxyoXL58ifR1dviZinnLBYnFmgjcNG,DFenkzbL9SUjs9cSCaHJ1eXK75mHfk3GSPRFs8TSzrFV,False,47373705,47373705,878230,43911,834319,72FwbpFGoLEazJEdpqNtPNefsadUrimUqma9wSoy4qiS,878230,21787027,-20908797,185
2021-12-10 17:34:34.847872,2021-12-10 12:20:59-05:00,660,9WyHRAB1rNAWcb1SzNRsAVgxaYoVCLeFZGEX93jsftcK,8fM8LBrUCEjtXitNNU1MvvqEQy4M6DNdrMRpNf3E3wPr,False,1247620959,1247620959,58914909,2945745,55969164,72FwbpFGoLEazJEdpqNtPNefsadUrimUqma9wSoy4qiS,58914909,390610188,-331695279,472
2021-12-10 17:34:34.847872,2021-12-10 12:20:59-05:00,661,7BY59PkXpdNQBwBAUte9icDDzB9H7pUWpG92DDtb5bQp,7Vp4w3nAdypxFAbZsq9CyLi83GM4z1rXPkrwUvPkP6XE,True,292003756,73000939,371786,185893,185893,72FwbpFGoLEazJEdpqNtPNefsadUrimUqma9wSoy4qiS,14871451,65134328,-50262877,509
2021-12-10 17:34:34.847872,2021-12-10 12:21:00-05:00,662,8w1hzDtCFuTJqWAtwihztrPzxwa7YrJH5uPk877SJnNj,D3gnctosqTZxTQNfLJQRdPgCvGx2JLLHHDmcvW5UX1QN,False,201788893,201788893,5721262,286063,5435199,72FwbpFGoLEazJEdpqNtPNefsadUrimUqma9wSoy4qiS,5721262,80314283,-74593021,283
2021-12-10 17:34:34.847872,2021-12-10 12:21:00-05:00,663,6eNfcSNvCuHs81L6nJcWHZjuc1ZUimLKHrhMh4LFsPi7,8DYdD73cQgw21P1QmiCAQWYrU5yG5K72yKjokzDLNcs8,False,78591525,78591525,1303687,65184,1238503,72FwbpFGoLEazJEdpqNtPNefsadUrimUqma9wSoy4qiS,1303687,17702567,-16398880,165
2021-12-10 17:34:34.847872,2021-12-10 12:21:01-05:00,664,CrVwfwqXiECyR4PMHs3ZiibPmEpRnJFdtG2wDEBAUDB7,H3VLpUgvEpQXkBsEQu6Rzcan9gESe8w7LDFzfQbxhmME,False,138565075,138565075,3958498,197924,3760574,72FwbpFGoLEazJEdpqNtPNefsadUrimUqma9wSoy4qiS,3958498,30484757,-26526259,285
2021-12-10 17:34:34.847872,2021-12-10 12:21:01-05:00,665,Gbxc51WERLLeCtiHv7rDvE52aqF541RoQWG5n5aqErq6,4ngBoHbfXijLMqGKxFMNht9sbmxy2g5eqBmn8QsBmbx1,True,64891947,16222986,93839,46919,46920,72FwbpFGoLEazJEdpqNtPNefsadUrimUqma9wSoy4qiS,3753581,13487223,-9733642,578
2021-12-10 17:34:34.847872,2021-12-10 12:21:01-05:00,666,EBUcTqh9AYyRokZRzLbPKL9ZmTUx6KcDEbBeuCLGwqYC,B5WSXfHzYQhUFE2T97GaiqSkeejTWKKGVjMkcFrxEvyJ,False,32753233,32753233,770210,38510,731700,72FwbpFGoLEazJEdpqNtPNefsadUrimUqma9wSoy4qiS,770210,7387445,-6617235,235
2021-12-10 17:34:34.847872,2021-12-10 12:21:01-05:00,667,4DFa7jRrs71bUCbkpD19kWJG8RU6z58ymgG47NhuP6gC,7jvKYqZ5QU44VqsgRJiptmrvPf5A3XJ1EWkXUqxNGv1d,True,21432861,5358215,28810,14405,14405,72FwbpFGoLEazJEdpqNtPNefsadUrimUqma9wSoy4qiS,1152426,4717040,-3564614,537
2021-12-10 17:34:34.847872,2021-12-10 12:21:01-05:00,668,ARVhD7UsVWatKbNfjebsG5wpttsknLxpSbfQgrAedJdk,5Ysnmna1DVUhAA8syzSCzQ2snhnQvyXN9ShjeN95LJeP,False,208919221,208919221,10184699,509234,9675465,72FwbpFGoLEazJEdpqNtPNefsadUrimUqma9wSoy4qiS,10184699,101264478,-91079779,487
2021-12-10 17:34:34.847872,2021-12-10 12:21:03-05:00,669,66SjFhmiNYz8tLRnBhZUbowWGTbM16G52X3AT2hma2wN,3wVy8nk24HCFZWMiacGe8QsJquYaadZ9pQg44bGRwdE3,False,10040900,10040900,226509,11325,215184,72FwbpFGoLEazJEdpqNtPNefsadUrimUqma9wSoy4qiS,226509,5415824,-5189315,225
2021-12-10 17:34:34.847872,2021-12-10 12:21:03-05:00,670,BtUb2aiZEXz89D8KgduJDt4SeLDuQeociXcAfey3sK7r,B4ZCTjVxHvAqSb4GqVWdan6qoSLVnYdq8KbUPbYMiz6v,False,4190581896,4190581896,200390776,10019538,190371238,72FwbpFGoLEazJEdpqNtPNefsadUrimUqma9wSoy4qiS,200390776,1195089397,-994698621,478
2021-12-10 17:34:34.847872,2021-12-10 12:21:03-05:00,671,C24que1C7tC3ysDSKhcBTF9NUnjiNhSanWp8Go5FRRb8,hgm3qRRG2njhNPWcUp9UnEU8pyg4gLaR2K13r4Lsqxm,False,138633389,138633389,3210208,160510,3049698,72FwbpFGoLEazJEdpqNtPNefsadUrimUqma9wSoy4qiS,3210208,54439650,-51229442,231
2021-12-10 17:34:34.847872,2021-12-10 12:21:05-05:00,672,8jmTkoNA5LM3xnsV2E1RRUegxYb8TospBNRbupaCeLF8,36LmDVFR5fgAYxgqhAtToJmRmYqYt5sVtUBkDQ3xmXhT,False,2227437,2227437,48743,2437,46306,72FwbpFGoLEazJEdpqNtPNefsadUrimUqma9wSoy4qiS,48743,682951,-634208,218
2021-12-10 17:34:34.847872,2021-12-10 12:21:06-05:00,673,7UwBQLT7uc8DFabDUwRBgTCjm2Tprh79HoDwhPCap6v7,CdWQHx3cRLC7ApxXSbVD3D6y2V6vtqQJLMjuhFcdbp4X,False,113898557,113898557,2919674,145983,2773691,72FwbpFGoLEazJEdpqNtPNefsadUrimUqma9wSoy4qiS,2919674,61685253,-58765579,256
2021-12-10 17:34:34.847872,2021-12-10 12:21:08-05:00,674,3Ek5j2ea8wS2nCxsNgn2AbovxzJwGK7zc6xarkigSA3u,DEWmTn3Ah4F3nNXpoQLt1GG65Dsf4ZmGjn7FZUJyK6rP,False,433024839,433024839,11199561,559978,10639583,72FwbpFGoLEazJEdpqNtPNefsadUrimUqma9wSoy4qiS,11199561,218830572,-207631011,258
2021-12-10 17:34:34.847872,2021-12-10 12:21:08-05:00,675,7iUx7JBwqUvPVPeCqMEXQdLccZJmaFYm1DUQiu3ouHa3,3EVZzhRmJnX9ZiBZZo9tenDtMogAyuA1yf2cKzvUWiuu,True,73675782,18418945,105980,52990,52990,72FwbpFGoLEazJEdpqNtPNefsadUrimUqma9wSoy4qiS,4239215,15570745,-11331530,575
2021-12-10 17:34:34.847872,2021-12-10 12:21:08-05:00,676,2XFYFxNQbCr5ao4cVzRZt45fsAwZc4jD9XTABmdqaJWd,CvpzBuDjyimaYFGWFkkBcaZGSRtAvtF6MtRV54mqZ74k,False,190201,190201,4978,248,4730,72FwbpFGoLEazJEdpqNtPNefsadUrimUqma9wSoy4qiS,4978,96442,-91464,261
2021-12-10 17:34:34.847872,2021-12-10 12:21:08-05:00,677,775ANAGx3kyFQV6YHvQXmfA7gB6DFkyojsQZXVdF4vwr,AzCb6gcTAdQLC3XKYDP3VwhHivXcURRCDfZ2cb81A6Kq,False,34090094668,34090094668,1670198430,83509921,1586688509,72FwbpFGoLEazJEdpqNtPNefsadUrimUqma9wSoy4qiS,1670198430,7738053683,-6067855253,489
2021-12-10 17:34:34.847872,2021-12-10 12:21:10-05:00,678,8djD77wbxqJCCesESU7EgPJsk4tq7KGDi5EQgXon6H49,AFZo239G3pF5EMHWMJa77SZbC7KeUr5qxc34gUBBis1J,False,437513404,437513404,16017484,800874,15216610,72FwbpFGoLEazJEdpqNtPNefsadUrimUqma9wSoy4qiS,16017484,101591892,-85574408,366
2021-12-10 17:34:34.847872,2021-12-10 12:21:10-05:00,679,EFHg5FatMRRSZnKJPJF9e1iw2cjPJRmwTTZYtkHno9DP,84LnLKhZDJgWFnbBYnYjqWkjymemXfidecPFwnUAvuFj,False,1398262768,1398262768,7280688,364034,6916654,72FwbpFGoLEazJEdpqNtPNefsadUrimUqma9wSoy4qiS,7280688,560069576,-552788888,52
2021-12-10 17:34:34.847872,2021-12-10 12:21:10-05:00,680,DfAra3qDA5bmgteTWxUzuFkw9ovSwKVeUhPQkaVxwPvF,CYU9XqGkGpkPm9KzNU5Kc2xBfcmi8kAaD6FBhPfY5xcc,False,3711647397,3711647397,88672799,4433639,84239160,72FwbpFGoLEazJEdpqNtPNefsadUrimUqma9wSoy4qiS,88672799,1214167504,-1125494705,238
2021-12-10 17:34:34.847872,2021-12-10 12:21:10-05:00,681,2Qz9cDjDujf5jxvnAcnNks567iD1cEndStmjaK8e8wCe,3863f1FRuKKXZ1sJFd3eVzj4Ddhuw2qMtkxKRLX9PRYB,False,396639063,396639063,2211236,110561,2100675,72FwbpFGoLEazJEdpqNtPNefsadUrimUqma9wSoy4qiS,2211236,90523188,-88311952,55
2021-12-10 17:34:34.847872,2021-12-10 12:21:10-05:00,682,JCQKDnPvyHnk9a99k8HqR97iW6QjUvAYnkAJs8hJQ2dg,CcZaAvUVdTj6p3kYEoEknnbEspjiNz1nkLbZKL32CUQW,False,20863332066,20863332066,688331686,34416584,653915102,72FwbpFGoLEazJEdpqNtPNefsadUrimUqma9wSoy4qiS,688331686,4822474622,-4134142936,329
2021-12-10 17:34:34.847872,2021-12-10 12:21:10-05:00,683,HEFpdWLZaiQnjftmXgxs6RNzhH72YiMjortxPkKekkvb,5Q8mmxBgVTijNGrWsnoA3VMArLHZEX5MkaigYXHpgXHE,False,65885299,65885299,3206929,160346,3046583,72FwbpFGoLEazJEdpqNtPNefsadUrimUqma9wSoy4qiS,3206929,13759855,-10552926,486
2021-12-10 17:34:34.847872,2021-12-10 12:21:11-05:00,684,FSduW743jAGyyn8HTifEJitgb89Spp5gEeMXDE59aEHF,HjojGNpR3ACtLCP2mP8DKGyXj6SeqWPKjcCAofcyQpsm,False,450628875,450628875,930796,46539,884257,72FwbpFGoLEazJEdpqNtPNefsadUrimUqma9wSoy4qiS,930796,144039526,-143108730,20
2021-12-10 17:34:34.847872,2021-12-10 12:21:13-05:00,685,FP6SmbXDbcb6c8Pi8uZMn6hnQDUbvbdCfzd5pEqyBgTm,53A9dhER1x3JjdceGMQmjujvWht7uemsoB3ngQLdo6Ub,False,285007715,285007715,2798115,139905,2658210,72FwbpFGoLEazJEdpqNtPNefsadUrimUqma9wSoy4qiS,2798115,121511955,-118713840,98
2021-12-10 17:34:34.847872,2021-12-10 12:21:15-05:00,686,DVV4Vhk44E5YvVzpXgjJMepYgUB5uKXmAhEbFg6R5vWJ,8CS7rCKNx7AQ5yaEA2rHrYx4PHnC9mK3DtSQmiKW2nUb,False,58015622,58015622,520455,26022,494433,72FwbpFGoLEazJEdpqNtPNefsadUrimUqma9wSoy4qiS,520455,27085628,-26565173,89
2021-12-10 17:34:34.847872,2021-12-10 12:21:15-05:00,687,2JH43pKUeXTXPd6LnL4BWgGQpwZHhX8EqyohKCFLAS4i,Bir3EKnDWkv6XX7KmoqAi1y6rxSaC5RfVV6Hwvnkfr2i,False,9090595,9090595,53231,2661,50570,72FwbpFGoLEazJEdpqNtPNefsadUrimUqma9wSoy4qiS,53231,3642611,-3589380,58
2021-12-10 17:34:34.847872,2021-12-10 12:21:16-05:00,688,8Xdf67Q5jXKwS52e492xUBu1tMUgS14jJg7V4R2Q28EP,GAPL3bsXP4xcukhgzyqrbDntGwUSm5BfuwJ8TLKkRaZc,False,141381599,141381599,1717300,85865,1631435,72FwbpFGoLEazJEdpqNtPNefsadUrimUqma9wSoy4qiS,1717300,52029266,-50311966,121
2021-12-10 17:34:34.847872,2021-12-10 12:21:16-05:00,689,29JVska5UEG3axs63EmtHpPvkswNEqYpZ3PKMSfupiAG,DCftNBUsuogxyaJe9G9m3eWipH6o3qo4Rn4TuQXdVaBF,False,174455345,174455345,4467911,223395,4244516,72FwbpFGoLEazJEdpqNtPNefsadUrimUqma9wSoy4qiS,4467911,40012566,-35544655,256
2021-12-10 17:34:34.847872,2021-12-10 12:21:16-05:00,690,3r4x7wkHNge6PBnKFQo45KUihUpTAgjWB72vKZEseTs4,1hsPi4ReN3nTPqxETBE697KALqcqo5Dh3HnPaoLS1Sq,False,36819752,36819752,446261,22313,423948,72FwbpFGoLEazJEdpqNtPNefsadUrimUqma9wSoy4qiS,446261,8621964,-8175703,121
2021-12-10 17:34:34.847872,2021-12-10 12:21:16-05:00,691,81GV2H9ipJSZD6YpJGj2XQNfoUroWWnKfwMHGSwvhixd,7cLHoNuNVj8qkn3QmBYLFwja37f1MWEo4e3ZcNSpXTPw,False,857556826,857556826,5680641,284032,5396609,72FwbpFGoLEazJEdpqNtPNefsadUrimUqma9wSoy4qiS,5680641,292916685,-287236044,66
2021-12-10 17:34:34.847872,2021-12-10 12:21:16-05:00,692,iiAw2xrR4TyAfuUbbSKWNJzxPjfcXVBtx2GKDCbA6LM,2sFNTdu2SmmpTFUjzZnqwKrDbnAhKFN3xCLZjPzgd8Pa,False,77846862,77846862,1064068,53203,1010865,72FwbpFGoLEazJEdpqNtPNefsadUrimUqma9wSoy4qiS,1064068,18207611,-17143543,136
2021-12-10 17:34:34.847872,2021-12-10 12:21:16-05:00,693,4xsYjVsPm2C2itNtJb3NYkBp4WySHUwtSbWdu9fge8wz,8zu2jMoTndZpf9khY9PMhve88LRwrKNTuVuLpa5ss8qo,False,126931678,126931678,954611,47730,906881,72FwbpFGoLEazJEdpqNtPNefsadUrimUqma9wSoy4qiS,954611,61818372,-60863761,75
2021-12-10 17:34:34.847872,2021-12-10 12:21:16-05:00,694,AaMCg49sJwNtdB5wHACg15TYAzzJXy8xtG4zuVXhKiVE,HbDYqDa9bewGPvsiaHRM9HmEvh1scPaUaGvqog66gYir,True,63417579,15854394,82302,41151,41151,72FwbpFGoLEazJEdpqNtPNefsadUrimUqma9wSoy4qiS,3292080,12905245,-9613165,519
2021-12-10 17:34:34.847872,2021-12-10 12:21:16-05:00,695,2xu5Vz1x3SpuxdhBVr1HQDPj5pyWD1FWBMdcGyAjkJYV,57MievWg8GXop9c213H2ivXMHkm1HyMgx8DUTNXoCUpt,False,2539132810,2539132810,40850429,2042521,38807908,72FwbpFGoLEazJEdpqNtPNefsadUrimUqma9wSoy4qiS,40850429,701241107,-660390678,160
2021-12-10 17:34:34.847872,2021-12-10 12:21:16-05:00,696,5W6PdHtcFCSFHWKNBX7JGgjGKt43A5j7kmmy1TY9SicJ,FynUWXgGoMu1bnUFtGwzH6DVRhhBnKvH29jWrWYu7iYm,False,8259604,8259604,90228,4511,85717,72FwbpFGoLEazJEdpqNtPNefsadUrimUqma9wSoy4qiS,90228,3829412,-3739184,109
2021-12-10 17:34:34.847872,2021-12-10 12:21:16-05:00,697,DCxghVXCXzEar41CPGichdzvtjwmf4NW7uHtKTj57BNN,Fmh5FPdnFb1KpFkoL6eNfWFGxN78GLdaJgPcVpCoCnkh,False,116926806,116926806,1165242,58262,1106980,72FwbpFGoLEazJEdpqNtPNefsadUrimUqma9wSoy4qiS,1165242,46603710,-45438468,99
2021-12-10 17:34:34.847872,2021-12-10 12:21:16-05:00,698,4AB6iMAC1Un3azYSR5SYnaWGisGDVHmL1ts2Xh9HTB66,4BTwjwGqfw2xB9KCu87qRLrBrEmNoKcc6DfLzebUtZ8T,False,27535681,27535681,262553,13127,249426,72FwbpFGoLEazJEdpqNtPNefsadUrimUqma9wSoy4qiS,262553,10793120,-10530567,95
2021-12-10 17:34:34.847872,2021-12-10 12:21:16-05:00,699,EQYUWtYbtvN9C9ixiupXPjHyFWHsYa7dUh4DSd6rxbzt,iS616uGNCwCxP1taAvvdvA2KdqfXRSjcQWwZRUgBkLb,False,3200669,3200669,16534,826,15708,72FwbpFGoLEazJEdpqNtPNefsadUrimUqma9wSoy4qiS,16534,1652383,-1635849,51
2021-12-10 17:34:34.847872,2021-12-10 12:21:16-05:00,700,CBEv8v9XZrgFT8UdEdd813XnRVv9R7GB5PLMyG8UWGC8,4uNcMEcQpJdThpisgNrttkQJTUFTsjEr25qgjkm4titC,False,94059597,94059597,0,0,0,GmqQKnMfFxkv6ChqGaZ2wmSFDow7R1x7WeRfU58GVvfw,0,53261408,-53458552,0
2021-12-10 17:34:34.847872,2021-12-10 12:21:16-05:00,701,A9BZ5kjh7iKu7SMzA5WUF31Zst9V7fehwDZaoKs4NpSi,3FzwTaT5LYucvoGGcRVXu5AUDnGHADv6yGqrBT6jEtvH,False,133671777,133671777,406143,20307,385836,72FwbpFGoLEazJEdpqNtPNefsadUrimUqma9wSoy4qiS,406143,54530164,-54124021,30
2021-12-10 17:34:34.847872,2021-12-10 12:21:16-05:00,702,57GUgfEp9ZQ5iAU2nx1Z2Tiz3gqq7yBNaqfE1cvxjFYt,98upivFa9Tdy3RZHGM1i2k5zeczaGqioq3rTzc3DMf4x,False,35448571,35448571,160071,8003,152068,72FwbpFGoLEazJEdpqNtPNefsadUrimUqma9wSoy4qiS,160071,17877936,-17717865,45
2021-12-10 17:34:34.847872,2021-12-10 12:21:16-05:00,703,BcFk9XUrzJRvxe3LPE5go95n7ALfu2yM8SXDm7BYHvzZ,3T6sS2uz9dd8VR8AB88VYtke88PEsoJ711EDHCCR9Ahk,False,298188692,298188692,7955346,397767,7557579,72FwbpFGoLEazJEdpqNtPNefsadUrimUqma9wSoy4qiS,7955346,65491207,-57535861,266
2021-12-10 17:34:34.847872,2021-12-10 12:21:16-05:00,704,2bovNUkndmEk62WDwvaWJMbSP63pUvQUattkbq54YLqh,FBvEdMGmwT7b3JCKKXVJoaHxdx1k8cWDeWqaZaik4Vec,False,41045591,41045591,1299633,64981,1234652,72FwbpFGoLEazJEdpqNtPNefsadUrimUqma9wSoy4qiS,1299633,20253042,-18953409,316
2021-12-10 17:34:34.847872,2021-12-10 12:21:16-05:00,705,4DFa7jRrs71bUCbkpD19kWJG8RU6z58ymgG47NhuP6gC,7jvKYqZ5QU44VqsgRJiptmrvPf5A3XJ1EWkXUqxNGv1d,True,15783904,3945976,20821,10410,10411,72FwbpFGoLEazJEdpqNtPNefsadUrimUqma9wSoy4qiS,832874,3797158,-2964284,527
2021-12-10 17:34:34.847872,2021-12-10 12:21:16-05:00,706,8fVwuVA2CL5sZoHh6Dg4MBpcX3cvoUm7mnitnpQSdPBD,4F4ccaNm1KQu29XvsKvdjFkmpsbWqNvXkV41851EYQyu,False,22742513,22742513,220436,11021,209415,GmqQKnMfFxkv6ChqGaZ2wmSFDow7R1x7WeRfU58GVvfw,220436,9494758,-9274322,96
2021-12-10 17:34:34.847872,2021-12-10 12:21:17-05:00,707,Frobc1KZTVcsyfwyKwSpHJobxmiJBomzHhGCLdrzdAz8,HziyKP9uxWCuXddtbRzWMczHNdgyQB5UXQZj4MnMm14,False,66041330,66041330,3162732,158136,3004596,72FwbpFGoLEazJEdpqNtPNefsadUrimUqma9wSoy4qiS,3162732,13746027,-10583295,478
2021-12-10 17:34:34.847872,2021-12-10 12:21:17-05:00,708,5gN3624v6n1zQ1BKtZi1e9ZLpbCa4MEfhgHySFB81Qfm,UXT3oB5ud18rBsygsfxwA93kQYdSNbbzTCjt4gtU2jP,True,74468301,18617074,103513,51756,51757,72FwbpFGoLEazJEdpqNtPNefsadUrimUqma9wSoy4qiS,4140555,15171342,-11030787,556
2021-12-10 17:34:34.847872,2021-12-10 12:21:17-05:00,709,pkvFVn6bFvjCYCgWV4BPksGzqpyikFANqMn3xPXHMPk,EY5wUnUeoLRQD6WJ3Ay1EgzPZmsidtcd9wVQj2Fh4sz9,False,17049340,17049340,825093,41254,783839,72FwbpFGoLEazJEdpqNtPNefsadUrimUqma9wSoy4qiS,825093,3827912,-3002819,483
2021-12-10 17:34:34.847872,2021-12-10 12:21:18-05:00,710,6meAnGTy2XNUDk9qSJZGT6BBRinA5iGiDYEy2T88LXuX,BCzNQCn3J1381yNH5xp5ky9QmVKVdSofSUaLHtxKxPBW,False,250794,250794,542,27,515,72FwbpFGoLEazJEdpqNtPNefsadUrimUqma9wSoy4qiS,542,125227,-124685,21
2021-12-10 17:34:34.847872,2021-12-10 12:21:18-05:00,711,FZhvN1RjLoBK9EpCeyEobYsvdHirtbTXV82c9EV9nn2u,FSeHqYNof79JYrRb7ZkJWEb4TfS5wx7HTdvT1kLCexHM,False,13647707,13647707,56428,2821,53607,72FwbpFGoLEazJEdpqNtPNefsadUrimUqma9wSoy4qiS,56428,5951084,-5894656,41
2021-12-10 17:34:34.847872,2021-12-10 12:21:18-05:00,712,7D4rFmGMPKNAF75VRPxHAhSn2wTjiW8jmth1UD22Xqq9,GQ7BrT6vsXu8tHCMm75YdxFR2r9QTCrCUbdPEZBSAg9w,False,574481537,574481537,23091738,1154586,21937152,72FwbpFGoLEazJEdpqNtPNefsadUrimUqma9wSoy4qiS,23091738,176187625,-153095887,401
2021-12-10 17:34:34.847872,2021-12-10 12:21:18-05:00,713,J5WcVsKNHbfioai1LRowvjvtEmUJBEkeoBim1ThshpoP,Ajh7SWBq3zJR4vb6AFoBS6C9D99wC6YF1sVN22qC1vCA,False,135850787,135850787,1917540,95877,1821663,72FwbpFGoLEazJEdpqNtPNefsadUrimUqma9wSoy4qiS,1917540,38798991,-36881451,141
2021-12-10 17:34:34.847872,2021-12-10 12:21:18-05:00,714,7BY59PkXpdNQBwBAUte9icDDzB9H7pUWpG92DDtb5bQp,7Vp4w3nAdypxFAbZsq9CyLi83GM4z1rXPkrwUvPkP6XE,False,215008940,215008940,10505788,525289,9980499,72FwbpFGoLEazJEdpqNtPNefsadUrimUqma9wSoy4qiS,10505788,52199578,-41693790,488
2021-12-10 17:34:34.847872,2021-12-10 12:21:18-05:00,715,E5KDZriZ89a5D4VsMaWxndMMG68RT4weruJ1tCEc6tSx,CaSwkUocpbyyGCQBgKjJZJgcexbyqs2GTrGJH6EMWXAz,False,1176764379,1176764379,34818423,1740921,33077502,72FwbpFGoLEazJEdpqNtPNefsadUrimUqma9wSoy4qiS,34818423,516420878,-481602455,295
2021-12-10 17:34:34.847872,2021-12-10 12:21:21-05:00,716,3DEyi4Dnfxc7d91JbTpQjdAP1Ypgx5kaTSm4wwh8Zbm2,Cb2aqg5MyjopPzx5zd4zU81RUwJDeNTGV1jfiCLmgNTL,False,3545512,3545512,168264,8413,159851,72FwbpFGoLEazJEdpqNtPNefsadUrimUqma9wSoy4qiS,168264,1519213,-1350949,474
2021-12-10 17:34:34.847872,2021-12-10 12:21:21-05:00,717,7DQvMas21zgbHgaiGPUYF5WyLWouqCqxmrxuT1J3cqFo,GfjHJF6z9KxCGJ2pXncYSzjkSMSyTTmzLuBB2JEpytT4,False,451342422,451342422,21138269,1056913,20081356,72FwbpFGoLEazJEdpqNtPNefsadUrimUqma9wSoy4qiS,21138269,130323472,-109185203,468
2021-12-10 17:34:34.847872,2021-12-10 12:21:21-05:00,718,7aKxZg1aoLuB51JUw7fruF77ts7SWoB7pcLBZKHZMynr,AAnbLY82UGULqaDNdyJHrYu7X3hGaBuiTkGWmh8qKTc,False,3512708482,3512708482,20725185,1036259,19688926,72FwbpFGoLEazJEdpqNtPNefsadUrimUqma9wSoy4qiS,20725185,1072759174,-1052033989,59
2021-12-10 17:34:34.847872,2021-12-10 12:21:21-05:00,719,9RSTBp82LizcenitXWpsccH53G2YFS2Yh42N9ofogpUX,9WUxAg5BaJtUFthTod8dSUDprUjLygsUFUGg5N7Uy2JG,False,50681992,50681992,2168160,108408,2059752,72FwbpFGoLEazJEdpqNtPNefsadUrimUqma9wSoy4qiS,2168160,11480108,-9311948,427
2021-12-10 17:34:34.847872,2021-12-10 12:21:23-05:00,720,8d333AWdyiVhvkAdiKCTwhgzaPBMbn8mtucwUC1SAbZZ,3BM8UNLN7XGRaYRjezAqFVMr1z4PS3VRXiN1NAtvBuD9,False,29652226,29652226,237040,11852,225188,GmqQKnMfFxkv6ChqGaZ2wmSFDow7R1x7WeRfU58GVvfw,237040,14513729,-14276689,79
2021-12-10 17:34:34.847872,2021-12-10 12:21:23-05:00,721,8G2hAWXgJZRNMv32dcGkCrsMpqs1aTmGo2rsDm2VZ5Fn,4PMxnUH1oQQdtchAZ2sKDYkg8iiFCFxCS7yE9iP5bQyi,True,41738785,10434696,54798,27399,27399,72FwbpFGoLEazJEdpqNtPNefsadUrimUqma9wSoy4qiS,2191941,18431381,-16239440,525
2021-12-10 17:34:34.847872,2021-12-10 12:21:23-05:00,722,Dng7By2saPu5TVxcvXidBe71ggBo8tiHkAXPi4kKL1tk,75ufEJmHbLHffphL7tvAXhGyftKLr1z2PXXoB2GGY5fG,True,60521962,15130489,90220,45110,45110,72FwbpFGoLEazJEdpqNtPNefsadUrimUqma9wSoy4qiS,3608809,12439869,-8831060,596
2021-12-10 17:34:34.847872,2021-12-10 12:21:23-05:00,723,AHm7zF4rpaxaayBLn5QDHgJSp8KAr647s4cNvQ9wLgd7,FDM33WngED24pukBvSDpPAzinW6afVAeGReum5nyLRiC,True,39509943,9877485,54932,27466,27466,72FwbpFGoLEazJEdpqNtPNefsadUrimUqma9wSoy4qiS,2197318,9682628,-7485310,556
2021-12-10 17:34:34.847872,2021-12-10 12:21:23-05:00,724,4j19AEcDwhtAZrnoDc4epNPmEL1jPpVUMeg7RmQ72Qkb,84WB42AAGbczVE9txZPwXrx4FD5jP87r8QdDzEABTm5G,False,36301465166,36301465166,1581895699,79094784,1502800915,72FwbpFGoLEazJEdpqNtPNefsadUrimUqma9wSoy4qiS,1581895699,11770463589,-10188567890,435
2021-12-10 17:34:34.847872,2021-12-10 12:21:23-05:00,725,3ufE8ZossNvypfLHuvbYMGyrAwKk7CUShTFqfpkjsCFB,DKF6tQstSHpxM9QTUCt6yU1iFZrRiXodRSZd9pSYBJN9,False,338066172,338066172,12383283,619164,11764119,72FwbpFGoLEazJEdpqNtPNefsadUrimUqma9wSoy4qiS,12383283,82678342,-70295059,366
2021-12-10 17:34:34.847872,2021-12-10 12:21:23-05:00,726,29rwdfrBkccfAXJdN6rhW5JNpCzDhg4oWF9ntWtMpQvo,HCjTVhGTSSqJFwQY68vSXYF7dQ1QCtz4EZca4HqmkYuo,True,342488996,85622249,438964,219482,219482,72FwbpFGoLEazJEdpqNtPNefsadUrimUqma9wSoy4qiS,17558597,145387417,-127828820,512
2021-12-10 17:34:34.847872,2021-12-10 12:21:23-05:00,727,93ho4cgnpAJiJsG6uu2udkLVNU7rkz4QjCYfsqvpbPA5,45ouQn9gGwXqnTGfaP5CvU8fCKadBRA5kPwtfvJzykRU,False,538835979,538835979,18948988,947449,18001539,72FwbpFGoLEazJEdpqNtPNefsadUrimUqma9wSoy4qiS,18948988,153207692,-134258704,351
2021-12-10 17:34:34.847872,2021-12-10 12:21:23-05:00,728,7v9ZoB7qxQsHBENVV5DXWJCUn33Y2cwvkVbvgUgBn3g4,BbVVWmu5jFbq5Efijex19vwpyP7dXmZGjLijf8BLtoq4,False,586183716,586183716,24293707,1214685,23079022,72FwbpFGoLEazJEdpqNtPNefsadUrimUqma9wSoy4qiS,24293707,188109991,-163816284,414
2021-12-10 17:34:34.847872,2021-12-10 12:21:23-05:00,729,4KMzwWHPeW51cxu4nMpbqCaqo96dMqaHWyRCGQktfQfd,F7q4GNYcbnZa8dJ4qovQwjmxpKpdEmdxQMXRPb9nQupa,True,64021646,16005411,80253,40126,40127,72FwbpFGoLEazJEdpqNtPNefsadUrimUqma9wSoy4qiS,3210129,13486344,-10276215,501
2021-12-10 17:34:34.847872,2021-12-10 12:21:23-05:00,730,AoPQqPjLPi8fZiLkhMGLRj6oD5k2asrvJtCkpW19DvGr,H5Sgmf1VuY13iHjPuLJ2q9wtSdkXG1AQsEv2eq6zzm8Y,True,62821671,15705417,82764,41382,41382,72FwbpFGoLEazJEdpqNtPNefsadUrimUqma9wSoy4qiS,3310570,12873624,-9563054,526
2021-12-10 17:34:34.847872,2021-12-10 12:21:28-05:00,731,BQBQicboM5o25LihnffqxcJmoPoA3mgBKNeG4H8UTHVh,E8rJFAs7dbDmQA1o5aTeNqdmADxWMd5cDzvwAGMFFCix,True,71850256,17962564,90776,45388,45388,72FwbpFGoLEazJEdpqNtPNefsadUrimUqma9wSoy4qiS,3631071,35377865,-31746794,505
2021-12-10 17:34:34.847872,2021-12-10 12:21:29-05:00,732,8G2hAWXgJZRNMv32dcGkCrsMpqs1aTmGo2rsDm2VZ5Fn,4PMxnUH1oQQdtchAZ2sKDYkg8iiFCFxCS7yE9iP5bQyi,True,30974278,7743569,45183,22591,22592,72FwbpFGoLEazJEdpqNtPNefsadUrimUqma9wSoy4qiS,1807332,14316827,-12509495,583
2021-12-10 17:34:34.847872,2021-12-10 12:21:29-05:00,733,Cv5oVktxmqbU1SxraxH67NEWMKnjgA18R832Fhe9h74a,Cs7xBD4BDiohyopnaYDDChUtR9vmx7uwot6Qp9beQLzt,True,56563082,14140770,82709,41354,41355,72FwbpFGoLEazJEdpqNtPNefsadUrimUqma9wSoy4qiS,3308377,11732841,-8424464,584
2021-12-10 17:34:34.847872,2021-12-10 12:21:30-05:00,734,4DFa7jRrs71bUCbkpD19kWJG8RU6z58ymgG47NhuP6gC,7jvKYqZ5QU44VqsgRJiptmrvPf5A3XJ1EWkXUqxNGv1d,True,11699839,2924959,16849,8424,8425,72FwbpFGoLEazJEdpqNtPNefsadUrimUqma9wSoy4qiS,673964,3035282,-2361318,576
2021-12-10 17:34:34.847872,2021-12-10 12:21:31-05:00,735,BrHRMouGRz3LBNzd9anfdYMhWfg8yUPHL4PqJ8WdEDFS,4uzoLa3mC2VYHAPBoHLX4gTjPTC28rPf2fvEGtJWPYc,True,2890602445,722650611,3679666,1839833,1839833,72FwbpFGoLEazJEdpqNtPNefsadUrimUqma9wSoy4qiS,147186655,1441166068,-1293979413,509
2021-12-10 17:34:34.847872,2021-12-10 12:21:31-05:00,736,8eTH6eJyyVeMno3UQkffeBg32xofKsQfkhLhXdtaf87s,BCFC7CPXrQPsUfJb2eYSht8GhaApWHpc49AeCXqaYq13,True,64597558,16149389,90814,45407,45407,72FwbpFGoLEazJEdpqNtPNefsadUrimUqma9wSoy4qiS,3632597,13115744,-9483147,562
2021-12-10 17:34:34.847872,2021-12-10 12:21:32-05:00,737,4oAmAWPdfD7Wc8zHUVeuQnJpp2WD5xH7K5yL5We4qX6k,D48tXw9B8jaF32MrWwCszztc4juCSDgFwCgCDy6PU3iB,False,1618784505,1618784505,53619620,2680981,50938639,72FwbpFGoLEazJEdpqNtPNefsadUrimUqma9wSoy4qiS,53619620,374639175,-321019555,331
2021-12-10 17:34:34.847872,2021-12-10 12:21:36-05:00,738,HqtTbC1LFreGvgfpZe7nCqkNnh8GHPQKosfmc19zb1yi,E39UNiHNkwQEd5GXkCtTPqSorQSB1kLx8kjzK4jdFoi3,True,11906421327,2976605331,16180872,8090436,8090436,72FwbpFGoLEazJEdpqNtPNefsadUrimUqma9wSoy4qiS,647234880,2850010871,-2202775991,543
2021-12-10 17:34:34.847872,2021-12-10 12:21:37-05:00,739,7jvKp6onXyWgwsFrFWj4hYTXJsYYD6ot5mn6rPFuJriy,J7N6HiozevJVTiY9hDEUs2ud5BwT5QSE7wnMBS1w5ie2,True,2078908196,519727048,3013695,1506847,1506848,72FwbpFGoLEazJEdpqNtPNefsadUrimUqma9wSoy4qiS,120547829,573024550,-452476721,579
2021-12-10 17:34:34.847872,2021-12-10 12:21:37-05:00,740,BpvWyveup3q7q6Cws5TWkFYiZ8bQXRrfdxvzrN9FnYo6,2CWjropYSn9fJ66FT4zqUcwTrEaPp3CjGgoRATixyca1,True,41808034,10452008,59435,29717,29718,72FwbpFGoLEazJEdpqNtPNefsadUrimUqma9wSoy4qiS,2377406,12588661,-10211255,568
2021-12-10 17:34:34.847872,2021-12-10 12:21:37-05:00,741,AHm7zF4rpaxaayBLn5QDHgJSp8KAr647s4cNvQ9wLgd7,FDM33WngED24pukBvSDpPAzinW6afVAeGReum5nyLRiC,True,29297792,7324448,45193,22596,22597,72FwbpFGoLEazJEdpqNtPNefsadUrimUqma9wSoy4qiS,1807720,7756456,-5948736,617
2021-12-10 17:34:34.847872,2021-12-10 12:21:37-05:00,742,6QZamUpLHzSzJhj1XtzPP5dHQRvTUmaqRmntxcLfWwE3,D9F6yp639JKp473cZTsB5puUr1URdi18ZxZTFXE1p8py,True,59855873,14963968,88581,44290,44291,72FwbpFGoLEazJEdpqNtPNefsadUrimUqma9wSoy4qiS,3543249,15431304,-11888055,591
2021-12-10 17:34:34.847872,2021-12-10 12:21:39-05:00,743,4FazDUgfQ3AKoFcnWHr8E9Ht8jLA3tkxf75yrGZVHdmF,HzRMH6mbgEKydRCnnMvSsKgTEVNQi6nuzoR1xutYFdzg,True,2170120,542530,3155,1577,1578,72FwbpFGoLEazJEdpqNtPNefsadUrimUqma9wSoy4qiS,126233,953322,-827089,581
2021-12-10 17:34:34.847872,2021-12-10 12:21:39-05:00,744,2XnLbeSYLmYWRhErrHMyaXTFtLGMZu6S5fDzp3KkFGC5,8zatCNqr7MQuJXeL7aUFSDGrrEEwa6fgviFu6M1WErHX,True,168105942,42026485,245451,122725,122726,72FwbpFGoLEazJEdpqNtPNefsadUrimUqma9wSoy4qiS,9818063,38496384,-28678321,584
2021-12-10 17:34:34.847872,2021-12-10 12:21:39-05:00,745,72L76qDRMK3M7X52zuuB9GVyvFFLDBZwFMpVjWjghXzA,4m2ZVuemUctu1edv4YJVAcjXzKwpbCmBujzoUmLDeA7h,True,66000297,16500074,96786,48393,48393,72FwbpFGoLEazJEdpqNtPNefsadUrimUqma9wSoy4qiS,3871457,13467364,-9595907,586
2021-12-10 17:34:34.847872,2021-12-10 12:22:00-05:00,746,AaMCg49sJwNtdB5wHACg15TYAzzJXy8xtG4zuVXhKiVE,HbDYqDa9bewGPvsiaHRM9HmEvh1scPaUaGvqog66gYir,True,47240338,11810084,72173,36086,36087,72FwbpFGoLEazJEdpqNtPNefsadUrimUqma9wSoy4qiS,2886931,10430233,-7543302,611
2021-12-10 17:34:34.847872,2021-12-10 12:22:05-05:00,747,GKNBtZbwK4w9hyXD1r38NTGcTJhpjt8R9WFCzdXup9Tk,7RLaL2XoFuqrcCcPEB6FzPJzLnAhjQpwcRmDfdpRXFgB,True,1582846707,395711676,2413735,1206867,1206868,4BnQKPLuE3DMTtxp8MjUBytgnhvxqq3ZTqZHTVZo4JJh,96549403,412236162,-315686759,609
2021-12-10 17:34:34.847872,2021-12-10 12:30:48-05:00,748,36ByQojnxEckWdQTjqHfxKqCx9yjqWQsPsZyqaN72UWR,AZoirtS1fjX61agRM64tqThVinnJTh3BWgiHyNHPTgZP,True,99872427,24968106,142189,71094,71095,4BnQKPLuE3DMTtxp8MjUBytgnhvxqq3ZTqZHTVZo4JJh,5687591,21717217,-16029626,569
2021-12-10 17:34:34.847872,2021-12-10 12:30:56-05:00,749,GbPWktFegZQEz5CDL2kphHexVrQgy3hTmXa8mCEZtdps,BVQzSYxgF1v6ftSLe5mftqgvretxPcNCrtN8RrHKDn5x,False,488531520,488531520,22555501,1127775,21427726,72FwbpFGoLEazJEdpqNtPNefsadUrimUqma9wSoy4qiS,22555501,123007847,-100452346,461
2021-12-10 17:34:34.847872,2021-12-10 12:31:10-05:00,750,6wYw2tQWSj6YzrPL8s5ZVp4pKnX4tUdovt8wzUCyoWfs,DCuvqHhUwZiZ2XZGyxPREjEA5WQZNwuV9eAcFMEeS3a5,True,1658841120,414710280,2288371,1144185,1144186,72FwbpFGoLEazJEdpqNtPNefsadUrimUqma9wSoy4qiS,91534840,367810498,-276275658,551
2021-12-10 22:20:46.475831,2021-12-10 17:04:52-05:00,751,9WoXgsHByBW41nJtgCBoLS1ZP2GredkysgyZeNRWx13u,26Hb8DNrxtVBHcThu71DJ3pTbhXRcGApnTrgk6iAVTau,True,113292322,28323080,171344,85672,85672,4BnQKPLuE3DMTtxp8MjUBytgnhvxqq3ZTqZHTVZo4JJh,6853761,31367328,-24513567,604
2021-12-10 22:34:47.790287,2021-12-10 17:22:44-05:00,752,6TWJ8huRvaHdb1Rr9TvV5oNA163kaV8o8dpXoZBrCotK,FB8yfdGootXBhsPpUB6i2cqjweFD2rjtUXg5KHM2zDPs,True,563307345,140826836,881394,440697,440697,4BnQKPLuE3DMTtxp8MjUBytgnhvxqq3ZTqZHTVZo4JJh,35255781,151914486,-116658705,625
2021-12-10 22:34:47.790287,2021-12-10 17:27:23-05:00,753,9WoXgsHByBW41nJtgCBoLS1ZP2GredkysgyZeNRWx13u,26Hb8DNrxtVBHcThu71DJ3pTbhXRcGApnTrgk6iAVTau,True,83456229,20864057,129235,64617,64618,4BnQKPLuE3DMTtxp8MjUBytgnhvxqq3ZTqZHTVZo4JJh,5169404,25069329,-19899925,619
2021-12-10 22:34:47.790287,2021-12-10 17:33:38-05:00,754,6TWJ8huRvaHdb1Rr9TvV5oNA163kaV8o8dpXoZBrCotK,FB8yfdGootXBhsPpUB6i2cqjweFD2rjtUXg5KHM2zDPs,True,413678427,103419606,639307,319653,319654,GmqQKnMfFxkv6ChqGaZ2wmSFDow7R1x7WeRfU58GVvfw,25572305,121906993,-96334688,618
2021-12-11 00:34:05.503536,2021-12-10 19:12:04-05:00,755,CRW3nidAs2C3irLsEMsnffCvcjZH3wMBoKXG8PRp1Ss8,GD2un4iqMrnZ1kKnGLbzaSQy5iKjGSHHDN58tKibtHN3,True,511822209,127955551,795982,397991,397991,GmqQKnMfFxkv6ChqGaZ2wmSFDow7R1x7WeRfU58GVvfw,31839318,113827390,-81988072,622
2021-12-11 00:34:05.503536,2021-12-10 19:12:21-05:00,756,J7i9qHaXQbWVGEVDGTgM9kYcBWYo4Gc8zbPkU2V9SXzp,ET2wi1T7WYUwekTMEncvbqP24Xw9WfULRyb8DV2M3wZc,True,41122758,10280689,64173,32086,32087,GmqQKnMfFxkv6ChqGaZ2wmSFDow7R1x7WeRfU58GVvfw,2566957,9444095,-6877138,624
2021-12-11 00:34:05.503536,2021-12-10 19:12:29-05:00,757,2pmVGLVRhBdJdQicVjRZbRNGcdPxqd99bvBXnw4ckhCS,7ab23P9dAKiBSuXx7xJG7QzEvSfGVcTEBMrSjiH8YEhf,True,46984163,11746040,72474,36237,36237,GmqQKnMfFxkv6ChqGaZ2wmSFDow7R1x7WeRfU58GVvfw,2898978,10798407,-7899429,617
2021-12-11 00:34:05.503536,2021-12-10 19:14:03-05:00,758,9WoXgsHByBW41nJtgCBoLS1ZP2GredkysgyZeNRWx13u,26Hb8DNrxtVBHcThu71DJ3pTbhXRcGApnTrgk6iAVTau,True,61376046,15344011,95444,47722,47722,GmqQKnMfFxkv6ChqGaZ2wmSFDow7R1x7WeRfU58GVvfw,3817790,19959738,-16141948,622
2021-12-11 00:34:05.503536,2021-12-10 19:18:25-05:00,759,DGbj8tnqECzM9FG8j225Ap7A4Fdm3J1Ksm32JBFG7igv,Cd3D2UVwoSZLygM2e3UQppQANsokpmx5CNBs1C5zueay,True,59187015,14796753,91902,45951,45951,GmqQKnMfFxkv6ChqGaZ2wmSFDow7R1x7WeRfU58GVvfw,3676085,11874587,-8198502,621
2021-12-11 00:34:05.503536,2021-12-10 19:20:51-05:00,760,gMjmD7WioyUdQdwNqE5fobLcxPwoJv5rAvLmJaf8Jjw,5n77euFjVJiwKrnbYq1KpcENW1mzBZj2BuDGyzazrkJ8,True,58668161,14667040,91115,45557,45558,72FwbpFGoLEazJEdpqNtPNefsadUrimUqma9wSoy4qiS,3644625,12226317,-8581692,621
2021-12-11 19:22:44.253443,2021-12-11 14:20:31-05:00,761,5qY8ZrqpHPqkAuXp6HpE2zC8qTfzsP8MXWSoxkZQV5jx,GPs3ap45TuHwHwmDb5bnKYHLBa5wj3AyuEsXcfHjEcAL,True,593062130,148265532,926483,463241,463242,GmqQKnMfFxkv6ChqGaZ2wmSFDow7R1x7WeRfU58GVvfw,37059358,131597049,-94537691,624
2021-12-11 19:29:26.151469,2021-12-11 14:23:57-05:00,762,D3o7CSh2zCAQ93BDomDCitZ4vuxC83wGPMwJEEyBJK4C,A4nDfpUZkdtuWRRWZkoNXc5Ux7JU1UJA2JTHgkHAfYyP,True,258332876701,64583219175,403426152,201713076,201713076,GmqQKnMfFxkv6ChqGaZ2wmSFDow7R1x7WeRfU58GVvfw,16137046116,111474043020,-95336996904,624
2021-12-11 19:29:26.151469,2021-12-11 14:23:57-05:00,763,6TWJ8huRvaHdb1Rr9TvV5oNA163kaV8o8dpXoZBrCotK,FB8yfdGootXBhsPpUB6i2cqjweFD2rjtUXg5KHM2zDPs,False,283473497,283473497,0,0,0,GmqQKnMfFxkv6ChqGaZ2wmSFDow7R1x7WeRfU58GVvfw,0,96660279,-99057817,0
2021-12-11 19:29:26.151469,2021-12-11 14:24:00-05:00,764,9WoXgsHByBW41nJtgCBoLS1ZP2GredkysgyZeNRWx13u,26Hb8DNrxtVBHcThu71DJ3pTbhXRcGApnTrgk6iAVTau,False,42673410,42673410,286321,14316,272005,GmqQKnMfFxkv6ChqGaZ2wmSFDow7R1x7WeRfU58GVvfw,286321,15751909,-15465588,67
2021-12-11 19:29:26.151469,2021-12-11 14:24:01-05:00,765,9JJoEQ8yMhbU8RjCUSb4rGyFzf5fcFwmRrhgwuP1gzoJ,2PgvGtcExTfvNFaXEpTtSAFETxA458m3L2SEU4wr7zjs,False,2889980257,2889980257,92417775,4620888,87796887,GmqQKnMfFxkv6ChqGaZ2wmSFDow7R1x7WeRfU58GVvfw,92417775,687162633,-594744858,319
2021-12-11 19:29:26.151469,2021-12-11 14:24:01-05:00,766,J7i9qHaXQbWVGEVDGTgM9kYcBWYo4Gc8zbPkU2V9SXzp,ET2wi1T7WYUwekTMEncvbqP24Xw9WfULRyb8DV2M3wZc,False,29152174,29152174,761245,38062,723183,GmqQKnMfFxkv6ChqGaZ2wmSFDow7R1x7WeRfU58GVvfw,761245,7609203,-6847958,261
2021-12-11 19:29:26.151469,2021-12-11 14:24:01-05:00,767,5qY8ZrqpHPqkAuXp6HpE2zC8qTfzsP8MXWSoxkZQV5jx,GPs3ap45TuHwHwmDb5bnKYHLBa5wj3AyuEsXcfHjEcAL,False,422522267,422522267,13858544,692927,13165617,GmqQKnMfFxkv6ChqGaZ2wmSFDow7R1x7WeRfU58GVvfw,13858544,107077980,-93219436,327
2021-12-11 19:29:26.151469,2021-12-11 14:24:01-05:00,768,HfF7RiVgyJfoVyr12C96KpK9oT7Aux5jHK4LvrEUNRf8,FCRk8WBGtu2p6dboan8fuVsKaECWyNxLkgWxuVmyv4r2,False,118299,118299,3971,198,3773,GmqQKnMfFxkv6ChqGaZ2wmSFDow7R1x7WeRfU58GVvfw,3971,38795,-34824,335
2021-12-11 19:29:26.151469,2021-12-11 14:24:01-05:00,769,2bjiHeP82LQ56fEsqR7xEZ9xyyE8LLeeNc7LBvSQm54r,6wdVmvunXFaPuCAXiDdYNmoumYkXz8M5C5vRnBZ9HSXT,False,122929353,122929353,4927097,246354,4680743,GmqQKnMfFxkv6ChqGaZ2wmSFDow7R1x7WeRfU58GVvfw,4927097,24084726,-19157629,400
2021-12-11 19:29:26.151469,2021-12-11 14:24:01-05:00,770,2pmVGLVRhBdJdQicVjRZbRNGcdPxqd99bvBXnw4ckhCS,7ab23P9dAKiBSuXx7xJG7QzEvSfGVcTEBMrSjiH8YEhf,False,33334906,33334906,864203,43210,820993,72FwbpFGoLEazJEdpqNtPNefsadUrimUqma9wSoy4qiS,864203,8692260,-7828057,259
2021-12-11 19:29:26.151469,2021-12-11 14:24:01-05:00,771,CRW3nidAs2C3irLsEMsnffCvcjZH3wMBoKXG8PRp1Ss8,GD2un4iqMrnZ1kKnGLbzaSQy5iKjGSHHDN58tKibtHN3,False,363214361,363214361,9751309,487565,9263744,GmqQKnMfFxkv6ChqGaZ2wmSFDow7R1x7WeRfU58GVvfw,9751309,91923788,-82172479,268
2021-12-11 19:29:26.151469,2021-12-11 14:24:01-05:00,772,v5cMbxv4J1QzgCUb3BRQsYX7yWz6C8AWZcvQ3JTXAK1,9vXUPbwsc7VZJoxhtUi6GCAqxz1iLeseW9NikwjrQzwj,False,14199009529,14199009529,543078695,27153934,515924761,72FwbpFGoLEazJEdpqNtPNefsadUrimUqma9wSoy4qiS,543078695,4893332894,-4350254199,382
2021-12-13 14:48:20.432293,2021-12-13 09:45:30-05:00,773,EAUFD16wab8qRMJ4H6updHGt4xFqgRCDeRHVCsLCTSTL,8vkfYSyCyBY9g4TZrp52jUcQj6udy9xAaA4fioRE2RXx,True,895029758,223757439,1394094,697047,697047,GmqQKnMfFxkv6ChqGaZ2wmSFDow7R1x7WeRfU58GVvfw,55763793,253483683,-197719890,623
2021-12-13 15:22:00.752654,2021-12-13 10:03:46-05:00,774,HGAFdundf5voDqeh9g7d6Q9mgMf8eEg898QMRBqwPZ6C,deanBuZXWBHEe2TGfP37S9aMBEnEgmZoyRJjAvruzfA,True,205852279,51463069,322045,161022,161023,GmqQKnMfFxkv6ChqGaZ2wmSFDow7R1x7WeRfU58GVvfw,12881802,93882814,-81001012,625
2021-12-13 15:22:00.752654,2021-12-13 10:08:02-05:00,775,C1CsbgQFvEvSXzuVHTr39tQHr3drDhjxeYiotd8eNocF,4rAaTCAMj5VpgNVKiYizabH7cMLhEA12seu2QXQNTyV3,True,116114192,29028547,181592,90796,90796,GmqQKnMfFxkv6ChqGaZ2wmSFDow7R1x7WeRfU58GVvfw,7263701,25764216,-18500515,625
2021-12-13 15:22:00.752654,2021-12-13 10:15:19-05:00,776,2ce2v2TCbjNH635NgbwTG3sqiRWYrRRaBpxPxBZJ929q,9cnoebT43FkWDFhidndGCVNiFD4NErv8DuL1Va4Jv9S8,True,215591709,53897927,335125,167562,167563,GmqQKnMfFxkv6ChqGaZ2wmSFDow7R1x7WeRfU58GVvfw,13405031,100812322,-87407291,621
2021-12-13 15:38:47.515248,2021-12-13 10:26:55-05:00,777,7iUx7JBwqUvPVPeCqMEXQdLccZJmaFYm1DUQiu3ouHa3,3EVZzhRmJnX9ZiBZZo9tenDtMogAyuA1yf2cKzvUWiuu,True,55006975,13751743,85601,42800,42801,GmqQKnMfFxkv6ChqGaZ2wmSFDow7R1x7WeRfU58GVvfw,3424074,12182798,-8758724,622
2021-12-13 15:38:47.515248,2021-12-13 10:27:59-05:00,778,4KMzwWHPeW51cxu4nMpbqCaqo96dMqaHWyRCGQktfQfd,F7q4GNYcbnZa8dJ4qovQwjmxpKpdEmdxQMXRPb9nQupa,True,48289135,12072283,74795,37397,37398,GmqQKnMfFxkv6ChqGaZ2wmSFDow7R1x7WeRfU58GVvfw,2991800,10430001,-7438201,619
2021-12-13 15:38:47.515248,2021-12-13 10:29:15-05:00,779,GGGyesjbt7h2XHHp9u8vpiWGugFwEbrtYaKrNQSDhQd7,8tydo1ZjGHmPBSqU33tywB3f9szdsHk1ckGFe4Ay5pgs,True,1800468204,450117051,2804217,1402108,1402109,GmqQKnMfFxkv6ChqGaZ2wmSFDow7R1x7WeRfU58GVvfw,112168682,830181196,-718012514,622
2021-12-13 15:38:47.515248,2021-12-13 10:35:28-05:00,780,Gbxc51WERLLeCtiHv7rDvE52aqF541RoQWG5n5aqErq6,4ngBoHbfXijLMqGKxFMNht9sbmxy2g5eqBmn8QsBmbx1,True,48410561,12102639,74765,37382,37383,GmqQKnMfFxkv6ChqGaZ2wmSFDow7R1x7WeRfU58GVvfw,2990639,10557738,-7567099,617
2021-12-13 15:38:47.515248,2021-12-13 10:37:07-05:00,781,EAUFD16wab8qRMJ4H6updHGt4xFqgRCDeRHVCsLCTSTL,8vkfYSyCyBY9g4TZrp52jUcQj6udy9xAaA4fioRE2RXx,True,658206958,164551739,1029825,514912,514913,GmqQKnMfFxkv6ChqGaZ2wmSFDow7R1x7WeRfU58GVvfw,41193004,202563723,-161370719,625
2021-12-13 15:38:47.515248,2021-12-13 10:37:36-05:00,782,BhiAaiZu7fF8ndggJrLyiFVCRq526cNBw7VaeascEmNL,4en8MipPi7vq15NGhpPMQfptNdEyhp2j7fpgxBBtjyfz,True,56355274,14088818,86442,43221,43221,GmqQKnMfFxkv6ChqGaZ2wmSFDow7R1x7WeRfU58GVvfw,3457701,10775162,-7317461,613
2021-12-13 15:51:20.108785,2021-12-13 10:45:57-05:00,783,HGAFdundf5voDqeh9g7d6Q9mgMf8eEg898QMRBqwPZ6C,deanBuZXWBHEe2TGfP37S9aMBEnEgmZoyRJjAvruzfA,True,151229528,37807381,235001,117500,117501,GmqQKnMfFxkv6ChqGaZ2wmSFDow7R1x7WeRfU58GVvfw,9400075,73311488,-63911413,621
2021-12-13 15:51:20.108785,2021-12-13 10:49:32-05:00,784,36ByQojnxEckWdQTjqHfxKqCx9yjqWQsPsZyqaN72UWR,AZoirtS1fjX61agRM64tqThVinnJTh3BWgiHyNHPTgZP,True,74215297,18553824,113785,56892,56893,GmqQKnMfFxkv6ChqGaZ2wmSFDow7R1x7WeRfU58GVvfw,4551405,17264094,-12712689,613
2021-12-13 15:51:20.108785,2021-12-13 10:50:41-05:00,785,AoPQqPjLPi8fZiLkhMGLRj6oD5k2asrvJtCkpW19DvGr,H5Sgmf1VuY13iHjPuLJ2q9wtSdkXG1AQsEv2eq6zzm8Y,True,47213167,11803291,72752,36376,36376,GmqQKnMfFxkv6ChqGaZ2wmSFDow7R1x7WeRfU58GVvfw,2910083,9991174,-7081091,616
2021-12-13 15:56:02.692268,2021-12-13 10:53:00-05:00,786,5gN3624v6n1zQ1BKtZi1e9ZLpbCa4MEfhgHySFB81Qfm,UXT3oB5ud18rBsygsfxwA93kQYdSNbbzTCjt4gtU2jP,True,55741738,13935434,86051,43025,43026,GmqQKnMfFxkv6ChqGaZ2wmSFDow7R1x7WeRfU58GVvfw,3442069,11830596,-8388527,617
2021-12-13 15:56:02.692268,2021-12-13 10:55:38-05:00,787,D58t4uTjFumsUeYFaKnpV8BRTEQEqKXBreFTdwGrott7,67p6kHDfVqQijfcwugvZK59c3aRRH9x3eHxruqH8WEqF,True,48200446,12050110,74038,37019,37019,4BnQKPLuE3DMTtxp8MjUBytgnhvxqq3ZTqZHTVZo4JJh,2961521,10505939,-7544418,614
2021-12-13 15:56:02.692268,2021-12-13 10:55:52-05:00,788,Fn6J1eMQJoA5rXCwX2HjAF86AowsJfULLuYXVfzgb8aX,6Ett2WPmz4HoWVSVEZD73UzFetd3oFSh7C676MEVYd36,True,2774820764,693705191,4290956,2145478,2145478,GmqQKnMfFxkv6ChqGaZ2wmSFDow7R1x7WeRfU58GVvfw,171638262,998724239,-827085977,618
2021-12-13 16:14:08.373822,2021-12-13 10:57:06-05:00,789,34235h7L3VPHqcUkLycAsaJAXyq4vtgoG27yei34CKaj,Bg6WtWMQXGBakzrizVhBrE1X2hafMHBtktn3YYjeyscf,True,552928824,138232206,823950,411975,411975,GmqQKnMfFxkv6ChqGaZ2wmSFDow7R1x7WeRfU58GVvfw,32958019,196518959,-163560940,596
2021-12-13 16:14:08.373822,2021-12-13 10:57:20-05:00,790,29rwdfrBkccfAXJdN6rhW5JNpCzDhg4oWF9ntWtMpQvo,HCjTVhGTSSqJFwQY68vSXYF7dQ1QCtz4EZca4HqmkYuo,True,257346403,64336600,401818,200909,200909,GmqQKnMfFxkv6ChqGaZ2wmSFDow7R1x7WeRfU58GVvfw,16072747,111469189,-95396442,624
2021-12-13 16:14:08.373822,2021-12-13 10:57:20-05:00,791,6kt64nJRnYaWMi9GbpZaUuhbToAVRd7FUMTGASAAJrve,2Sdxv9ZtogNcVbJwBPxKmVjwAiKyX5GHEfnRmFcydQ1G,True,223891085,55972771,346013,173006,173007,GmqQKnMfFxkv6ChqGaZ2wmSFDow7R1x7WeRfU58GVvfw,13840531,95918540,-82078009,618
2021-12-13 16:14:08.373822,2021-12-13 10:57:20-05:00,792,Ggjn39zkoAcCcmDmmzqYw8RFsMqjQGtAX8myhB3p4WQ4,FWnftuAeU86mR8RMR9qQwLfkujqcfzEiupBPkvWre3RS,True,234990843,58747710,366009,183004,183005,GmqQKnMfFxkv6ChqGaZ2wmSFDow7R1x7WeRfU58GVvfw,14640372,100617108,-85976736,623
2021-12-13 16:14:08.373822,2021-12-13 10:57:27-05:00,793,GqAS41YJssg9aaEp3hs3sG98APCsXhiQBQszXaSjZ2bN,2wodJ3AhrXdE1T4oVL95KvoBND7PubG5Wd5GWiLCMZJU,True,6772236509,1693059127,10324046,5162023,5162023,GmqQKnMfFxkv6ChqGaZ2wmSFDow7R1x7WeRfU58GVvfw,412961867,3462746366,-3049784499,609
2021-12-13 16:14:08.373822,2021-12-13 10:57:29-05:00,794,6VBYUiLyQXvvsDmq1vh1oJ5VeA89tGgxtkgFfofc372m,35pyoeRA4duKX7njdYny3KffM2xaxuWUZGRUMQJ5iAiu,True,221592527,55398131,340026,170013,170013,GmqQKnMfFxkv6ChqGaZ2wmSFDow7R1x7WeRfU58GVvfw,13601045,94977915,-81376870,613
2021-12-13 16:14:08.373822,2021-12-13 10:57:31-05:00,795,DjbEch16uzdDtujFUeqxjquTTS3JXzEys8e9ogUv3aTy,6N8eKb3kfcbJEUZKZERiFiUR4hubB635D8Sotiji2TU8,True,230429052,57607263,354965,177482,177483,GmqQKnMfFxkv6ChqGaZ2wmSFDow7R1x7WeRfU58GVvfw,14198618,98737751,-84539133,616
2021-12-13 16:14:08.373822,2021-12-13 10:57:31-05:00,796,4nEJqarcHzgizZsc11SYg3PP5E91nsjqzzNxUCSYA5sb,zayUU1osJ9byFsmsi9CZqvQAhtEenpmXv2UwN6YDt6B,True,239098771,59774692,365841,182920,182921,GmqQKnMfFxkv6ChqGaZ2wmSFDow7R1x7WeRfU58GVvfw,14633678,102501880,-87868202,612
2021-12-13 16:14:08.373822,2021-12-13 10:57:31-05:00,797,C1CsbgQFvEvSXzuVHTr39tQHr3drDhjxeYiotd8eNocF,4rAaTCAMj5VpgNVKiYizabH7cMLhEA12seu2QXQNTyV3,True,85110143,21277535,127665,63832,63833,GmqQKnMfFxkv6ChqGaZ2wmSFDow7R1x7WeRfU58GVvfw,5106607,20957879,-15851272,599
2021-12-13 16:14:08.373822,2021-12-13 10:57:31-05:00,798,BQBQicboM5o25LihnffqxcJmoPoA3mgBKNeG4H8UTHVh,E8rJFAs7dbDmQA1o5aTeNqdmADxWMd5cDzvwAGMFFCix,True,53954016,13488504,82159,41079,41080,GmqQKnMfFxkv6ChqGaZ2wmSFDow7R1x7WeRfU58GVvfw,3286395,27030435,-23744040,609
2021-12-13 16:14:08.373822,2021-12-13 10:57:31-05:00,799,9bhB755nk1VKCFQ15knBRdXESNqN6T1o3Lp3u214mARe,FvZuSbYfVMwGg8UUurGDFe7VVtoUBghrPNFYTr2gKCFc,True,237030887,59257721,365543,182771,182772,4BnQKPLuE3DMTtxp8MjUBytgnhvxqq3ZTqZHTVZo4JJh,14621737,101558126,-86936389,616
2021-12-13 16:14:08.373822,2021-12-13 10:57:32-05:00,800,Ad4hjpPdExRAqUATSvqZYLBVNBcmtB2Pqh6MWwc1XGj,6TnqcHDyBnSZMds1eUc28aKuBThwGjAPsnaFKeC2fGnK,True,232688307,58172076,359913,179956,179957,72FwbpFGoLEazJEdpqNtPNefsadUrimUqma9wSoy4qiS,14396535,99676110,-85279575,618
2021-12-13 16:14:08.373822,2021-12-13 10:57:32-05:00,801,73PpLzJmAimmqtjGpRcYHua8t6wx3gYiiXFvQxnSDMJV,CRCpLcS8LNKX22co94spJBXEes9Fnh5rYBvbVEte4JXA,True,225937212,56484303,345692,172846,172846,GmqQKnMfFxkv6ChqGaZ2wmSFDow7R1x7WeRfU58GVvfw,13827693,96859272,-83031579,612
2021-12-13 16:14:08.373822,2021-12-13 10:57:32-05:00,802,DTWFNeptqa59hRfBzQUVtVjto8fmRW7TvXcH8Tz8PXkT,67JFe2J2ZVJJWkGcYBeJUhXsScYAH2zTJbzfmFL1kGDb,True,241248304,60312076,368114,184057,184057,GmqQKnMfFxkv6ChqGaZ2wmSFDow7R1x7WeRfU58GVvfw,14724593,103442959,-88718366,610
2021-12-13 16:14:08.373822,2021-12-13 10:57:32-05:00,803,Fw2e6jxKVeFcJSe9MyVhSz3dUdJQLs3XULHrT1mtMU9U,591U5bexgLRJXygtK5fpCRXcZEq89KgewFTdfPkti8bY,True,228201614,57050403,350768,175384,175384,GmqQKnMfFxkv6ChqGaZ2wmSFDow7R1x7WeRfU58GVvfw,14030755,97797629,-83766874,614
2021-12-13 16:14:08.373822,2021-12-13 10:57:32-05:00,804,BrHRMouGRz3LBNzd9anfdYMhWfg8yUPHL4PqJ8WdEDFS,4uzoLa3mC2VYHAPBoHLX4gTjPTC28rPf2fvEGtJWPYc,True,2170653372,542663343,3333011,1666505,1666506,72FwbpFGoLEazJEdpqNtPNefsadUrimUqma9wSoy4qiS,133320474,1101434125,-968113651,614
2021-12-13 16:14:08.373822,2021-12-13 10:58:06-05:00,805,8eTH6eJyyVeMno3UQkffeBg32xofKsQfkhLhXdtaf87s,BCFC7CPXrQPsUfJb2eYSht8GhaApWHpc49AeCXqaYq13,True,48301718,12075429,74184,37092,37092,72FwbpFGoLEazJEdpqNtPNefsadUrimUqma9wSoy4qiS,2967363,10235104,-7267741,614
2021-12-13 16:14:08.373822,2021-12-13 10:58:34-05:00,806,J1sBDjpdBZcsSBS5eg95SSRjRqmQUR9cXJCsLJu8yCUt,F5wRpD2senMkGbL8Uquqo8W9x5NQDDa268dHuVFAZCww,True,168898379,42224594,263543,131771,131772,72FwbpFGoLEazJEdpqNtPNefsadUrimUqma9wSoy4qiS,10541721,43963700,-33421979,624
2021-12-13 16:14:08.373822,2021-12-13 11:11:54-05:00,807,7mYQ2DJZ1YYMpNbpA93hCDtzQDhEHjAGxLJt2g4KeYTW,8nTKeruC3wiPjT7VytdM2gX7msjwbHxTkyhsR88GJgpc,True,54839751,13709937,83858,41929,41929,72FwbpFGoLEazJEdpqNtPNefsadUrimUqma9wSoy4qiS,3354334,12153880,-8799546,611
2021-12-13 16:14:08.373822,2021-12-13 11:11:54-05:00,808,BpvWyveup3q7q6Cws5TWkFYiZ8bQXRrfdxvzrN9FnYo6,2CWjropYSn9fJ66FT4zqUcwTrEaPp3CjGgoRATixyca1,True,31129854,7782463,47393,23696,23697,GmqQKnMfFxkv6ChqGaZ2wmSFDow7R1x7WeRfU58GVvfw,1895728,9780449,-7884721,608
2021-12-13 16:14:08.373822,2021-12-13 11:11:54-05:00,809,HqtTbC1LFreGvgfpZe7nCqkNnh8GHPQKosfmc19zb1yi,E39UNiHNkwQEd5GXkCtTPqSorQSB1kLx8kjzK4jdFoi3,True,8866528601,2216632150,12796268,6398134,6398134,GmqQKnMfFxkv6ChqGaZ2wmSFDow7R1x7WeRfU58GVvfw,511850727,2231812732,-1719962005,577
2021-12-13 16:14:08.373822,2021-12-13 11:11:54-05:00,810,Dng7By2saPu5TVxcvXidBe71ggBo8tiHkAXPi4kKL1tk,75ufEJmHbLHffphL7tvAXhGyftKLr1z2PXXoB2GGY5fG,True,45038150,11259537,68780,34390,34390,GmqQKnMfFxkv6ChqGaZ2wmSFDow7R1x7WeRfU58GVvfw,2751208,9730015,-6978807,610
2021-12-13 16:14:08.373822,2021-12-13 11:11:54-05:00,811,H6UTHgiUSkFbavHHZAfGB8R74SHcGDpQLeP1acduznG6,Gz56dyUAKnQ2WAHuCi8CWd5wsikowFvNAi4bzxPUpuyT,True,2146025923,536506480,3074178,1537089,1537089,GmqQKnMfFxkv6ChqGaZ2wmSFDow7R1x7WeRfU58GVvfw,122967122,476688699,-353721577,572
2021-12-13 16:14:08.373822,2021-12-13 11:11:54-05:00,812,4MmpDGUTyMcYEqJ1RoZ46AN2BhrBUseHaHqF8AmiTPyD,7HW2YZpYM349HMfW7u4h9ESZ1AXkwN8JcVDTNFzp9aTz,True,3427871896,856967974,4925115,2462557,2462558,GmqQKnMfFxkv6ChqGaZ2wmSFDow7R1x7WeRfU58GVvfw,197004622,988706506,-791701884,574
2021-12-13 16:14:08.373822,2021-12-13 11:11:54-05:00,813,F7ZpqKKvip659597Jpy6dB91CXS1Cqvxu734GV8mrWFk,BeCPgg2XqH44ed2BYYDadJNZzYTFKBHWhC2oFgQGZTCc,True,2149300755,537325188,3163708,1581854,1581854,GmqQKnMfFxkv6ChqGaZ2wmSFDow7R1x7WeRfU58GVvfw,126548349,476995094,-350446745,588
2021-12-13 16:14:08.373822,2021-12-13 11:12:01-05:00,814,9YEzjb49Awvedv9yNc6LG54SkGBug2RYiJwiUV13mGsS,3H8w5WCD187NWWoZMNUCzUDdxTgqrRJLga8gDzUVXBgZ,True,31316547,7829136,45191,22595,22596,GmqQKnMfFxkv6ChqGaZ2wmSFDow7R1x7WeRfU58GVvfw,1807660,11151762,-9344102,577
2021-12-13 16:14:08.373822,2021-12-13 11:12:11-05:00,815,2ce2v2TCbjNH635NgbwTG3sqiRWYrRRaBpxPxBZJ929q,9cnoebT43FkWDFhidndGCVNiFD4NErv8DuL1Va4Jv9S8,True,158424857,39606214,243801,121900,121901,GmqQKnMfFxkv6ChqGaZ2wmSFDow7R1x7WeRfU58GVvfw,9752073,78578240,-68826167,615
2021-12-13 16:14:08.373822,2021-12-13 11:12:11-05:00,816,8G2hAWXgJZRNMv32dcGkCrsMpqs1aTmGo2rsDm2VZ5Fn,4PMxnUH1oQQdtchAZ2sKDYkg8iiFCFxCS7yE9iP5bQyi,True,23019510,5754877,35144,17572,17572,GmqQKnMfFxkv6ChqGaZ2wmSFDow7R1x7WeRfU58GVvfw,1405798,10999230,-9593432,610
2021-12-13 16:14:08.373822,2021-12-13 11:12:12-05:00,817,2XnLbeSYLmYWRhErrHMyaXTFtLGMZu6S5fDzp3KkFGC5,8zatCNqr7MQuJXeL7aUFSDGrrEEwa6fgviFu6M1WErHX,True,125008141,31252035,192825,96412,96413,GmqQKnMfFxkv6ChqGaZ2wmSFDow7R1x7WeRfU58GVvfw,7713026,30294055,-22581029,617
2021-12-13 16:14:08.373822,2021-12-13 11:12:18-05:00,818,7jvKp6onXyWgwsFrFWj4hYTXJsYYD6ot5mn6rPFuJriy,J7N6HiozevJVTiY9hDEUs2ud5BwT5QSE7wnMBS1w5ie2,True,1549577006,387394251,2388968,1194484,1194484,GmqQKnMfFxkv6ChqGaZ2wmSFDow7R1x7WeRfU58GVvfw,95558748,444595155,-349036407,616
2021-12-13 16:14:08.373822,2021-12-13 11:12:20-05:00,819,4FazDUgfQ3AKoFcnWHr8E9Ht8jLA3tkxf75yrGZVHdmF,HzRMH6mbgEKydRCnnMvSsKgTEVNQi6nuzoR1xutYFdzg,True,1614021,403505,2483,1241,1242,GmqQKnMfFxkv6ChqGaZ2wmSFDow7R1x7WeRfU58GVvfw,99334,733230,-633896,615
2021-12-13 16:14:08.373822,2021-12-13 11:12:50-05:00,820,GGGyesjbt7h2XHHp9u8vpiWGugFwEbrtYaKrNQSDhQd7,8tydo1ZjGHmPBSqU33tywB3f9szdsHk1ckGFe4Ay5pgs,True,1321407853,330351963,2000282,1000141,1000141,GmqQKnMfFxkv6ChqGaZ2wmSFDow7R1x7WeRfU58GVvfw,80011284,647583802,-567572518,605
2021-12-13 16:14:08.373822,2021-12-13 11:12:50-05:00,821,Hkn5Ghsa35dqjtkXHRvnx3wkSoo9hfuRGkdbhqhCzyy5,67C58WFj5x7evA4xTh3pj7FQL49xyxtCzcZVGRMwQyMi,True,1495447001,373861750,2222504,1111252,1111252,GmqQKnMfFxkv6ChqGaZ2wmSFDow7R1x7WeRfU58GVvfw,88900183,440707364,-351807181,594
2021-12-13 16:14:08.373822,2021-12-13 11:12:50-05:00,822,gHv15388BYFZ6PS2p7XTvT9QViJ1rjevHdykD6Pmvzh,9YZPTB6d7St4TPpMY2vP4rZ56B2ZvzViB1DLWbPLK1hn,True,285075050,71268761,422864,211432,211432,GmqQKnMfFxkv6ChqGaZ2wmSFDow7R1x7WeRfU58GVvfw,16914571,83733355,-66818784,593
2021-12-13 16:14:08.373822,2021-12-13 11:12:50-05:00,823,Cv5oVktxmqbU1SxraxH67NEWMKnjgA18R832Fhe9h74a,Cs7xBD4BDiohyopnaYDDChUtR9vmx7uwot6Qp9beQLzt,True,42185146,10546286,64902,32451,32451,4BnQKPLuE3DMTtxp8MjUBytgnhvxqq3ZTqZHTVZo4JJh,2596088,9166399,-6570311,615
2021-12-13 16:14:08.373822,2021-12-13 11:12:55-05:00,824,72L76qDRMK3M7X52zuuB9GVyvFFLDBZwFMpVjWjghXzA,4m2ZVuemUctu1edv4YJVAcjXzKwpbCmBujzoUmLDeA7h,True,49224163,12306040,76096,38048,38048,GmqQKnMfFxkv6ChqGaZ2wmSFDow7R1x7WeRfU58GVvfw,3043864,10519449,-7475585,618
2021-12-13 16:14:08.373822,2021-12-13 11:12:59-05:00,825,AHm7zF4rpaxaayBLn5QDHgJSp8KAr647s4cNvQ9wLgd7,FDM33WngED24pukBvSDpPAzinW6afVAeGReum5nyLRiC,True,21687165,5421791,33473,16736,16737,GmqQKnMfFxkv6ChqGaZ2wmSFDow7R1x7WeRfU58GVvfw,1338948,6086720,-4747772,617
2021-12-13 16:14:08.373822,2021-12-13 11:13:02-05:00,826,6QZamUpLHzSzJhj1XtzPP5dHQRvTUmaqRmntxcLfWwE3,D9F6yp639JKp473cZTsB5puUr1URdi18ZxZTFXE1p8py,True,44307322,11076830,64734,32367,32367,GmqQKnMfFxkv6ChqGaZ2wmSFDow7R1x7WeRfU58GVvfw,2589371,12090151,-9500780,584
2021-12-13 16:45:39.255892,2021-12-13 11:22:30-05:00,827,5Rxuqgs4CaSKbfDXqBMFXkLTQ9dxrUjThXzoy3ouYVtK,BgvbKru66ebrGUcFFymGTmsaQv6GgcGMybiWaXqzBtwX,True,19236960,4809240,29747,14873,14874,GmqQKnMfFxkv6ChqGaZ2wmSFDow7R1x7WeRfU58GVvfw,1189880,5154932,-3965052,618
2021-12-13 16:45:39.255892,2021-12-13 11:22:32-05:00,828,3VdSA9CED9f5swRwHX2U15U7J6Muaq8VPnCNy9CaGDHe,2YYstfnfdYic5NWmEbcUEHpccNUVd1EhuCkExvMsoMk8,True,622136160,155534040,942777,471388,471389,GmqQKnMfFxkv6ChqGaZ2wmSFDow7R1x7WeRfU58GVvfw,37711109,152455947,-114744838,606
2021-12-13 16:45:39.255892,2021-12-13 11:34:45-05:00,829,BgoKAyBNaJ1geeQ2FcGSHEQDWATVD3w3wmcNHtj8Awu3,8Haz7duE2ycueaJsGdrGNnK79KGHwnzKBpoafC8RZGg2,True,1313894088,328473522,2039719,1019859,1019860,GmqQKnMfFxkv6ChqGaZ2wmSFDow7R1x7WeRfU58GVvfw,81588773,349881389,-268292616,620
2021-12-13 16:45:39.255892,2021-12-13 11:36:57-05:00,830,3qyKG4juvhcDnhoSVAFibqJtk5i4q8vLVgvwzXtdk5KP,2ofR6Hdm8qgQfKnaNFouzzBs311xgPcxny4ViS7g2Wxo,True,36951850,9237962,57310,28655,28655,GmqQKnMfFxkv6ChqGaZ2wmSFDow7R1x7WeRfU58GVvfw,2292422,9667331,-7374909,620
2021-12-13 16:45:39.255892,2021-12-13 11:40:03-05:00,831,BCGo6RhFcVnLCzZxtEh5YDyfq59nEWXPyJ5STC9PkzA1,24ShUfs1AB1n5NUus99sZ58kuSvMPhVgpiiT56rcLHRk,True,209886508,52471627,326943,163471,163472,GmqQKnMfFxkv6ChqGaZ2wmSFDow7R1x7WeRfU58GVvfw,13077738,47935371,-34857633,623
2021-12-13 19:15:21.562342,2021-12-13 14:10:46-05:00,832,36ByQojnxEckWdQTjqHfxKqCx9yjqWQsPsZyqaN72UWR,AZoirtS1fjX61agRM64tqThVinnJTh3BWgiHyNHPTgZP,True,54695063,13673765,85490,42745,42745,GmqQKnMfFxkv6ChqGaZ2wmSFDow7R1x7WeRfU58GVvfw,3419612,13921606,-10501994,625
2021-12-13 19:24:28.475422,2021-12-13 14:17:16-05:00,833,DTWFNeptqa59hRfBzQUVtVjto8fmRW7TvXcH8Tz8PXkT,67JFe2J2ZVJJWkGcYBeJUhXsScYAH2zTJbzfmFL1kGDb,True,177743746,44435936,275658,137829,137829,GmqQKnMfFxkv6ChqGaZ2wmSFDow7R1x7WeRfU58GVvfw,11026326,80759750,-69733424,620
2021-12-13 19:24:28.475422,2021-12-13 14:17:16-05:00,834,BQBQicboM5o25LihnffqxcJmoPoA3mgBKNeG4H8UTHVh,E8rJFAs7dbDmQA1o5aTeNqdmADxWMd5cDzvwAGMFFCix,True,39748338,9937084,61406,30703,30703,GmqQKnMfFxkv6ChqGaZ2wmSFDow7R1x7WeRfU58GVvfw,2456276,20981622,-18525346,617
2021-12-13 19:24:28.475422,2021-12-13 14:17:16-05:00,835,73PpLzJmAimmqtjGpRcYHua8t6wx3gYiiXFvQxnSDMJV,CRCpLcS8LNKX22co94spJBXEes9Fnh5rYBvbVEte4JXA,True,166457530,41614382,258942,129471,129471,GmqQKnMfFxkv6ChqGaZ2wmSFDow7R1x7WeRfU58GVvfw,10357691,75628647,-65270956,622
2021-12-13 19:24:28.475422,2021-12-13 14:17:16-05:00,836,4nEJqarcHzgizZsc11SYg3PP5E91nsjqzzNxUCSYA5sb,zayUU1osJ9byFsmsi9CZqvQAhtEenpmXv2UwN6YDt6B,True,176142826,44035706,273753,136876,136877,GmqQKnMfFxkv6ChqGaZ2wmSFDow7R1x7WeRfU58GVvfw,10950149,80034677,-69084528,621
2021-12-13 19:24:28.475422,2021-12-13 14:17:17-05:00,837,6VBYUiLyQXvvsDmq1vh1oJ5VeA89tGgxtkgFfofc372m,35pyoeRA4duKX7njdYny3KffM2xaxuWUZGRUMQJ5iAiu,True,163238378,40809594,254464,127232,127232,GmqQKnMfFxkv6ChqGaZ2wmSFDow7R1x7WeRfU58GVvfw,10178560,74169015,-63990455,623
2021-12-13 19:24:28.475422,2021-12-13 14:17:18-05:00,838,GqAS41YJssg9aaEp3hs3sG98APCsXhiQBQszXaSjZ2bN,2wodJ3AhrXdE1T4oVL95KvoBND7PubG5Wd5GWiLCMZJU,True,4988735061,1247183765,7708215,3854107,3854108,GmqQKnMfFxkv6ChqGaZ2wmSFDow7R1x7WeRfU58GVvfw,308328620,2687872505,-2379543885,618
2021-12-13 19:24:28.475422,2021-12-13 14:17:27-05:00,839,Fw2e6jxKVeFcJSe9MyVhSz3dUdJQLs3XULHrT1mtMU9U,591U5bexgLRJXygtK5fpCRXcZEq89KgewFTdfPkti8bY,True,168065468,42016367,261600,130800,130800,4BnQKPLuE3DMTtxp8MjUBytgnhvxqq3ZTqZHTVZo4JJh,10464016,76376838,-65912822,622
2021-12-13 19:24:28.475422,2021-12-13 14:17:31-05:00,840,DjbEch16uzdDtujFUeqxjquTTS3JXzEys8e9ogUv3aTy,6N8eKb3kfcbJEUZKZERiFiUR4hubB635D8Sotiji2TU8,True,169686274,42421568,264416,132208,132208,GmqQKnMfFxkv6ChqGaZ2wmSFDow7R1x7WeRfU58GVvfw,10576653,77118461,-66541808,623
2021-12-13 19:24:28.475422,2021-12-13 14:17:31-05:00,841,6kt64nJRnYaWMi9GbpZaUuhbToAVRd7FUMTGASAAJrve,2Sdxv9ZtogNcVbJwBPxKmVjwAiKyX5GHEfnRmFcydQ1G,True,164782916,41195729,255785,127892,127893,GmqQKnMfFxkv6ChqGaZ2wmSFDow7R1x7WeRfU58GVvfw,10231433,74927176,-64695743,620
2021-12-13 19:24:28.475422,2021-12-13 14:17:31-05:00,842,B4Uc39nKzz9wBRQsCkMR4A7RwTJ8rSuwpR6EQn2AesRb,H49bGZgatRZVpj6QufZRVgYrQtH7LpdbiqKBs23151m,True,680122595,170030648,1061374,530687,530687,GmqQKnMfFxkv6ChqGaZ2wmSFDow7R1x7WeRfU58GVvfw,42454976,412331381,-369876405,624
2021-12-13 19:24:28.475422,2021-12-13 14:17:32-05:00,843,9bhB755nk1VKCFQ15knBRdXESNqN6T1o3Lp3u214mARe,FvZuSbYfVMwGg8UUurGDFe7VVtoUBghrPNFYTr2gKCFc,True,174541906,43635476,272241,136120,136121,GmqQKnMfFxkv6ChqGaZ2wmSFDow7R1x7WeRfU58GVvfw,10889676,79325279,-68435603,623
2021-12-13 19:24:28.475422,2021-12-13 14:17:37-05:00,844,BrHRMouGRz3LBNzd9anfdYMhWfg8yUPHL4PqJ8WdEDFS,4uzoLa3mC2VYHAPBoHLX4gTjPTC28rPf2fvEGtJWPYc,True,1598732885,399683221,2487278,1243639,1243639,GmqQKnMfFxkv6ChqGaZ2wmSFDow7R1x7WeRfU58GVvfw,99491144,855014211,-755523067,622
2021-12-13 19:24:28.475422,2021-12-13 14:17:58-05:00,845,Ggjn39zkoAcCcmDmmzqYw8RFsMqjQGtAX8myhB3p4WQ4,FWnftuAeU86mR8RMR9qQwLfkujqcfzEiupBPkvWre3RS,True,172922738,43230684,270498,135249,135249,GmqQKnMfFxkv6ChqGaZ2wmSFDow7R1x7WeRfU58GVvfw,10819948,78624905,-67804957,625
2021-12-13 19:24:28.475422,2021-12-13 14:17:59-05:00,846,Ad4hjpPdExRAqUATSvqZYLBVNBcmtB2Pqh6MWwc1XGj,6TnqcHDyBnSZMds1eUc28aKuBThwGjAPsnaFKeC2fGnK,True,171323222,42830805,267770,133885,133885,GmqQKnMfFxkv6ChqGaZ2wmSFDow7R1x7WeRfU58GVvfw,10710831,77865541,-67154710,625
2021-12-13 19:24:28.475422,2021-12-13 14:18:16-05:00,847,4M7XECgNotuYef6fXsB659bgvA4LBYq9WrUFZP8jEZ8q,EjF9ZKUaBWZodjKy7ET7rEyK1uSsKX2cvcd4eJSYarF8,True,219174653,54793663,343000,171500,171500,72FwbpFGoLEazJEdpqNtPNefsadUrimUqma9wSoy4qiS,13720000,49008554,-35288554,625
2021-12-13 19:24:28.475422,2021-12-13 14:18:53-05:00,848,29rwdfrBkccfAXJdN6rhW5JNpCzDhg4oWF9ntWtMpQvo,HCjTVhGTSSqJFwQY68vSXYF7dQ1QCtz4EZca4HqmkYuo,True,189252214,47313053,294164,147082,147082,4BnQKPLuE3DMTtxp8MjUBytgnhvxqq3ZTqZHTVZo4JJh,11766575,87073970,-75307395,621
2021-12-13 19:24:28.475422,2021-12-13 14:19:07-05:00,849,EXP61AETWHw3kHSjrJH1jQBt6cXR9Zebz34Cueb3KAzg,2JT9GrgdUKjuQQtXvZqevbjFquUQBMYDoADmBjDKWXj3,True,1680136338,420034084,2624923,1312461,1312462,GmqQKnMfFxkv6ChqGaZ2wmSFDow7R1x7WeRfU58GVvfw,104996936,772000910,-667003974,624
2021-12-13 19:24:28.475422,2021-12-13 14:22:55-05:00,850,Dn916KSmX3HqxT53hrxrbCrV3tdRMCPdaoiRLqetMrth,ATCXRiXgnjRRUbSTPBvtBXMENCqsViexSZbZ6aDaXXWA,True,61554767,15388691,94989,47494,47495,GmqQKnMfFxkv6ChqGaZ2wmSFDow7R1x7WeRfU58GVvfw,3799594,13228703,-9429109,617
2021-12-13 19:24:28.475422,2021-12-13 14:23:53-05:00,851,HGAFdundf5voDqeh9g7d6Q9mgMf8eEg898QMRBqwPZ6C,deanBuZXWBHEe2TGfP37S9aMBEnEgmZoyRJjAvruzfA,True,111303704,27825925,174098,87049,87049,GmqQKnMfFxkv6ChqGaZ2wmSFDow7R1x7WeRfU58GVvfw,6963955,57016501,-50052546,625
2021-12-13 19:31:06.825012,2021-12-13 14:24:36-05:00,852,H6UTHgiUSkFbavHHZAfGB8R74SHcGDpQLeP1acduznG6,Gz56dyUAKnQ2WAHuCi8CWd5wsikowFvNAi4bzxPUpuyT,True,1589586142,397396535,2480482,1240241,1240241,GmqQKnMfFxkv6ChqGaZ2wmSFDow7R1x7WeRfU58GVvfw,99219317,384586759,-285367442,624
2021-12-13 19:31:06.825012,2021-12-13 14:24:39-05:00,853,4MmpDGUTyMcYEqJ1RoZ46AN2BhrBUseHaHqF8AmiTPyD,7HW2YZpYM349HMfW7u4h9ESZ1AXkwN8JcVDTNFzp9aTz,True,2538094072,634523518,3952177,1976088,1976089,GmqQKnMfFxkv6ChqGaZ2wmSFDow7R1x7WeRfU58GVvfw,158087098,785058697,-626971599,622
2021-12-13 19:31:06.825012,2021-12-13 14:24:43-05:00,854,3njiRuSRMXRzKmamyiR72Hc38PU8UDDmWdfPhgxmGxEW,5WoF3gkgygyNNbwxWgVfqGWkExcDixuzgJQQjXEZQ6J5,True,9760066937,2440016734,15139937,7569968,7569969,GmqQKnMfFxkv6ChqGaZ2wmSFDow7R1x7WeRfU58GVvfw,605597516,4773374435,-4167776919,620
2021-12-13 19:31:06.825012,2021-12-13 14:24:44-05:00,855,HqtTbC1LFreGvgfpZe7nCqkNnh8GHPQKosfmc19zb1yi,E39UNiHNkwQEd5GXkCtTPqSorQSB1kLx8kjzK4jdFoi3,True,6557868124,1639467031,10099141,5049570,5049571,GmqQKnMfFxkv6ChqGaZ2wmSFDow7R1x7WeRfU58GVvfw,403965674,1788465935,-1384500261,616
2021-12-13 19:31:06.825012,2021-12-13 14:24:55-05:00,856,9YEzjb49Awvedv9yNc6LG54SkGBug2RYiJwiUV13mGsS,3H8w5WCD187NWWoZMNUCzUDdxTgqrRJLga8gDzUVXBgZ,True,23162453,5790613,35667,17833,17834,GmqQKnMfFxkv6ChqGaZ2wmSFDow7R1x7WeRfU58GVvfw,1426707,8759824,-7333117,615
2021-12-13 19:31:06.825012,2021-12-13 14:25:58-05:00,857,7iUx7JBwqUvPVPeCqMEXQdLccZJmaFYm1DUQiu3ouHa3,3EVZzhRmJnX9ZiBZZo9tenDtMogAyuA1yf2cKzvUWiuu,True,40452846,10113211,62378,31189,31189,72FwbpFGoLEazJEdpqNtPNefsadUrimUqma9wSoy4qiS,2495129,9868985,-7373856,616
2021-12-13 19:31:06.825012,2021-12-13 14:25:58-05:00,858,F7ZpqKKvip659597Jpy6dB91CXS1Cqvxu734GV8mrWFk,BeCPgg2XqH44ed2BYYDadJNZzYTFKBHWhC2oFgQGZTCc,True,1588473476,397118369,2478526,1239263,1239263,72FwbpFGoLEazJEdpqNtPNefsadUrimUqma9wSoy4qiS,99141065,385621353,-286480288,624
2021-12-13 19:31:06.825012,2021-12-13 14:25:59-05:00,859,AaMCg49sJwNtdB5wHACg15TYAzzJXy8xtG4zuVXhKiVE,HbDYqDa9bewGPvsiaHRM9HmEvh1scPaUaGvqog66gYir,True,35111320,8777830,53815,26907,26908,GmqQKnMfFxkv6ChqGaZ2wmSFDow7R1x7WeRfU58GVvfw,2152628,8141761,-5989133,613
2021-12-13 19:31:06.825012,2021-12-13 14:26:30-05:00,860,EAUFD16wab8qRMJ4H6updHGt4xFqgRCDeRHVCsLCTSTL,8vkfYSyCyBY9g4TZrp52jUcQj6udy9xAaA4fioRE2RXx,True,484121874,121030468,756977,378488,378489,GmqQKnMfFxkv6ChqGaZ2wmSFDow7R1x7WeRfU58GVvfw,30279101,160849101,-130570000,625
2021-12-13 19:31:06.825012,2021-12-13 14:26:42-05:00,861,gMjmD7WioyUdQdwNqE5fobLcxPwoJv5rAvLmJaf8Jjw,5n77euFjVJiwKrnbYq1KpcENW1mzBZj2BuDGyzazrkJ8,True,43515614,10878902,66868,33434,33434,GmqQKnMfFxkv6ChqGaZ2wmSFDow7R1x7WeRfU58GVvfw,2674739,9604288,-6929549,614
2021-12-13 19:31:06.825012,2021-12-13 14:26:58-05:00,862,DGbj8tnqECzM9FG8j225Ap7A4Fdm3J1Ksm32JBFG7igv,Cd3D2UVwoSZLygM2e3UQppQANsokpmx5CNBs1C5zueay,True,43918442,10979610,67714,33857,33857,GmqQKnMfFxkv6ChqGaZ2wmSFDow7R1x7WeRfU58GVvfw,2708560,9334553,-6625993,616
2021-12-13 19:31:06.825012,2021-12-13 14:27:57-05:00,863,4KMzwWHPeW51cxu4nMpbqCaqo96dMqaHWyRCGQktfQfd,F7q4GNYcbnZa8dJ4qovQwjmxpKpdEmdxQMXRPb9nQupa,True,35542261,8885564,55147,27573,27574,GmqQKnMfFxkv6ChqGaZ2wmSFDow7R1x7WeRfU58GVvfw,2205884,8467392,-6261508,620
2021-12-13 19:31:06.825012,2021-12-13 14:28:10-05:00,864,Gbxc51WERLLeCtiHv7rDvE52aqF541RoQWG5n5aqErq6,4ngBoHbfXijLMqGKxFMNht9sbmxy2g5eqBmn8QsBmbx1,True,35617831,8904457,54731,27365,27366,GmqQKnMfFxkv6ChqGaZ2wmSFDow7R1x7WeRfU58GVvfw,2189246,8566250,-6377004,614
2021-12-13 19:31:06.825012,2021-12-13 14:28:17-05:00,865,7mYQ2DJZ1YYMpNbpA93hCDtzQDhEHjAGxLJt2g4KeYTW,8nTKeruC3wiPjT7VytdM2gX7msjwbHxTkyhsR88GJgpc,True,40354269,10088567,61900,30950,30950,GmqQKnMfFxkv6ChqGaZ2wmSFDow7R1x7WeRfU58GVvfw,2476032,9851382,-7375350,613
2021-12-13 19:31:06.825012,2021-12-13 14:28:18-05:00,866,BpvWyveup3q7q6Cws5TWkFYiZ8bQXRrfdxvzrN9FnYo6,2CWjropYSn9fJ66FT4zqUcwTrEaPp3CjGgoRATixyca1,True,22856681,5714170,33672,16836,16836,GmqQKnMfFxkv6ChqGaZ2wmSFDow7R1x7WeRfU58GVvfw,1346897,7751236,-6404339,589
2021-12-13 19:31:06.825012,2021-12-13 14:28:18-05:00,867,8G2hAWXgJZRNMv32dcGkCrsMpqs1aTmGo2rsDm2VZ5Fn,4PMxnUH1oQQdtchAZ2sKDYkg8iiFCFxCS7yE9iP5bQyi,True,16922071,4230517,25503,12751,12752,GmqQKnMfFxkv6ChqGaZ2wmSFDow7R1x7WeRfU58GVvfw,1020150,8557820,-7537670,602
2021-12-13 19:31:06.825012,2021-12-13 14:28:27-05:00,868,2ce2v2TCbjNH635NgbwTG3sqiRWYrRRaBpxPxBZJ929q,9cnoebT43FkWDFhidndGCVNiFD4NErv8DuL1Va4Jv9S8,True,116480663,29120165,177890,88945,88945,GmqQKnMfFxkv6ChqGaZ2wmSFDow7R1x7WeRfU58GVvfw,7115632,61074243,-53958611,610
2021-12-13 19:31:06.825012,2021-12-13 14:28:27-05:00,869,4FazDUgfQ3AKoFcnWHr8E9Ht8jLA3tkxf75yrGZVHdmF,HzRMH6mbgEKydRCnnMvSsKgTEVNQi6nuzoR1xutYFdzg,True,1186360,296590,1803,901,902,GmqQKnMfFxkv6ChqGaZ2wmSFDow7R1x7WeRfU58GVvfw,72139,571791,-499652,608
2021-12-13 19:31:06.825012,2021-12-13 14:28:29-05:00,870,2XnLbeSYLmYWRhErrHMyaXTFtLGMZu6S5fDzp3KkFGC5,8zatCNqr7MQuJXeL7aUFSDGrrEEwa6fgviFu6M1WErHX,True,91913808,22978452,140869,70434,70435,GmqQKnMfFxkv6ChqGaZ2wmSFDow7R1x7WeRfU58GVvfw,5634772,24413389,-18778617,613
2021-12-13 19:31:06.825012,2021-12-13 14:28:29-05:00,871,6QZamUpLHzSzJhj1XtzPP5dHQRvTUmaqRmntxcLfWwE3,D9F6yp639JKp473cZTsB5puUr1URdi18ZxZTFXE1p8py,True,32731710,8182927,50262,25131,25131,GmqQKnMfFxkv6ChqGaZ2wmSFDow7R1x7WeRfU58GVvfw,2010496,9634956,-7624460,614
2021-12-13 19:31:06.825012,2021-12-13 14:28:30-05:00,872,gHv15388BYFZ6PS2p7XTvT9QViJ1rjevHdykD6Pmvzh,9YZPTB6d7St4TPpMY2vP4rZ56B2ZvzViB1DLWbPLK1hn,True,210549518,52637379,328471,164235,164236,GmqQKnMfFxkv6ChqGaZ2wmSFDow7R1x7WeRfU58GVvfw,13138850,66511882,-53373032,624
2021-12-13 19:31:06.825012,2021-12-13 14:28:46-05:00,873,Hkn5Ghsa35dqjtkXHRvnx3wkSoo9hfuRGkdbhqhCzyy5,67C58WFj5x7evA4xTh3pj7FQL49xyxtCzcZVGRMwQyMi,True,1104510235,276127558,1727104,863552,863552,GmqQKnMfFxkv6ChqGaZ2wmSFDow7R1x7WeRfU58GVvfw,69084184,350088377,-281004193,625
2021-12-13 19:31:06.825012,2021-12-13 14:29:32-05:00,874,6woJkgUd2cpQQQBEp1C2G9NsYAvPwYmZXXTd6AxhieMy,E6xCdLJbDq5qFsvHEffD1Qfqrsj19H81mbj7XMUXUPnr,True,911687413,227921853,1422494,711247,711247,GmqQKnMfFxkv6ChqGaZ2wmSFDow7R1x7WeRfU58GVvfw,56899774,242013486,-185113712,624
2021-12-13 19:31:06.825012,2021-12-13 14:29:32-05:00,875,DH2tcZVt4nHQbph6znZRrwcyhjwiNYtgeamu72vcC6nR,ACsbP5BDFQEHQHTsdrWTBShhEUh9HeAKsE7iwyK72v2p,True,44057975,11014493,67953,33976,33977,GmqQKnMfFxkv6ChqGaZ2wmSFDow7R1x7WeRfU58GVvfw,2718147,11864562,-9146415,616
2021-12-13 19:31:06.825012,2021-12-13 14:29:34-05:00,876,FCrgF8s6BHP9Hho11yzZgbSaVXraUxJA3zSEzQK52DFQ,HAikgTkQvmKEseE5mXxVFKe1pyvVmTZePHh4M27YgFDg,True,3240393,810098,4625,2312,2313,GmqQKnMfFxkv6ChqGaZ2wmSFDow7R1x7WeRfU58GVvfw,185024,695491,-510467,570
2021-12-13 19:37:46.102580,2021-12-13 14:31:37-05:00,877,6wYw2tQWSj6YzrPL8s5ZVp4pKnX4tUdovt8wzUCyoWfs,DCuvqHhUwZiZ2XZGyxPREjEA5WQZNwuV9eAcFMEeS3a5,True,1238345280,309586320,1936449,968224,968225,GmqQKnMfFxkv6ChqGaZ2wmSFDow7R1x7WeRfU58GVvfw,77457968,290563167,-213105199,625
2021-12-13 19:37:46.102580,2021-12-13 14:31:54-05:00,878,C1CsbgQFvEvSXzuVHTr39tQHr3drDhjxeYiotd8eNocF,4rAaTCAMj5VpgNVKiYizabH7cMLhEA12seu2QXQNTyV3,True,62826974,15706743,97912,48956,48956,GmqQKnMfFxkv6ChqGaZ2wmSFDow7R1x7WeRfU58GVvfw,3916504,16810895,-12894391,623
2021-12-13 19:37:46.102580,2021-12-13 14:33:14-05:00,879,Fn6J1eMQJoA5rXCwX2HjAF86AowsJfULLuYXVfzgb8aX,6Ett2WPmz4HoWVSVEZD73UzFetd3oFSh7C676MEVYd36,True,2032899991,508224997,2943267,1471633,1471634,72FwbpFGoLEazJEdpqNtPNefsadUrimUqma9wSoy4qiS,117730689,786619547,-668888858,579
2021-12-13 19:37:46.102580,2021-12-13 14:33:14-05:00,880,34235h7L3VPHqcUkLycAsaJAXyq4vtgoG27yei34CKaj,Bg6WtWMQXGBakzrizVhBrE1X2hafMHBtktn3YYjeyscf,True,406584404,101646101,593541,296770,296771,72FwbpFGoLEazJEdpqNtPNefsadUrimUqma9wSoy4qiS,23741678,154538866,-130797188,583
2021-12-13 19:37:46.102580,2021-12-13 14:33:14-05:00,881,F4hN7ecndZ8Gr5KQNSFaSrMGawMasz7jfWTLTMpk7gaB,AJ23FpXSGjipcqywk88WGsKfqfiiUjPzZLsvLtBAhB12,True,208566052,52141513,301596,150798,150798,GmqQKnMfFxkv6ChqGaZ2wmSFDow7R1x7WeRfU58GVvfw,12063878,47694729,-35630851,578
2021-12-13 19:37:46.102580,2021-12-13 14:33:27-05:00,882,3EkaWW2WfpdRsgX7KF2DxjW4DA5qyvHMRtUNrea7c5Bk,B9JxYbj471pp49bkZic3LWfWFVT75oJd3UzMcysYitdg,True,68662080,17165520,105625,52812,52813,GmqQKnMfFxkv6ChqGaZ2wmSFDow7R1x7WeRfU58GVvfw,4225010,15215062,-10990052,615
2021-12-13 19:37:46.102580,2021-12-13 14:33:34-05:00,883,9WJBnVi84E926j7xEd566WzrZJkPJWRgmEnYj9vyjuad,4dLaFS5F7TGyLdwuJLMGkz3bSL53aHzd9ZfpNmhHxXeF,True,1410622560,352655640,2175640,1087820,1087820,GmqQKnMfFxkv6ChqGaZ2wmSFDow7R1x7WeRfU58GVvfw,87025614,291849782,-204824168,616
2021-12-13 19:37:46.102580,2021-12-13 14:33:48-05:00,884,AoPQqPjLPi8fZiLkhMGLRj6oD5k2asrvJtCkpW19DvGr,H5Sgmf1VuY13iHjPuLJ2q9wtSdkXG1AQsEv2eq6zzm8Y,True,34736279,8684069,53176,26588,26588,GmqQKnMfFxkv6ChqGaZ2wmSFDow7R1x7WeRfU58GVvfw,2127063,8123451,-5996388,612
2021-12-13 19:37:46.102580,2021-12-13 14:34:24-05:00,885,D58t4uTjFumsUeYFaKnpV8BRTEQEqKXBreFTdwGrott7,67p6kHDfVqQijfcwugvZK59c3aRRH9x3eHxruqH8WEqF,True,35514638,8878659,55367,27683,27684,GmqQKnMfFxkv6ChqGaZ2wmSFDow7R1x7WeRfU58GVvfw,2214701,8513463,-6298762,623
2021-12-13 19:37:46.102580,2021-12-13 14:34:38-05:00,886,5gN3624v6n1zQ1BKtZi1e9ZLpbCa4MEfhgHySFB81Qfm,UXT3oB5ud18rBsygsfxwA93kQYdSNbbzTCjt4gtU2jP,True,41006316,10251578,62825,31412,31413,GmqQKnMfFxkv6ChqGaZ2wmSFDow7R1x7WeRfU58GVvfw,2513027,9615449,-7102422,612
2021-12-13 19:37:46.102580,2021-12-13 14:34:47-05:00,887,AHm7zF4rpaxaayBLn5QDHgJSp8KAr647s4cNvQ9wLgd7,FDM33WngED24pukBvSDpPAzinW6afVAeGReum5nyLRiC,True,15962876,3990719,24886,12443,12443,GmqQKnMfFxkv6ChqGaZ2wmSFDow7R1x7WeRfU58GVvfw,995459,4858802,-3863343,623
2021-12-13 19:37:46.102580,2021-12-13 14:34:47-05:00,888,2FrqGFZjbiNykJyo9BZ5S9FguQJPJiTi681rJJsQ5dta,3QUncYP92NKrfpaTvuF9iQg11PXKgZAgEngwh6BbnCCj,True,15919361,3979840,24702,12351,12351,GmqQKnMfFxkv6ChqGaZ2wmSFDow7R1x7WeRfU58GVvfw,988108,3583195,-2595087,620
2021-12-13 19:37:46.102580,2021-12-13 14:34:47-05:00,889,GGGyesjbt7h2XHHp9u8vpiWGugFwEbrtYaKrNQSDhQd7,8tydo1ZjGHmPBSqU33tywB3f9szdsHk1ckGFe4Ay5pgs,True,972559159,243139789,1476404,738202,738202,GmqQKnMfFxkv6ChqGaZ2wmSFDow7R1x7WeRfU58GVvfw,59056165,503298963,-444242798,607
2021-12-13 19:37:46.102580,2021-12-13 14:35:00-05:00,890,7jvKp6onXyWgwsFrFWj4hYTXJsYYD6ot5mn6rPFuJriy,J7N6HiozevJVTiY9hDEUs2ud5BwT5QSE7wnMBS1w5ie2,True,1141059590,285264897,1783302,891651,891651,GmqQKnMfFxkv6ChqGaZ2wmSFDow7R1x7WeRfU58GVvfw,71332086,354278587,-282946501,625
2021-12-13 19:37:46.102580,2021-12-13 14:35:01-05:00,891,6yw4GPvkqUbakcEWtqSCfjVLukty11xqjDpGxtEN9Km2,5ppEx7wkpqbG5nApCWMdRja3oRSheFmAAsNHUX7h2w2Y,True,31757776,7939444,48152,24076,24076,GmqQKnMfFxkv6ChqGaZ2wmSFDow7R1x7WeRfU58GVvfw,1926082,19881963,-17955881,606
2021-12-13 19:37:46.102580,2021-12-13 14:35:02-05:00,892,BhiAaiZu7fF8ndggJrLyiFVCRq526cNBw7VaeascEmNL,4en8MipPi7vq15NGhpPMQfptNdEyhp2j7fpgxBBtjyfz,True,41521390,10380347,64518,32259,32259,GmqQKnMfFxkv6ChqGaZ2wmSFDow7R1x7WeRfU58GVvfw,2580745,8826159,-6245414,621
2021-12-13 19:37:46.102580,2021-12-13 14:36:59-05:00,893,DTWFNeptqa59hRfBzQUVtVjto8fmRW7TvXcH8Tz8PXkT,67JFe2J2ZVJJWkGcYBeJUhXsScYAH2zTJbzfmFL1kGDb,True,130739214,32684803,204551,102275,102276,GmqQKnMfFxkv6ChqGaZ2wmSFDow7R1x7WeRfU58GVvfw,8182072,63051954,-54869882,625
2021-12-13 19:37:46.102580,2021-12-13 14:37:02-05:00,894,BQBQicboM5o25LihnffqxcJmoPoA3mgBKNeG4H8UTHVh,E8rJFAs7dbDmQA1o5aTeNqdmADxWMd5cDzvwAGMFFCix,True,29236731,7309182,45508,22754,22754,GmqQKnMfFxkv6ChqGaZ2wmSFDow7R1x7WeRfU58GVvfw,1820347,16288986,-14468639,622
2021-12-13 19:37:46.102580,2021-12-13 14:37:20-05:00,895,GqAS41YJssg9aaEp3hs3sG98APCsXhiQBQszXaSjZ2bN,2wodJ3AhrXdE1T4oVL95KvoBND7PubG5Wd5GWiLCMZJU,True,3670092028,917523007,5729028,2864514,2864514,GmqQKnMfFxkv6ChqGaZ2wmSFDow7R1x7WeRfU58GVvfw,229161137,2086261692,-1857100555,624
2021-12-13 19:37:46.102580,2021-12-13 14:37:21-05:00,896,4nEJqarcHzgizZsc11SYg3PP5E91nsjqzzNxUCSYA5sb,zayUU1osJ9byFsmsi9CZqvQAhtEenpmXv2UwN6YDt6B,True,129501384,32375346,201766,100883,100883,GmqQKnMfFxkv6ChqGaZ2wmSFDow7R1x7WeRfU58GVvfw,8070660,62490962,-54420302,623
2021-12-13 19:37:46.102580,2021-12-13 14:37:25-05:00,897,73PpLzJmAimmqtjGpRcYHua8t6wx3gYiiXFvQxnSDMJV,CRCpLcS8LNKX22co94spJBXEes9Fnh5rYBvbVEte4JXA,True,122378309,30594577,190847,95423,95424,GmqQKnMfFxkv6ChqGaZ2wmSFDow7R1x7WeRfU58GVvfw,7633910,59053056,-51419146,623
2021-12-13 19:37:46.102580,2021-12-13 14:37:26-05:00,898,6VBYUiLyQXvvsDmq1vh1oJ5VeA89tGgxtkgFfofc372m,35pyoeRA4duKX7njdYny3KffM2xaxuWUZGRUMQJ5iAiu,True,120013308,30003327,187715,93857,93858,GmqQKnMfFxkv6ChqGaZ2wmSFDow7R1x7WeRfU58GVvfw,7508620,57917977,-50409357,625
2021-12-13 19:37:46.102580,2021-12-13 14:37:31-05:00,899,6kt64nJRnYaWMi9GbpZaUuhbToAVRd7FUMTGASAAJrve,2Sdxv9ZtogNcVbJwBPxKmVjwAiKyX5GHEfnRmFcydQ1G,True,121195224,30298806,189592,94796,94796,GmqQKnMfFxkv6ChqGaZ2wmSFDow7R1x7WeRfU58GVvfw,7583685,58498512,-50914827,625
2021-12-13 19:37:46.102580,2021-12-13 14:37:45-05:00,900,Fw2e6jxKVeFcJSe9MyVhSz3dUdJQLs3XULHrT1mtMU9U,591U5bexgLRJXygtK5fpCRXcZEq89KgewFTdfPkti8bY,True,123422662,30855665,189399,94699,94700,GmqQKnMfFxkv6ChqGaZ2wmSFDow7R1x7WeRfU58GVvfw,7575977,59638152,-52062175,613
2021-12-13 19:44:37.307614,2021-12-13 14:37:50-05:00,901,29rwdfrBkccfAXJdN6rhW5JNpCzDhg4oWF9ntWtMpQvo,HCjTVhGTSSqJFwQY68vSXYF7dQ1QCtz4EZca4HqmkYuo,True,139094738,34773684,215699,107849,107850,GmqQKnMfFxkv6ChqGaZ2wmSFDow7R1x7WeRfU58GVvfw,8627988,67954341,-59326353,620
2021-12-13 19:44:37.307614,2021-12-13 14:37:57-05:00,902,BrHRMouGRz3LBNzd9anfdYMhWfg8yUPHL4PqJ8WdEDFS,4uzoLa3mC2VYHAPBoHLX4gTjPTC28rPf2fvEGtJWPYc,True,1174278570,293569642,1805819,902909,902910,GmqQKnMfFxkv6ChqGaZ2wmSFDow7R1x7WeRfU58GVvfw,72232772,663746898,-591514126,615
2021-12-13 19:44:37.307614,2021-12-13 14:37:57-05:00,903,Ggjn39zkoAcCcmDmmzqYw8RFsMqjQGtAX8myhB3p4WQ4,FWnftuAeU86mR8RMR9qQwLfkujqcfzEiupBPkvWre3RS,True,127003500,31750875,196522,98261,98261,GmqQKnMfFxkv6ChqGaZ2wmSFDow7R1x7WeRfU58GVvfw,7860896,61404361,-53543465,618
2021-12-13 19:44:37.307614,2021-12-13 14:37:57-05:00,904,4M7XECgNotuYef6fXsB659bgvA4LBYq9WrUFZP8jEZ8q,EjF9ZKUaBWZodjKy7ET7rEyK1uSsKX2cvcd4eJSYarF8,True,160976082,40244020,249302,124651,124651,GmqQKnMfFxkv6ChqGaZ2wmSFDow7R1x7WeRfU58GVvfw,9972092,39844911,-29872819,619
2021-12-13 19:44:37.307614,2021-12-13 14:37:57-05:00,905,Ad4hjpPdExRAqUATSvqZYLBVNBcmtB2Pqh6MWwc1XGj,6TnqcHDyBnSZMds1eUc28aKuBThwGjAPsnaFKeC2fGnK,True,125827668,31456917,194457,97228,97229,GmqQKnMfFxkv6ChqGaZ2wmSFDow7R1x7WeRfU58GVvfw,7778312,60810252,-53031940,618
2021-12-13 19:44:37.307614,2021-12-13 14:37:57-05:00,906,9bhB755nk1VKCFQ15knBRdXESNqN6T1o3Lp3u214mARe,FvZuSbYfVMwGg8UUurGDFe7VVtoUBghrPNFYTr2gKCFc,True,128135818,32033954,196170,98085,98085,GmqQKnMfFxkv6ChqGaZ2wmSFDow7R1x7WeRfU58GVvfw,7846823,61945303,-54098480,612
2021-12-13 19:44:37.307614,2021-12-13 14:37:58-05:00,907,DjbEch16uzdDtujFUeqxjquTTS3JXzEys8e9ogUv3aTy,6N8eKb3kfcbJEUZKZERiFiUR4hubB635D8Sotiji2TU8,True,124489006,31122251,188413,94206,94207,GmqQKnMfFxkv6ChqGaZ2wmSFDow7R1x7WeRfU58GVvfw,7536537,60219724,-52683187,605
2021-12-13 19:44:37.307614,2021-12-13 14:38:14-05:00,908,B4Uc39nKzz9wBRQsCkMR4A7RwTJ8rSuwpR6EQn2AesRb,H49bGZgatRZVpj6QufZRVgYrQtH7LpdbiqKBs23151m,True,499239240,124809810,763522,381761,381761,GmqQKnMfFxkv6ChqGaZ2wmSFDow7R1x7WeRfU58GVvfw,30540895,318820016,-288279121,611
2021-12-13 19:44:37.307614,2021-12-13 14:38:23-05:00,909,3VdSA9CED9f5swRwHX2U15U7J6Muaq8VPnCNy9CaGDHe,2YYstfnfdYic5NWmEbcUEHpccNUVd1EhuCkExvMsoMk8,True,458602560,114650640,711863,355931,355932,GmqQKnMfFxkv6ChqGaZ2wmSFDow7R1x7WeRfU58GVvfw,28474559,122549648,-94075089,620
2021-12-13 19:44:37.307614,2021-12-13 14:38:24-05:00,910,9KD2AifD5wFD4QkHYuawXbJgLWHrfj2QPF3fT8jhGVA5,Ga9gAqmkuHbqrr31sUFPqa1xa5WNxLWJWGPUaMxQqLdj,True,89022240,22255560,137909,68954,68955,GmqQKnMfFxkv6ChqGaZ2wmSFDow7R1x7WeRfU58GVvfw,5516375,24322966,-18806591,619
2021-12-13 19:44:37.307614,2021-12-13 14:38:34-05:00,911,HGAFdundf5voDqeh9g7d6Q9mgMf8eEg898QMRBqwPZ6C,deanBuZXWBHEe2TGfP37S9aMBEnEgmZoyRJjAvruzfA,True,81777649,20444411,127243,63621,63622,GmqQKnMfFxkv6ChqGaZ2wmSFDow7R1x7WeRfU58GVvfw,5089727,44329595,-39239868,622
2021-12-13 19:44:37.307614,2021-12-13 14:38:34-05:00,912,i7TcF4weYcqgrRdH3GpndbEYxCxfcSfr9JWYrAUg1CF,BkDfknUir7PnSEW8auoB87PytycEFwyX5kT2GY4SGJJL,True,82297761,20574440,128769,64384,64385,GmqQKnMfFxkv6ChqGaZ2wmSFDow7R1x7WeRfU58GVvfw,5150772,47840386,-42689614,625
2021-12-13 19:44:37.307614,2021-12-13 14:39:26-05:00,913,Gs3WP18hbzNpbBgiU39e6tfkggfCKRyNqPqJQcthuHFD,4XAY25YUma6gUdG2GdbXeivum3t21g93ZagfWGTZYkWZ,True,232061242,58015309,360412,180206,180206,GmqQKnMfFxkv6ChqGaZ2wmSFDow7R1x7WeRfU58GVvfw,14416495,61829736,-47413241,621
2021-12-13 19:44:37.307614,2021-12-13 14:39:36-05:00,914,5Rxuqgs4CaSKbfDXqBMFXkLTQ9dxrUjThXzoy3ouYVtK,BgvbKru66ebrGUcFFymGTmsaQv6GgcGMybiWaXqzBtwX,True,14152320,3538080,21891,10945,10946,GmqQKnMfFxkv6ChqGaZ2wmSFDow7R1x7WeRfU58GVvfw,875643,4125672,-3250029,618
2021-12-13 19:44:37.307614,2021-12-13 14:41:12-05:00,915,H6UTHgiUSkFbavHHZAfGB8R74SHcGDpQLeP1acduznG6,Gz56dyUAKnQ2WAHuCi8CWd5wsikowFvNAi4bzxPUpuyT,True,1168405957,292101489,1823879,911939,911940,GmqQKnMfFxkv6ChqGaZ2wmSFDow7R1x7WeRfU58GVvfw,72955185,310844325,-237889140,624
2021-12-13 19:44:37.307614,2021-12-13 14:41:13-05:00,916,4MmpDGUTyMcYEqJ1RoZ46AN2BhrBUseHaHqF8AmiTPyD,7HW2YZpYM349HMfW7u4h9ESZ1AXkwN8JcVDTNFzp9aTz,True,1866070357,466517589,2915868,1457934,1457934,GmqQKnMfFxkv6ChqGaZ2wmSFDow7R1x7WeRfU58GVvfw,116634724,624579067,-507944343,625
2021-12-13 19:44:37.307614,2021-12-13 14:41:21-05:00,917,2dSDhkCA6Z4wKwZV26EM7quSht4SPh7UakvWn553vs5i,5Yre8DiDyMc1u4SZH7MAHN8rbJ5qyipGXYN5WUkYzhmw,True,6843753153,1710938288,10688316,5344158,5344158,GmqQKnMfFxkv6ChqGaZ2wmSFDow7R1x7WeRfU58GVvfw,427532665,2048653657,-1621120992,624
2021-12-13 19:44:37.307614,2021-12-13 14:41:22-05:00,918,8eTH6eJyyVeMno3UQkffeBg32xofKsQfkhLhXdtaf87s,BCFC7CPXrQPsUfJb2eYSht8GhaApWHpc49AeCXqaYq13,True,35569361,8892339,54960,27480,27480,GmqQKnMfFxkv6ChqGaZ2wmSFDow7R1x7WeRfU58GVvfw,2198422,8321565,-6123143,618
2021-12-13 19:44:37.307614,2021-12-13 14:41:22-05:00,919,9YEzjb49Awvedv9yNc6LG54SkGBug2RYiJwiUV13mGsS,3H8w5WCD187NWWoZMNUCzUDdxTgqrRJLga8gDzUVXBgZ,True,17043257,4260814,26561,13280,13281,4BnQKPLuE3DMTtxp8MjUBytgnhvxqq3ZTqZHTVZo4JJh,1062457,6890961,-5828504,623
2021-12-13 19:44:37.307614,2021-12-13 14:42:21-05:00,920,84SgzR8J6DeqPJ1uXphP1BHMotYGKh3kS4owMMj9x58x,CL7Jkwe3NK4qaAVK2QjuftXnQ5YLqDT9qYeeEi7kJXrV,True,50978753096,12744688274,79248206,39624103,39624103,GmqQKnMfFxkv6ChqGaZ2wmSFDow7R1x7WeRfU58GVvfw,3169928269,22191175173,-19021246904,621
2021-12-13 19:44:37.307614,2021-12-13 14:42:33-05:00,921,7mYQ2DJZ1YYMpNbpA93hCDtzQDhEHjAGxLJt2g4KeYTW,8nTKeruC3wiPjT7VytdM2gX7msjwbHxTkyhsR88GJgpc,True,29673984,7418496,45560,22780,22780,GmqQKnMfFxkv6ChqGaZ2wmSFDow7R1x7WeRfU58GVvfw,1822414,7945731,-6123317,614
2021-12-13 19:44:37.307614,2021-12-13 14:42:33-05:00,922,Dng7By2saPu5TVxcvXidBe71ggBo8tiHkAXPi4kKL1tk,75ufEJmHbLHffphL7tvAXhGyftKLr1z2PXXoB2GGY5fG,True,33168358,8292089,51190,25595,25595,GmqQKnMfFxkv6ChqGaZ2wmSFDow7R1x7WeRfU58GVvfw,2047632,7899542,-5851910,617
2021-12-13 19:44:37.307614,2021-12-13 14:42:35-05:00,923,BpvWyveup3q7q6Cws5TWkFYiZ8bQXRrfdxvzrN9FnYo6,2CWjropYSn9fJ66FT4zqUcwTrEaPp3CjGgoRATixyca1,True,16844400,4211100,25377,12688,12689,72FwbpFGoLEazJEdpqNtPNefsadUrimUqma9wSoy4qiS,1015114,6116511,-5101397,602
2021-12-13 19:44:37.307614,2021-12-13 14:42:35-05:00,924,F7ZpqKKvip659597Jpy6dB91CXS1Cqvxu734GV8mrWFk,BeCPgg2XqH44ed2BYYDadJNZzYTFKBHWhC2oFgQGZTCc,True,1164082561,291020640,1734749,867374,867375,72FwbpFGoLEazJEdpqNtPNefsadUrimUqma9wSoy4qiS,69389993,311602691,-242212698,596
2021-12-13 19:44:37.307614,2021-12-13 14:42:35-05:00,925,8G2hAWXgJZRNMv32dcGkCrsMpqs1aTmGo2rsDm2VZ5Fn,4PMxnUH1oQQdtchAZ2sKDYkg8iiFCFxCS7yE9iP5bQyi,True,12468833,3117208,19298,9649,9649,72FwbpFGoLEazJEdpqNtPNefsadUrimUqma9wSoy4qiS,771926,6647922,-5875996,619
2021-12-13 19:44:37.307614,2021-12-13 14:42:44-05:00,926,EXP61AETWHw3kHSjrJH1jQBt6cXR9Zebz34Cueb3KAzg,2JT9GrgdUKjuQQtXvZqevbjFquUQBMYDoADmBjDKWXj3,True,1231050759,307762689,1833012,916506,916506,GmqQKnMfFxkv6ChqGaZ2wmSFDow7R1x7WeRfU58GVvfw,73320518,602701469,-529380951,595
2021-12-13 19:44:37.307614,2021-12-13 14:42:44-05:00,927,HqtTbC1LFreGvgfpZe7nCqkNnh8GHPQKosfmc19zb1yi,E39UNiHNkwQEd5GXkCtTPqSorQSB1kLx8kjzK4jdFoi3,True,4802304283,1200576070,6944243,3472121,3472122,GmqQKnMfFxkv6ChqGaZ2wmSFDow7R1x7WeRfU58GVvfw,277769723,1433639233,-1155869510,578
2021-12-13 19:44:37.307614,2021-12-13 14:42:44-05:00,928,EAUFD16wab8qRMJ4H6updHGt4xFqgRCDeRHVCsLCTSTL,8vkfYSyCyBY9g4TZrp52jUcQj6udy9xAaA4fioRE2RXx,True,354977855,88744463,535214,267607,267607,GmqQKnMfFxkv6ChqGaZ2wmSFDow7R1x7WeRfU58GVvfw,21408573,127454485,-106045912,603
2021-12-13 19:44:37.307614,2021-12-13 14:42:49-05:00,929,3njiRuSRMXRzKmamyiR72Hc38PU8UDDmWdfPhgxmGxEW,5WoF3gkgygyNNbwxWgVfqGWkExcDixuzgJQQjXEZQ6J5,True,7142196617,1785549154,10315099,5157549,5157550,GmqQKnMfFxkv6ChqGaZ2wmSFDow7R1x7WeRfU58GVvfw,412603993,3719936705,-3307332712,577
2021-12-13 19:44:37.307614,2021-12-13 14:43:04-05:00,930,4FazDUgfQ3AKoFcnWHr8E9Ht8jLA3tkxf75yrGZVHdmF,HzRMH6mbgEKydRCnnMvSsKgTEVNQi6nuzoR1xutYFdzg,True,873569,218392,1353,676,677,72FwbpFGoLEazJEdpqNtPNefsadUrimUqma9wSoy4qiS,54135,445145,-391010,619
2021-12-13 19:44:37.307614,2021-12-13 14:43:09-05:00,931,2ce2v2TCbjNH635NgbwTG3sqiRWYrRRaBpxPxBZJ929q,9cnoebT43FkWDFhidndGCVNiFD4NErv8DuL1Va4Jv9S8,True,85765134,21441283,133559,66779,66780,GmqQKnMfFxkv6ChqGaZ2wmSFDow7R1x7WeRfU58GVvfw,5342378,47407311,-42064933,622
2021-12-13 19:44:37.307614,2021-12-13 14:43:11-05:00,932,2XnLbeSYLmYWRhErrHMyaXTFtLGMZu6S5fDzp3KkFGC5,8zatCNqr7MQuJXeL7aUFSDGrrEEwa6fgviFu6M1WErHX,True,67674482,16918620,105825,52912,52913,72FwbpFGoLEazJEdpqNtPNefsadUrimUqma9wSoy4qiS,4233029,19578192,-15345163,625
2021-12-13 19:44:37.307614,2021-12-13 14:44:21-05:00,933,6QZamUpLHzSzJhj1XtzPP5dHQRvTUmaqRmntxcLfWwE3,D9F6yp639JKp473cZTsB5puUr1URdi18ZxZTFXE1p8py,True,24080941,6020235,37309,18654,18655,GmqQKnMfFxkv6ChqGaZ2wmSFDow7R1x7WeRfU58GVvfw,1492392,7678665,-6186273,619
2021-12-13 19:51:14.546485,2021-12-13 14:47:17-05:00,934,36ByQojnxEckWdQTjqHfxKqCx9yjqWQsPsZyqaN72UWR,AZoirtS1fjX61agRM64tqThVinnJTh3BWgiHyNHPTgZP,True,40203685,10050921,62912,31456,31456,GmqQKnMfFxkv6ChqGaZ2wmSFDow7R1x7WeRfU58GVvfw,2516509,11211627,-8695118,625
2021-12-13 20:12:40.338140,2021-12-13 15:08:38-05:00,935,FCrgF8s6BHP9Hho11yzZgbSaVXraUxJA3zSEzQK52DFQ,HAikgTkQvmKEseE5mXxVFKe1pyvVmTZePHh4M27YgFDg,True,2387658,596914,3420,1710,1710,3RdfgDvLvsdZG5Cf6hKiKMQMqfidyxHzjYvUx1FZpeHQ,136805,567455,-430650,572
2021-12-13 21:16:37.670755,2021-12-13 16:10:48-05:00,936,GKNBtZbwK4w9hyXD1r38NTGcTJhpjt8R9WFCzdXup9Tk,7RLaL2XoFuqrcCcPEB6FzPJzLnAhjQpwcRmDfdpRXFgB,True,1180469485,295117371,1833457,916728,916729,3RdfgDvLvsdZG5Cf6hKiKMQMqfidyxHzjYvUx1FZpeHQ,73338281,316818166,-243479885,621
2021-12-13 21:16:37.670755,2021-12-13 16:12:21-05:00,937,72L76qDRMK3M7X52zuuB9GVyvFFLDBZwFMpVjWjghXzA,4m2ZVuemUctu1edv4YJVAcjXzKwpbCmBujzoUmLDeA7h,True,36253185,9063296,56234,28117,28117,3RdfgDvLvsdZG5Cf6hKiKMQMqfidyxHzjYvUx1FZpeHQ,2249397,8521103,-6271706,620
2021-12-13 21:29:32.973461,2021-12-13 16:20:24-05:00,938,Cv5oVktxmqbU1SxraxH67NEWMKnjgA18R832Fhe9h74a,Cs7xBD4BDiohyopnaYDDChUtR9vmx7uwot6Qp9beQLzt,True,31088322,7772080,48362,24181,24181,3RdfgDvLvsdZG5Cf6hKiKMQMqfidyxHzjYvUx1FZpeHQ,1934480,7425204,-5490724,622
2021-12-13 23:55:30.441757,2021-12-13 18:52:14-05:00,939,F4hN7ecndZ8Gr5KQNSFaSrMGawMasz7jfWTLTMpk7gaB,AJ23FpXSGjipcqywk88WGsKfqfiiUjPzZLsvLtBAhB12,True,154416090,38604022,239541,119770,119771,4BnQKPLuE3DMTtxp8MjUBytgnhvxqq3ZTqZHTVZo4JJh,9581662,38315113,-28733451,620
2021-12-14 00:20:25.201802,2021-12-13 19:00:51-05:00,940,34235h7L3VPHqcUkLycAsaJAXyq4vtgoG27yei34CKaj,Bg6WtWMQXGBakzrizVhBrE1X2hafMHBtktn3YYjeyscf,True,301006517,75251629,470530,235265,235265,3RdfgDvLvsdZG5Cf6hKiKMQMqfidyxHzjYvUx1FZpeHQ,18821205,120858829,-102037624,625
2021-12-14 06:35:08.106151,2021-12-14 01:29:17-05:00,941,Dn916KSmX3HqxT53hrxrbCrV3tdRMCPdaoiRLqetMrth,ATCXRiXgnjRRUbSTPBvtBXMENCqsViexSZbZ6aDaXXWA,True,45356458,11339114,69744,34872,34872,3RdfgDvLvsdZG5Cf6hKiKMQMqfidyxHzjYvUx1FZpeHQ,2789769,10685864,-7896095,615
2021-12-14 06:35:08.106151,2021-12-14 01:29:19-05:00,942,G25vsB3sDqRhHoSK4KwR1TywfrJDtpejVbbevEG9sQ9a,5xFC3Hm13magnAA9GD1EnwC9PrPoEfQ7omEa9p9zCrB1,True,58887251,14721812,90921,45460,45461,3RdfgDvLvsdZG5Cf6hKiKMQMqfidyxHzjYvUx1FZpeHQ,3636867,12174726,-8537859,617
2021-12-14 19:08:14.224755,2021-12-14 13:58:54-05:00,943,J1sBDjpdBZcsSBS5eg95SSRjRqmQUR9cXJCsLJu8yCUt,F5wRpD2senMkGbL8Uquqo8W9x5NQDDa268dHuVFAZCww,True,124840404,31210101,193397,96698,96699,3RdfgDvLvsdZG5Cf6hKiKMQMqfidyxHzjYvUx1FZpeHQ,7735897,34645646,-26909749,619
2021-12-15 15:52:43.179599,2021-12-15 10:51:38-05:00,944,6wYw2tQWSj6YzrPL8s5ZVp4pKnX4tUdovt8wzUCyoWfs,DCuvqHhUwZiZ2XZGyxPREjEA5WQZNwuV9eAcFMEeS3a5,True,913485600,228371400,1409995,704997,704998,GmqQKnMfFxkv6ChqGaZ2wmSFDow7R1x7WeRfU58GVvfw,56399826,231564808,-175164982,617
2021-12-15 15:52:43.179599,2021-12-15 10:52:06-05:00,945,9WJBnVi84E926j7xEd566WzrZJkPJWRgmEnYj9vyjuad,4dLaFS5F7TGyLdwuJLMGkz3bSL53aHzd9ZfpNmhHxXeF,True,1042701120,260675280,1629716,814858,814858,3RdfgDvLvsdZG5Cf6hKiKMQMqfidyxHzjYvUx1FZpeHQ,65188643,234151459,-168962816,625
2021-12-15 15:52:43.179599,2021-12-15 10:52:07-05:00,946,3EkaWW2WfpdRsgX7KF2DxjW4DA5qyvHMRtUNrea7c5Bk,B9JxYbj471pp49bkZic3LWfWFVT75oJd3UzMcysYitdg,True,50742720,12685680,78791,39395,39396,3RdfgDvLvsdZG5Cf6hKiKMQMqfidyxHzjYvUx1FZpeHQ,3151649,12148994,-8997345,621
2021-12-15 15:59:13.283953,2021-12-15 10:58:46-05:00,947,3VdSA9CED9f5swRwHX2U15U7J6Muaq8VPnCNy9CaGDHe,2YYstfnfdYic5NWmEbcUEHpccNUVd1EhuCkExvMsoMk8,True,338549760,84637440,523079,261539,261540,3RdfgDvLvsdZG5Cf6hKiKMQMqfidyxHzjYvUx1FZpeHQ,20923172,96890588,-75967416,618
2021-12-15 15:59:13.283953,2021-12-15 10:58:46-05:00,948,9KD2AifD5wFD4QkHYuawXbJgLWHrfj2QPF3fT8jhGVA5,Ga9gAqmkuHbqrr31sUFPqa1xa5WNxLWJWGPUaMxQqLdj,True,65715840,16428960,101215,50607,50608,3RdfgDvLvsdZG5Cf6hKiKMQMqfidyxHzjYvUx1FZpeHQ,4048622,19204776,-15156154,616
2021-12-15 15:59:13.283953,2021-12-15 10:58:46-05:00,949,5Rxuqgs4CaSKbfDXqBMFXkLTQ9dxrUjThXzoy3ouYVtK,BgvbKru66ebrGUcFFymGTmsaQv6GgcGMybiWaXqzBtwX,True,10458720,2614680,16345,8172,8173,3RdfgDvLvsdZG5Cf6hKiKMQMqfidyxHzjYvUx1FZpeHQ,653818,3247619,-2593801,625
2021-12-15 20:31:22.292300,2021-12-15 15:28:50-05:00,950,FL1C5wMXApaNzez9LFMAiFYVFiLSRQxgZ3GfPrscdvRB,2FkYGYyTzbTFjJBiggre23H7TvqHjzBTdyrzQ5VNGqht,True,32519,8129,49,24,25,3RdfgDvLvsdZG5Cf6hKiKMQMqfidyxHzjYvUx1FZpeHQ,1994,6325,-4331,613
2021-12-15 20:31:22.292300,2021-12-15 15:29:39-05:00,951,FL1C5wMXApaNzez9LFMAiFYVFiLSRQxgZ3GfPrscdvRB,2FkYGYyTzbTFjJBiggre23H7TvqHjzBTdyrzQ5VNGqht,False,25968,25968,367,18,349,GmqQKnMfFxkv6ChqGaZ2wmSFDow7R1x7WeRfU58GVvfw,367,4192,-3825,141
2021-12-15 20:47:56.783917,2021-12-15 15:44:59-05:00,952,9VJgwPsqmUEKHFXGJzfETNaH4XqTgcYzNkNZ5H481UEK,BVvRsDTNQik8oUbqLxtsQLYxrAkZdSKKjrhVtyDT6sCw,True,39519769,9879942,57895,28947,28948,GmqQKnMfFxkv6ChqGaZ2wmSFDow7R1x7WeRfU58GVvfw,2315815,6948553,-4632738,585
2021-12-15 20:47:56.783917,2021-12-15 15:44:59-05:00,953,J5ttoY9YjAuVvggkCeps9sX7ivUWoqps5DzxjfgqddxT,mR1fxSNP4bX9GyzRS1UFLpHg31UAXwB8Du7dydCa7VR,True,33673125,8418281,50079,25039,25040,GmqQKnMfFxkv6ChqGaZ2wmSFDow7R1x7WeRfU58GVvfw,2003178,5925543,-3922365,594
2021-12-15 21:01:06.105679,2021-12-15 15:56:22-05:00,954,F9HRMjUNMmiSdUYrXrV1eUGHpm5x1fFc7Ef5JXdThUub,GKhiMaAWFaUyUAyWyzStHAWqcEfN1EPgVJ9rJ1cyktL,True,5649190,1412297,8723,4361,4362,GmqQKnMfFxkv6ChqGaZ2wmSFDow7R1x7WeRfU58GVvfw,348931,998626,-649695,617
2021-12-16 10:17:12.555279,2021-12-16 05:07:49-05:00,955,D67X2HKszEB1VYeaHGsBo4uCzMTFSg8i3CabjeJmDUv7,422YiGvHrcXU1HQruML68rXqpaEcvvrVcZPnUNrfxdze,True,887859,221964,1386,693,693,3RdfgDvLvsdZG5Cf6hKiKMQMqfidyxHzjYvUx1FZpeHQ,55456,162033,-106577,624
2021-12-16 11:05:43.116752,2021-12-16 06:04:11-05:00,956,F9HRMjUNMmiSdUYrXrV1eUGHpm5x1fFc7Ef5JXdThUub,GKhiMaAWFaUyUAyWyzStHAWqcEfN1EPgVJ9rJ1cyktL,True,4308657,1077164,6723,3361,3362,3RdfgDvLvsdZG5Cf6hKiKMQMqfidyxHzjYvUx1FZpeHQ,268956,828020,-559064,624
2021-12-16 11:44:08.284419,2021-12-16 06:39:59-05:00,957,D67X2HKszEB1VYeaHGsBo4uCzMTFSg8i3CabjeJmDUv7,422YiGvHrcXU1HQruML68rXqpaEcvvrVcZPnUNrfxdze,True,677530,169382,1059,529,530,3RdfgDvLvsdZG5Cf6hKiKMQMqfidyxHzjYvUx1FZpeHQ,42363,133946,-91583,625
2021-12-16 11:50:32.930179,2021-12-16 06:46:09-05:00,958,F9HRMjUNMmiSdUYrXrV1eUGHpm5x1fFc7Ef5JXdThUub,GKhiMaAWFaUyUAyWyzStHAWqcEfN1EPgVJ9rJ1cyktL,True,3323727,830931,4249,2124,2125,3RdfgDvLvsdZG5Cf6hKiKMQMqfidyxHzjYvUx1FZpeHQ,169999,681552,-511553,511
2021-12-16 13:42:44.420803,2021-12-16 08:41:45-05:00,959,EMZFun8ihnRYniWmMGoaBgDLMYZPS5fHQ7ng3WitvhD9,8ximgKeaMQDFtxXexJzYsMm2pg7rK1hh5FNXqahLehXY,True,45503330,11375832,68733,34366,34367,3RdfgDvLvsdZG5Cf6hKiKMQMqfidyxHzjYvUx1FZpeHQ,2749335,8256705,-5507370,604
2021-12-16 15:17:33.508804,2021-12-16 10:13:15-05:00,960,EMZFun8ihnRYniWmMGoaBgDLMYZPS5fHQ7ng3WitvhD9,8ximgKeaMQDFtxXexJzYsMm2pg7rK1hh5FNXqahLehXY,True,34638794,8659698,54051,27025,27026,GmqQKnMfFxkv6ChqGaZ2wmSFDow7R1x7WeRfU58GVvfw,2162040,6803923,-4641883,624
2021-12-16 15:17:33.508804,2021-12-16 10:16:21-05:00,961,D67X2HKszEB1VYeaHGsBo4uCzMTFSg8i3CabjeJmDUv7,422YiGvHrcXU1HQruML68rXqpaEcvvrVcZPnUNrfxdze,True,517456,129362,794,397,397,GmqQKnMfFxkv6ChqGaZ2wmSFDow7R1x7WeRfU58GVvfw,31769,109824,-78055,613
2021-12-16 15:55:09.683084,2021-12-16 10:54:59-05:00,962,GpPGyJfH6evuzQoPokVqrC7vodzzaeMqCPeat2GUcKD6,6u45nCCmdzReAoYcAfNZyny37djyDrsuKAD49W62QXwJ,False,5146,5146,0,0,0,72FwbpFGoLEazJEdpqNtPNefsadUrimUqma9wSoy4qiS,0,1036,-2237,0
2021-12-17 10:32:16.814367,2021-12-17 05:28:18-05:00,963,BgoKAyBNaJ1geeQ2FcGSHEQDWATVD3w3wmcNHtj8Awu3,8Haz7duE2ycueaJsGdrGNnK79KGHwnzKBpoafC8RZGg2,True,982691814,245672953,1529378,764689,764689,GmqQKnMfFxkv6ChqGaZ2wmSFDow7R1x7WeRfU58GVvfw,61175121,265151762,-203976641,622
2021-12-17 12:45:03.905036,2021-12-17 07:16:05-05:00,964,7PzGZgzieFyyFs1dbajkNQgVxooFUNZrj1bUsQvrSwbp,A2gDREmSmJTBPPw3sbKVY3smC9wbHMDdv87gr4Tr2ES7,True,155254619,38813654,241790,120895,120895,4BnQKPLuE3DMTtxp8MjUBytgnhvxqq3ZTqZHTVZo4JJh,9671616,38230842,-28559226,622
2021-12-17 13:27:59.219589,2021-12-17 08:05:45-05:00,965,DH2tcZVt4nHQbph6znZRrwcyhjwiNYtgeamu72vcC6nR,ACsbP5BDFQEHQHTsdrWTBShhEUh9HeAKsE7iwyK72v2p,True,32972420,8243105,51465,25732,25733,GmqQKnMfFxkv6ChqGaZ2wmSFDow7R1x7WeRfU58GVvfw,2058615,8995262,-6936647,624
2021-12-17 14:11:53.902450,2021-12-17 09:02:09-05:00,966,3qyKG4juvhcDnhoSVAFibqJtk5i4q8vLVgvwzXtdk5KP,2ofR6Hdm8qgQfKnaNFouzzBs311xgPcxny4ViS7g2Wxo,True,27628614,6907153,42148,21074,21074,GmqQKnMfFxkv6ChqGaZ2wmSFDow7R1x7WeRfU58GVvfw,1685937,7307678,-5621741,610
2021-12-17 14:11:53.902450,2021-12-17 09:04:19-05:00,967,6woJkgUd2cpQQQBEp1C2G9NsYAvPwYmZXXTd6AxhieMy,E6xCdLJbDq5qFsvHEffD1Qfqrsj19H81mbj7XMUXUPnr,True,681846906,170461726,1067003,533501,533502,GmqQKnMfFxkv6ChqGaZ2wmSFDow7R1x7WeRfU58GVvfw,42680123,183451458,-140771335,625
2021-12-17 14:48:43.373812,2021-12-17 09:37:27-05:00,968,GKNBtZbwK4w9hyXD1r38NTGcTJhpjt8R9WFCzdXup9Tk,7RLaL2XoFuqrcCcPEB6FzPJzLnAhjQpwcRmDfdpRXFgB,True,881841688,220460422,1363043,681521,681522,4BnQKPLuE3DMTtxp8MjUBytgnhvxqq3ZTqZHTVZo4JJh,54521752,240673351,-186151599,618
2021-12-17 14:48:43.373812,2021-12-17 09:40:57-05:00,969,2YcB3QQGWho5oogDd1nK3cpLQzwwwXGxybrhe2xDkDxq,5DjAUp6CxKStYTaXSnzjvYkfqCXfG8Y61bWw5UwbbE3q,True,137801976,34450494,215584,107792,107792,GmqQKnMfFxkv6ChqGaZ2wmSFDow7R1x7WeRfU58GVvfw,8623388,38804444,-30181056,625
2021-12-17 14:48:43.373812,2021-12-17 09:43:28-05:00,970,FCrgF8s6BHP9Hho11yzZgbSaVXraUxJA3zSEzQK52DFQ,HAikgTkQvmKEseE5mXxVFKe1pyvVmTZePHh4M27YgFDg,False,1762319,1762319,76266,3813,72453,GmqQKnMfFxkv6ChqGaZ2wmSFDow7R1x7WeRfU58GVvfw,76266,442645,-366379,432
2021-12-17 14:48:43.373812,2021-12-17 09:43:30-05:00,971,J1sBDjpdBZcsSBS5eg95SSRjRqmQUR9cXJCsLJu8yCUt,F5wRpD2senMkGbL8Uquqo8W9x5NQDDa268dHuVFAZCww,True,92948115,23237028,144473,72236,72237,GmqQKnMfFxkv6ChqGaZ2wmSFDow7R1x7WeRfU58GVvfw,5778945,26660522,-20881577,621
2021-12-17 14:48:43.373812,2021-12-17 09:48:37-05:00,972,BgoKAyBNaJ1geeQ2FcGSHEQDWATVD3w3wmcNHtj8Awu3,8Haz7duE2ycueaJsGdrGNnK79KGHwnzKBpoafC8RZGg2,True,722550790,180637697,1114492,557246,557246,4BnQKPLuE3DMTtxp8MjUBytgnhvxqq3ZTqZHTVZo4JJh,44579700,212050215,-167470515,616
2021-12-17 15:04:25.317664,2021-12-17 09:57:17-05:00,973,7PzGZgzieFyyFs1dbajkNQgVxooFUNZrj1bUsQvrSwbp,A2gDREmSmJTBPPw3sbKVY3smC9wbHMDdv87gr4Tr2ES7,True,114095943,28523985,176098,88049,88049,GmqQKnMfFxkv6ChqGaZ2wmSFDow7R1x7WeRfU58GVvfw,7043943,30809559,-23765616,617
2021-12-17 15:04:25.317664,2021-12-17 10:00:14-05:00,974,3qyKG4juvhcDnhoSVAFibqJtk5i4q8vLVgvwzXtdk5KP,2ofR6Hdm8qgQfKnaNFouzzBs311xgPcxny4ViS7g2Wxo,True,20351942,5087985,31698,15849,15849,GmqQKnMfFxkv6ChqGaZ2wmSFDow7R1x7WeRfU58GVvfw,1267948,5870764,-4602816,623
2021-12-17 15:04:25.317664,2021-12-17 10:03:24-05:00,975,Gs3WP18hbzNpbBgiU39e6tfkggfCKRyNqPqJQcthuHFD,4XAY25YUma6gUdG2GdbXeivum3t21g93ZagfWGTZYkWZ,True,173100586,43275145,263053,131526,131527,DddJ7EWCmYEEZETCBNgAUSg81Ls6fZtiAaY5ekJ5sXx1,10522147,47038369,-36516222,607
2021-12-17 15:04:25.317664,2021-12-17 10:03:28-05:00,976,DH2tcZVt4nHQbph6znZRrwcyhjwiNYtgeamu72vcC6nR,ACsbP5BDFQEHQHTsdrWTBShhEUh9HeAKsE7iwyK72v2p,True,24217674,6054418,37096,18548,18548,GmqQKnMfFxkv6ChqGaZ2wmSFDow7R1x7WeRfU58GVvfw,1483872,7215012,-5731140,612
2021-12-17 15:04:25.317664,2021-12-17 10:03:33-05:00,977,6woJkgUd2cpQQQBEp1C2G9NsYAvPwYmZXXTd6AxhieMy,E6xCdLJbDq5qFsvHEffD1Qfqrsj19H81mbj7XMUXUPnr,True,500725992,125181498,769952,384976,384976,72FwbpFGoLEazJEdpqNtPNefsadUrimUqma9wSoy4qiS,30798094,147053863,-116255769,615
2021-12-17 16:17:35.493487,2021-12-17 11:02:15-05:00,978,DcPPN5C8RAMXXghgp5xrJYytNsWJksWRQqhwRCv1LiuE,5RNFKEMCUQ2r7KxA4NeaWmrzHd8KBztEiBCQNfHhkLWi,True,556550,139136,838,419,419,GmqQKnMfFxkv6ChqGaZ2wmSFDow7R1x7WeRfU58GVvfw,33523,101949,-68426,602
2021-12-17 16:17:35.493487,2021-12-17 11:02:23-05:00,979,F4hN7ecndZ8Gr5KQNSFaSrMGawMasz7jfWTLTMpk7gaB,AJ23FpXSGjipcqywk88WGsKfqfiiUjPzZLsvLtBAhB12,True,218718486,54679621,336534,168267,168267,GmqQKnMfFxkv6ChqGaZ2wmSFDow7R1x7WeRfU58GVvfw,13461381,38208795,-24747414,615
2021-12-18 11:09:23.099116,2021-12-18 06:08:56-05:00,980,D67X2HKszEB1VYeaHGsBo4uCzMTFSg8i3CabjeJmDUv7,422YiGvHrcXU1HQruML68rXqpaEcvvrVcZPnUNrfxdze,True,393391,98347,615,307,308,3RdfgDvLvsdZG5Cf6hKiKMQMqfidyxHzjYvUx1FZpeHQ,24612,88518,-63906,625
2021-12-18 11:21:42.192168,2021-12-18 06:10:02-05:00,981,DcPPN5C8RAMXXghgp5xrJYytNsWJksWRQqhwRCv1LiuE,5RNFKEMCUQ2r7KxA4NeaWmrzHd8KBztEiBCQNfHhkLWi,True,433136,108283,671,335,336,3RdfgDvLvsdZG5Cf6hKiKMQMqfidyxHzjYvUx1FZpeHQ,26863,84058,-57195,620
2021-12-18 11:21:42.192168,2021-12-18 06:17:42-05:00,982,EMZFun8ihnRYniWmMGoaBgDLMYZPS5fHQ7ng3WitvhD9,8ximgKeaMQDFtxXexJzYsMm2pg7rK1hh5FNXqahLehXY,True,26397628,6599407,40834,20417,20417,4BnQKPLuE3DMTtxp8MjUBytgnhvxqq3ZTqZHTVZo4JJh,1633372,5533361,-3899989,618
2021-12-18 11:43:19.957308,2021-12-18 06:37:31-05:00,983,54rcQUxBXFfoNq8n9RxsxH1Lp4VHR2CfE71vCCVy6rPQ,4exavmUP5CfqEmqVusSNuW9Ha2rhPBAy2gg6rP2d5tvu,True,782046501,195511625,1221135,610567,610568,4BnQKPLuE3DMTtxp8MjUBytgnhvxqq3ZTqZHTVZo4JJh,48845428,135827203,-86981775,624
2021-12-18 12:12:13.853774,2021-12-18 07:02:24-05:00,984,EMZFun8ihnRYniWmMGoaBgDLMYZPS5fHQ7ng3WitvhD9,8ximgKeaMQDFtxXexJzYsMm2pg7rK1hh5FNXqahLehXY,True,20135051,5033762,31285,15642,15643,3RdfgDvLvsdZG5Cf6hKiKMQMqfidyxHzjYvUx1FZpeHQ,1251406,4513249,-3261843,621
2021-12-18 12:45:56.811171,2021-12-18 07:37:10-05:00,985,EMZFun8ihnRYniWmMGoaBgDLMYZPS5fHQ7ng3WitvhD9,8ximgKeaMQDFtxXexJzYsMm2pg7rK1hh5FNXqahLehXY,True,15360377,3840094,24025,12012,12013,4BnQKPLuE3DMTtxp8MjUBytgnhvxqq3ZTqZHTVZo4JJh,961033,3666522,-2705489,625
2021-12-18 12:45:56.811171,2021-12-18 07:39:25-05:00,986,D67X2HKszEB1VYeaHGsBo4uCzMTFSg8i3CabjeJmDUv7,422YiGvHrcXU1HQruML68rXqpaEcvvrVcZPnUNrfxdze,True,300203,75050,469,234,235,GmqQKnMfFxkv6ChqGaZ2wmSFDow7R1x7WeRfU58GVvfw,18786,71904,-53118,625
2021-12-18 13:40:20.521852,2021-12-18 08:32:20-05:00,987,EMZFun8ihnRYniWmMGoaBgDLMYZPS5fHQ7ng3WitvhD9,8ximgKeaMQDFtxXexJzYsMm2pg7rK1hh5FNXqahLehXY,True,11730196,2932549,18107,9053,9054,4BnQKPLuE3DMTtxp8MjUBytgnhvxqq3ZTqZHTVZo4JJh,724291,2963337,-2239046,617
2021-12-18 21:34:31.786671,2021-12-18 16:24:35-05:00,988,EMZFun8ihnRYniWmMGoaBgDLMYZPS5fHQ7ng3WitvhD9,8ximgKeaMQDFtxXexJzYsMm2pg7rK1hh5FNXqahLehXY,True,8936952,2234238,13884,6942,6942,4BnQKPLuE3DMTtxp8MjUBytgnhvxqq3ZTqZHTVZo4JJh,555383,2373983,-1818600,621
2021-12-18 22:25:56.462763,2021-12-18 17:19:00-05:00,989,D67X2HKszEB1VYeaHGsBo4uCzMTFSg8i3CabjeJmDUv7,422YiGvHrcXU1HQruML68rXqpaEcvvrVcZPnUNrfxdze,True,228838,57209,358,179,179,GmqQKnMfFxkv6ChqGaZ2wmSFDow7R1x7WeRfU58GVvfw,14325,57906,-43581,625
2021-12-19 08:21:02.920445,2021-12-19 03:08:59-05:00,990,EMZFun8ihnRYniWmMGoaBgDLMYZPS5fHQ7ng3WitvhD9,8ximgKeaMQDFtxXexJzYsMm2pg7rK1hh5FNXqahLehXY,True,6806921,1701730,10643,5321,5322,4BnQKPLuE3DMTtxp8MjUBytgnhvxqq3ZTqZHTVZo4JJh,425726,1893896,-1468170,625
2021-12-19 16:53:44.377127,2021-12-19 11:15:57-05:00,991,EMZFun8ihnRYniWmMGoaBgDLMYZPS5fHQ7ng3WitvhD9,8ximgKeaMQDFtxXexJzYsMm2pg7rK1hh5FNXqahLehXY,True,5204000,1301000,7734,3867,3867,4BnQKPLuE3DMTtxp8MjUBytgnhvxqq3ZTqZHTVZo4JJh,309379,1509324,-1199945,594
2021-12-19 20:19:27.075442,2021-12-19 15:08:36-05:00,992,GKNBtZbwK4w9hyXD1r38NTGcTJhpjt8R9WFCzdXup9Tk,7RLaL2XoFuqrcCcPEB6FzPJzLnAhjQpwcRmDfdpRXFgB,True,653877198,163469299,1004636,502318,502318,4BnQKPLuE3DMTtxp8MjUBytgnhvxqq3ZTqZHTVZo4JJh,40185456,187322508,-147137052,614
2021-12-19 22:19:41.635113,2021-12-19 17:14:29-05:00,993,EMZFun8ihnRYniWmMGoaBgDLMYZPS5fHQ7ng3WitvhD9,8ximgKeaMQDFtxXexJzYsMm2pg7rK1hh5FNXqahLehXY,True,3958062,989515,6080,3040,3040,3RdfgDvLvsdZG5Cf6hKiKMQMqfidyxHzjYvUx1FZpeHQ,243225,1198252,-955027,614
2021-12-19 22:34:43.126927,2021-12-19 17:29:46-05:00,994,EMZFun8ihnRYniWmMGoaBgDLMYZPS5fHQ7ng3WitvhD9,8ximgKeaMQDFtxXexJzYsMm2pg7rK1hh5FNXqahLehXY,True,3029401,757350,4407,2203,2204,4BnQKPLuE3DMTtxp8MjUBytgnhvxqq3ZTqZHTVZo4JJh,176291,953416,-777125,581
2021-12-20 01:47:33.797445,2021-12-19 20:13:20-05:00,995,EMZFun8ihnRYniWmMGoaBgDLMYZPS5fHQ7ng3WitvhD9,8ximgKeaMQDFtxXexJzYsMm2pg7rK1hh5FNXqahLehXY,True,2302683,575670,3508,1754,1754,4BnQKPLuE3DMTtxp8MjUBytgnhvxqq3ZTqZHTVZo4JJh,140336,753818,-613482,609
2021-12-20 03:52:48.025286,2021-12-19 22:48:11-05:00,996,EMZFun8ihnRYniWmMGoaBgDLMYZPS5fHQ7ng3WitvhD9,8ximgKeaMQDFtxXexJzYsMm2pg7rK1hh5FNXqahLehXY,True,1754236,438559,2726,1363,1363,GmqQKnMfFxkv6ChqGaZ2wmSFDow7R1x7WeRfU58GVvfw,109075,596410,-487335,621
2021-12-20 09:32:42.498481,2021-12-20 04:16:26-05:00,997,4gzW9gBbEMnNm1epY6MMJ1XfxGMtvn2mKFyKPQ2Gyb79,G6x862hmMJ2PLpyyPDwVPGapXjvEeNkqFRTAS3jWVozB,True,155936807,38984201,242089,121044,121045,4BnQKPLuE3DMTtxp8MjUBytgnhvxqq3ZTqZHTVZo4JJh,9683571,46108558,-36424987,620
2021-12-20 09:32:42.498481,2021-12-20 04:16:28-05:00,998,BhiAaiZu7fF8ndggJrLyiFVCRq526cNBw7VaeascEmNL,4en8MipPi7vq15NGhpPMQfptNdEyhp2j7fpgxBBtjyfz,True,31254867,7813716,48368,24184,24184,GmqQKnMfFxkv6ChqGaZ2wmSFDow7R1x7WeRfU58GVvfw,1934729,6509198,-4574469,619
2021-12-20 09:32:42.498481,2021-12-20 04:16:33-05:00,999,2YcB3QQGWho5oogDd1nK3cpLQzwwwXGxybrhe2xDkDxq,5DjAUp6CxKStYTaXSnzjvYkfqCXfG8Y61bWw5UwbbE3q,True,102385049,25596262,160048,80024,80024,GmqQKnMfFxkv6ChqGaZ2wmSFDow7R1x7WeRfU58GVvfw,6401958,30006975,-23605017,625
2021-12-20 09:45:06.679606,2021-12-20 04:38:12-05:00,1000,DGbj8tnqECzM9FG8j225Ap7A4Fdm3J1Ksm32JBFG7igv,Cd3D2UVwoSZLygM2e3UQppQANsokpmx5CNBs1C5zueay,True,33061899,8265474,51642,25821,25821,GmqQKnMfFxkv6ChqGaZ2wmSFDow7R1x7WeRfU58GVvfw,2065697,6923266,-4857569,624
2021-12-20 10:12:54.191497,2021-12-20 05:00:41-05:00,1001,G25vsB3sDqRhHoSK4KwR1TywfrJDtpejVbbevEG9sQ9a,5xFC3Hm13magnAA9GD1EnwC9PrPoEfQ7omEa9p9zCrB1,True,44305116,11076278,69321,34660,34661,GmqQKnMfFxkv6ChqGaZ2wmSFDow7R1x7WeRfU58GVvfw,2772858,9046878,-6274020,625
2021-12-20 10:12:54.191497,2021-12-20 05:07:04-05:00,1002,J1sBDjpdBZcsSBS5eg95SSRjRqmQUR9cXJCsLJu8yCUt,F5wRpD2senMkGbL8Uquqo8W9x5NQDDa268dHuVFAZCww,True,69071535,17267883,106940,53470,53470,GmqQKnMfFxkv6ChqGaZ2wmSFDow7R1x7WeRfU58GVvfw,4277607,20595225,-16317618,619
2021-12-20 11:12:45.907912,2021-12-20 06:06:34-05:00,1003,BgoKAyBNaJ1geeQ2FcGSHEQDWATVD3w3wmcNHtj8Awu3,8Haz7duE2ycueaJsGdrGNnK79KGHwnzKBpoafC8RZGg2,True,537734691,134433672,840462,420231,420231,GmqQKnMfFxkv6ChqGaZ2wmSFDow7R1x7WeRfU58GVvfw,33618494,163410339,-129791845,625
2021-12-20 13:02:45.016639,2021-12-20 07:49:00-05:00,1004,DH2tcZVt4nHQbph6znZRrwcyhjwiNYtgeamu72vcC6nR,ACsbP5BDFQEHQHTsdrWTBShhEUh9HeAKsE7iwyK72v2p,True,18021133,4505283,27935,13967,13968,GmqQKnMfFxkv6ChqGaZ2wmSFDow7R1x7WeRfU58GVvfw,1117435,5559986,-4442551,620
2021-12-20 13:02:45.016639,2021-12-20 07:49:00-05:00,1005,3qyKG4juvhcDnhoSVAFibqJtk5i4q8vLVgvwzXtdk5KP,2ofR6Hdm8qgQfKnaNFouzzBs311xgPcxny4ViS7g2Wxo,True,15121834,3780458,23426,11713,11713,GmqQKnMfFxkv6ChqGaZ2wmSFDow7R1x7WeRfU58GVvfw,937066,4538620,-3601554,619
2021-12-20 13:02:45.016639,2021-12-20 07:54:09-05:00,1006,7PzGZgzieFyyFs1dbajkNQgVxooFUNZrj1bUsQvrSwbp,A2gDREmSmJTBPPw3sbKVY3smC9wbHMDdv87gr4Tr2ES7,True,84875557,21218889,131623,65811,65812,GmqQKnMfFxkv6ChqGaZ2wmSFDow7R1x7WeRfU58GVvfw,5264946,23800390,-18535444,620
2021-12-20 14:08:24.856884,2021-12-20 08:59:55-05:00,1007,gMjmD7WioyUdQdwNqE5fobLcxPwoJv5rAvLmJaf8Jjw,5n77euFjVJiwKrnbYq1KpcENW1mzBZj2BuDGyzazrkJ8,True,32748433,8187107,51072,25536,25536,GmqQKnMfFxkv6ChqGaZ2wmSFDow7R1x7WeRfU58GVvfw,2042892,7142309,-5099417,623
2021-12-20 14:24:54.335594,2021-12-20 09:23:36-05:00,1008,6woJkgUd2cpQQQBEp1C2G9NsYAvPwYmZXXTd6AxhieMy,E6xCdLJbDq5qFsvHEffD1Qfqrsj19H81mbj7XMUXUPnr,True,372815742,93203935,583048,291524,291524,GmqQKnMfFxkv6ChqGaZ2wmSFDow7R1x7WeRfU58GVvfw,23321950,113248033,-89926083,625
2021-12-20 19:22:37.963694,2021-12-20 14:15:56-05:00,1009,D67X2HKszEB1VYeaHGsBo4uCzMTFSg8i3CabjeJmDUv7,422YiGvHrcXU1HQruML68rXqpaEcvvrVcZPnUNrfxdze,True,174394,43598,269,134,135,GmqQKnMfFxkv6ChqGaZ2wmSFDow7R1x7WeRfU58GVvfw,10760,46235,-35475,616
2021-12-20 19:28:56.972921,2021-12-20 14:23:55-05:00,1010,HwMdPKabtCSiMZPhXGZjxMKg7RVwxfHSJGt6FW6XKKN5,4Wuu74hfqpRHY6sB55hzSgqEkK4G6oYXZv4ZA21LUckA,True,54025501754,13506375438,84278274,42139137,42139137,GmqQKnMfFxkv6ChqGaZ2wmSFDow7R1x7WeRfU58GVvfw,3371130984,20114458394,-16743327410,623
2021-12-20 21:14:54.876872,2021-12-20 16:07:30-05:00,1011,4nqsW3XCJxzSsDdQzvE3zeM9nqBv8xVdUG8GxFWn6Edf,6eVvNs2rckFeTGkXZgPEGLYg4rmz3MFtoVNPRNmktcrY,True,1197326015,299331503,1867462,933731,933731,4BnQKPLuE3DMTtxp8MjUBytgnhvxqq3ZTqZHTVZo4JJh,74698487,210172864,-135474377,623
2021-12-21 00:21:08.908153,2021-12-20 18:57:54-05:00,1012,EMZFun8ihnRYniWmMGoaBgDLMYZPS5fHQ7ng3WitvhD9,8ximgKeaMQDFtxXexJzYsMm2pg7rK1hh5FNXqahLehXY,True,1335767,333941,2089,1044,1045,3RdfgDvLvsdZG5Cf6hKiKMQMqfidyxHzjYvUx1FZpeHQ,83582,469182,-385600,625
2021-12-21 01:39:18.470396,2021-12-20 20:24:16-05:00,1013,26oxTRpmELK2gTLz4xhCnZ4W3XQYRhQUNgL8A7unUe9n,3GjuSNzYtMLHwU2oeSHbcoHc2KcBUYaFGxaZDrRqD11U,False,2339,2339,0,0,0,GmqQKnMfFxkv6ChqGaZ2wmSFDow7R1x7WeRfU58GVvfw,0,1348,-2041,0
2021-12-21 02:25:18.291914,2021-12-20 20:39:33-05:00,1014,EwQ6s4yy5Dxgf4kYzzX7PSdKuBbAYXY9DQ3GBuBRKVHm,9UK4GrWJSWYeN2rVkN4srqXszn2UgKKs6yE9rZmDQqU4,False,2573,2573,0,0,0,3RdfgDvLvsdZG5Cf6hKiKMQMqfidyxHzjYvUx1FZpeHQ,0,1212,-2334,0
2021-12-21 03:36:29.648415,2021-12-20 22:34:44-05:00,1015,HwMdPKabtCSiMZPhXGZjxMKg7RVwxfHSJGt6FW6XKKN5,4Wuu74hfqpRHY6sB55hzSgqEkK4G6oYXZv4ZA21LUckA,True,41181997779,10295499444,64305024,32152512,32152512,4BnQKPLuE3DMTtxp8MjUBytgnhvxqq3ZTqZHTVZo4JJh,2572200969,15823553106,-13251352137,624
2021-12-21 03:36:29.648415,2021-12-20 22:34:45-05:00,1016,D67X2HKszEB1VYeaHGsBo4uCzMTFSg8i3CabjeJmDUv7,422YiGvHrcXU1HQruML68rXqpaEcvvrVcZPnUNrfxdze,True,133143,33285,200,100,100,3RdfgDvLvsdZG5Cf6hKiKMQMqfidyxHzjYvUx1FZpeHQ,8034,37048,-29014,603
2021-12-21 03:53:42.645582,2021-12-20 22:52:14-05:00,1017,EMZFun8ihnRYniWmMGoaBgDLMYZPS5fHQ7ng3WitvhD9,8ximgKeaMQDFtxXexJzYsMm2pg7rK1hh5FNXqahLehXY,True,1018869,254717,1594,797,797,3RdfgDvLvsdZG5Cf6hKiKMQMqfidyxHzjYvUx1FZpeHQ,63765,370016,-306251,625
2021-12-21 04:47:09.832427,2021-12-20 23:26:13-05:00,1018,D67X2HKszEB1VYeaHGsBo4uCzMTFSg8i3CabjeJmDUv7,422YiGvHrcXU1HQruML68rXqpaEcvvrVcZPnUNrfxdze,True,101387,25345,157,78,79,3RdfgDvLvsdZG5Cf6hKiKMQMqfidyxHzjYvUx1FZpeHQ,6296,29645,-23349,620
2021-12-21 04:47:09.832427,2021-12-20 23:26:14-05:00,1019,4nqsW3XCJxzSsDdQzvE3zeM9nqBv8xVdUG8GxFWn6Edf,6eVvNs2rckFeTGkXZgPEGLYg4rmz3MFtoVNPRNmktcrY,True,914891971,228722992,1380827,690413,690414,3RdfgDvLvsdZG5Cf6hKiKMQMqfidyxHzjYvUx1FZpeHQ,55233113,173772352,-118539239,603
2021-12-21 04:47:09.832427,2021-12-20 23:27:04-05:00,1020,54rcQUxBXFfoNq8n9RxsxH1Lp4VHR2CfE71vCCVy6rPQ,4exavmUP5CfqEmqVusSNuW9Ha2rhPBAy2gg6rP2d5tvu,True,594339889,148584972,916595,458297,458298,3RdfgDvLvsdZG5Cf6hKiKMQMqfidyxHzjYvUx1FZpeHQ,36663810,109720486,-73056676,616
2021-12-21 05:18:48.712579,2021-12-21 00:11:11-05:00,1021,DcPPN5C8RAMXXghgp5xrJYytNsWJksWRQqhwRCv1LiuE,5RNFKEMCUQ2r7KxA4NeaWmrzHd8KBztEiBCQNfHhkLWi,True,327547,81886,511,255,256,3RdfgDvLvsdZG5Cf6hKiKMQMqfidyxHzjYvUx1FZpeHQ,20478,68165,-47687,625
2021-12-21 05:18:48.712579,2021-12-21 00:11:42-05:00,1022,FMdKLXhQEnNJtvM17ZX8jhaeMaSD9UgDuN3Kw7kMrd7K,5pURHYWB5LUGwJmWVBGH8p6oyR9NJvXnZk7uDVoiassv,True,887951897,221987974,1385349,692674,692675,3RdfgDvLvsdZG5Cf6hKiKMQMqfidyxHzjYvUx1FZpeHQ,55413979,155112568,-99698589,624
2021-12-21 08:24:51.583770,2021-12-21 03:24:10-05:00,1023,4nqsW3XCJxzSsDdQzvE3zeM9nqBv8xVdUG8GxFWn6Edf,6eVvNs2rckFeTGkXZgPEGLYg4rmz3MFtoVNPRNmktcrY,True,696265567,174066391,1085898,542949,542949,3RdfgDvLvsdZG5Cf6hKiKMQMqfidyxHzjYvUx1FZpeHQ,43435935,142457388,-99021453,623
2021-12-21 12:54:30.571233,2021-12-21 07:30:51-05:00,1024,54rcQUxBXFfoNq8n9RxsxH1Lp4VHR2CfE71vCCVy6rPQ,4exavmUP5CfqEmqVusSNuW9Ha2rhPBAy2gg6rP2d5tvu,True,452915293,113228823,704459,352229,352230,DddJ7EWCmYEEZETCBNgAUSg81Ls6fZtiAaY5ekJ5sXx1,28178399,90139966,-61961567,622
2021-12-21 12:54:30.571233,2021-12-21 07:35:02-05:00,1025,D67X2HKszEB1VYeaHGsBo4uCzMTFSg8i3CabjeJmDUv7,422YiGvHrcXU1HQruML68rXqpaEcvvrVcZPnUNrfxdze,True,77346,19336,119,59,60,3RdfgDvLvsdZG5Cf6hKiKMQMqfidyxHzjYvUx1FZpeHQ,4773,23658,-18885,617
2021-12-21 12:54:30.571233,2021-12-21 07:35:13-05:00,1026,FMdKLXhQEnNJtvM17ZX8jhaeMaSD9UgDuN3Kw7kMrd7K,5pURHYWB5LUGwJmWVBGH8p6oyR9NJvXnZk7uDVoiassv,True,677130420,169282605,1058430,529215,529215,3RdfgDvLvsdZG5Cf6hKiKMQMqfidyxHzjYvUx1FZpeHQ,42337239,128297277,-85960038,625
2021-12-21 14:36:00.251103,2021-12-21 09:32:21-05:00,1027,EMZFun8ihnRYniWmMGoaBgDLMYZPS5fHQ7ng3WitvhD9,8ximgKeaMQDFtxXexJzYsMm2pg7rK1hh5FNXqahLehXY,True,776651,194162,1211,605,606,3RdfgDvLvsdZG5Cf6hKiKMQMqfidyxHzjYvUx1FZpeHQ,48448,290642,-242194,623
2021-12-21 16:28:13.808691,2021-12-21 11:11:32-05:00,1028,EMZFun8ihnRYniWmMGoaBgDLMYZPS5fHQ7ng3WitvhD9,8ximgKeaMQDFtxXexJzYsMm2pg7rK1hh5FNXqahLehXY,True,596234,149058,832,416,416,3RdfgDvLvsdZG5Cf6hKiKMQMqfidyxHzjYvUx1FZpeHQ,33295,228693,-195398,558
2021-12-21 17:46:10.947265,2021-12-21 12:07:31-05:00,1029,295KMTb2Dr2C2Jgi1f87vCKJzcbQMfsEMCNBTWPLRq4z,87zqKXpTuuHtazyBZeUvs9e57FQh8Y4TsqfVeY4E9Zaw,False,546656841,546656841,0,0,0,3RdfgDvLvsdZG5Cf6hKiKMQMqfidyxHzjYvUx1FZpeHQ,0,87079993,-99559373,0
2021-12-21 17:46:10.947265,2021-12-21 12:07:31-05:00,1030,3eFGWZubje93NCB8ug6VNYtn3Nq7c5XHAJJJEX2RZ2Zk,7s3WQgCRPyfCj2D4FLmgosPJMFhJVzFpStGZE541YfmP,False,582932330,582932330,5142175,257108,4885067,3RdfgDvLvsdZG5Cf6hKiKMQMqfidyxHzjYvUx1FZpeHQ,5142175,96206768,-91064593,88
2021-12-21 17:46:10.947265,2021-12-21 12:07:31-05:00,1031,D67X2HKszEB1VYeaHGsBo4uCzMTFSg8i3CabjeJmDUv7,422YiGvHrcXU1HQruML68rXqpaEcvvrVcZPnUNrfxdze,False,60440,60440,2194,109,2085,3RdfgDvLvsdZG5Cf6hKiKMQMqfidyxHzjYvUx1FZpeHQ,2194,18818,-16624,363
2021-12-21 17:46:10.947265,2021-12-21 12:07:32-05:00,1032,EMZFun8ihnRYniWmMGoaBgDLMYZPS5fHQ7ng3WitvhD9,8ximgKeaMQDFtxXexJzYsMm2pg7rK1hh5FNXqahLehXY,False,493653,493653,0,0,0,3RdfgDvLvsdZG5Cf6hKiKMQMqfidyxHzjYvUx1FZpeHQ,0,178933,-193030,0
2021-12-21 17:46:10.947265,2021-12-21 12:07:39-05:00,1033,2egmzVnVsmHDmS72VzQthAwUYy6EqyvoXpQPqnWZCCk6,EU7N78R4MGV9MjJKkvViMyKYXwhSNnZjePmbg6hTooeE,False,13015777,13015777,620680,31034,589646,GmqQKnMfFxkv6ChqGaZ2wmSFDow7R1x7WeRfU58GVvfw,620680,2250872,-1630192,476
2021-12-21 22:10:38.111442,2021-12-21 16:59:31-05:00,1034,4nqsW3XCJxzSsDdQzvE3zeM9nqBv8xVdUG8GxFWn6Edf,6eVvNs2rckFeTGkXZgPEGLYg4rmz3MFtoVNPRNmktcrY,True,530858265,132714566,826662,413331,413331,3RdfgDvLvsdZG5Cf6hKiKMQMqfidyxHzjYvUx1FZpeHQ,33066499,116003266,-82936767,622
2021-12-21 22:10:38.111442,2021-12-21 17:02:07-05:00,1035,54rcQUxBXFfoNq8n9RxsxH1Lp4VHR2CfE71vCCVy6rPQ,4exavmUP5CfqEmqVusSNuW9Ha2rhPBAy2gg6rP2d5tvu,True,345513872,86378468,534017,267008,267009,3RdfgDvLvsdZG5Cf6hKiKMQMqfidyxHzjYvUx1FZpeHQ,21360714,73664227,-52303513,618
2021-12-21 22:39:30.683921,2021-12-21 17:33:29-05:00,1036,FMdKLXhQEnNJtvM17ZX8jhaeMaSD9UgDuN3Kw7kMrd7K,5pURHYWB5LUGwJmWVBGH8p6oyR9NJvXnZk7uDVoiassv,True,516806604,129201651,797336,398668,398668,3RdfgDvLvsdZG5Cf6hKiKMQMqfidyxHzjYvUx1FZpeHQ,31893444,105333380,-73439936,617
2021-12-21 22:39:30.683921,2021-12-21 17:33:29-05:00,1037,DcPPN5C8RAMXXghgp5xrJYytNsWJksWRQqhwRCv1LiuE,5RNFKEMCUQ2r7KxA4NeaWmrzHd8KBztEiBCQNfHhkLWi,True,252974,63242,392,196,196,3RdfgDvLvsdZG5Cf6hKiKMQMqfidyxHzjYvUx1FZpeHQ,15680,56166,-40486,619
2021-12-21 23:31:10.047679,2021-12-21 18:29:15-05:00,1038,4nqsW3XCJxzSsDdQzvE3zeM9nqBv8xVdUG8GxFWn6Edf,6eVvNs2rckFeTGkXZgPEGLYg4rmz3MFtoVNPRNmktcrY,True,405123033,101280758,629284,314642,314642,3RdfgDvLvsdZG5Cf6hKiKMQMqfidyxHzjYvUx1FZpeHQ,25171369,94359847,-69188478,621
2021-12-22 00:16:54.803962,2021-12-21 19:03:25-05:00,1039,54rcQUxBXFfoNq8n9RxsxH1Lp4VHR2CfE71vCCVy6rPQ,4exavmUP5CfqEmqVusSNuW9Ha2rhPBAy2gg6rP2d5tvu,True,263440747,65860186,411311,205655,205656,3RdfgDvLvsdZG5Cf6hKiKMQMqfidyxHzjYvUx1FZpeHQ,16452450,59988235,-43535785,624
2021-12-22 00:16:54.803962,2021-12-21 19:05:31-05:00,1040,DcPPN5C8RAMXXghgp5xrJYytNsWJksWRQqhwRCv1LiuE,5RNFKEMCUQ2r7KxA4NeaWmrzHd8KBztEiBCQNfHhkLWi,True,190577,47643,297,148,149,3RdfgDvLvsdZG5Cf6hKiKMQMqfidyxHzjYvUx1FZpeHQ,11905,45898,-33993,624
2021-12-22 00:16:54.803962,2021-12-21 19:05:31-05:00,1041,FMdKLXhQEnNJtvM17ZX8jhaeMaSD9UgDuN3Kw7kMrd7K,5pURHYWB5LUGwJmWVBGH8p6oyR9NJvXnZk7uDVoiassv,True,394171372,98542843,610671,305335,305336,3RdfgDvLvsdZG5Cf6hKiKMQMqfidyxHzjYvUx1FZpeHQ,24426854,86079536,-61652682,619
2021-12-22 02:25:13.094166,2021-12-21 20:59:54-05:00,1042,4nqsW3XCJxzSsDdQzvE3zeM9nqBv8xVdUG8GxFWn6Edf,6eVvNs2rckFeTGkXZgPEGLYg4rmz3MFtoVNPRNmktcrY,True,308971888,77242972,483302,241651,241651,3RdfgDvLvsdZG5Cf6hKiKMQMqfidyxHzjYvUx1FZpeHQ,19332107,76356814,-57024707,625
2021-12-22 02:25:13.094166,2021-12-21 21:12:13-05:00,1043,54rcQUxBXFfoNq8n9RxsxH1Lp4VHR2CfE71vCCVy6rPQ,4exavmUP5CfqEmqVusSNuW9Ha2rhPBAy2gg6rP2d5tvu,True,201047023,50261755,313002,156501,156501,3RdfgDvLvsdZG5Cf6hKiKMQMqfidyxHzjYvUx1FZpeHQ,12520108,48640002,-36119894,622
2021-12-22 02:25:13.094166,2021-12-21 21:13:26-05:00,1044,FMdKLXhQEnNJtvM17ZX8jhaeMaSD9UgDuN3Kw7kMrd7K,5pURHYWB5LUGwJmWVBGH8p6oyR9NJvXnZk7uDVoiassv,True,300557678,75139419,470139,235069,235070,3RdfgDvLvsdZG5Cf6hKiKMQMqfidyxHzjYvUx1FZpeHQ,18805593,69977843,-51172250,625
2021-12-23 18:34:32.117767,2021-12-23 13:21:45-05:00,1045,F9HRMjUNMmiSdUYrXrV1eUGHpm5x1fFc7Ef5JXdThUub,GKhiMaAWFaUyUAyWyzStHAWqcEfN1EPgVJ9rJ1cyktL,True,2507008,626752,3895,1947,1948,GmqQKnMfFxkv6ChqGaZ2wmSFDow7R1x7WeRfU58GVvfw,155830,553747,-397917,621
2021-12-23 19:46:49.020295,2021-12-23 14:45:35-05:00,1046,2pj53AmKNnmDG66nDGaeYP867KkVJnDp7GPHvszdBtcB,8iNqdeuaegF3ab9R2RWgE5f5Xm5AXyayGM5ks5pUzbUN,True,4538630,1134657,7095,3547,3548,3RdfgDvLvsdZG5Cf6hKiKMQMqfidyxHzjYvUx1FZpeHQ,283825,830609,-546784,625
2021-12-24 04:02:47.111648,2021-12-23 22:56:56-05:00,1047,25NUDrsdLhS3fcARLiTMbbmZHvvzvzPj9xAdoN8sJBN3,8baNRGHfYRcLdhbHNuH72ofAWM9UojqhTMLnbBayzGnW,True,98846428,24711607,151832,75916,75916,4BnQKPLuE3DMTtxp8MjUBytgnhvxqq3ZTqZHTVZo4JJh,6073319,17182679,-11109360,614
2021-12-24 06:42:39.417534,2021-12-24 01:25:48-05:00,1048,H2M1vELLnRSEATaqtbnWGJZGofwPqYoM5z8TwVxziZv,7oZc5aBcr1mFgMhWqAvSHQ7JXWKu3n5syNtQZ6Sq1w4K,True,479445737,119861434,740571,370285,370286,3RdfgDvLvsdZG5Cf6hKiKMQMqfidyxHzjYvUx1FZpeHQ,29622850,158452157,-128829307,617
2021-12-24 15:57:00.352917,2021-12-24 10:51:15-05:00,1049,F9HRMjUNMmiSdUYrXrV1eUGHpm5x1fFc7Ef5JXdThUub,GKhiMaAWFaUyUAyWyzStHAWqcEfN1EPgVJ9rJ1cyktL,True,1912073,478018,2980,1490,1490,3RdfgDvLvsdZG5Cf6hKiKMQMqfidyxHzjYvUx1FZpeHQ,119203,449499,-330296,623
2021-12-24 16:14:05.105420,2021-12-24 10:58:26-05:00,1050,7SBSVWCWENfJpg3Rd61kHjvj7rf5RchHeWChE42jdfk2,GNgZk4pw4cyetbovfqLtjdD5eEJTvJmrNbk572XnBeeN,True,24570832,6142708,38439,19219,19220,3RdfgDvLvsdZG5Cf6hKiKMQMqfidyxHzjYvUx1FZpeHQ,1537566,4372481,-2834915,625
2021-12-24 16:14:05.105420,2021-12-24 11:06:25-05:00,1051,2pj53AmKNnmDG66nDGaeYP867KkVJnDp7GPHvszdBtcB,8iNqdeuaegF3ab9R2RWgE5f5Xm5AXyayGM5ks5pUzbUN,True,3464331,866082,5369,2684,2685,3RdfgDvLvsdZG5Cf6hKiKMQMqfidyxHzjYvUx1FZpeHQ,214765,685232,-470467,619
2021-12-24 16:14:05.105420,2021-12-24 11:11:24-05:00,1052,ENbudKxrT5FBwUCzE2sTKn4KtfQQRvfzLw9cJfY8uQpF,4nYt3hxFo9aRJ4CSzb2aBoMGn5bcoEKkPXT1J4e8ywg1,True,92327431,23081857,142304,71152,71152,3RdfgDvLvsdZG5Cf6hKiKMQMqfidyxHzjYvUx1FZpeHQ,5692182,16485618,-10793436,616
2021-12-24 16:14:05.105420,2021-12-24 11:11:24-05:00,1053,7SBSVWCWENfJpg3Rd61kHjvj7rf5RchHeWChE42jdfk2,GNgZk4pw4cyetbovfqLtjdD5eEJTvJmrNbk572XnBeeN,True,18868067,4717016,26449,13224,13225,4BnQKPLuE3DMTtxp8MjUBytgnhvxqq3ZTqZHTVZo4JJh,1057981,3624147,-2566166,560
2021-12-24 16:14:05.105420,2021-12-24 11:11:26-05:00,1054,F9HRMjUNMmiSdUYrXrV1eUGHpm5x1fFc7Ef5JXdThUub,GKhiMaAWFaUyUAyWyzStHAWqcEfN1EPgVJ9rJ1cyktL,True,1475288,368822,1872,936,936,3RdfgDvLvsdZG5Cf6hKiKMQMqfidyxHzjYvUx1FZpeHQ,74896,363878,-288982,507
2021-12-24 16:14:05.105420,2021-12-24 11:11:26-05:00,1055,6ufi649W3L5k4Qssan4wSCg1JLcKcWkNCqtG1idP4hge,HxSjdnkeYChdEPFsC4uUs2YTUJsQUQWRUAusz7r12dcr,True,268862358,67215589,416041,208020,208021,4BnQKPLuE3DMTtxp8MjUBytgnhvxqq3ZTqZHTVZo4JJh,16641664,47869489,-31227825,618
2021-12-24 16:14:05.105420,2021-12-24 11:11:26-05:00,1056,2pj53AmKNnmDG66nDGaeYP867KkVJnDp7GPHvszdBtcB,8iNqdeuaegF3ab9R2RWgE5f5Xm5AXyayGM5ks5pUzbUN,True,2647612,661903,4000,2000,2000,4BnQKPLuE3DMTtxp8MjUBytgnhvxqq3ZTqZHTVZo4JJh,160033,562293,-402260,604
2021-12-25 19:09:35.353887,2021-12-25 14:00:55-05:00,1057,9yvyis25xBcKBXegVT7tNY6wo7JMv1dto2UqZsV9B2wp,Cjvjrroo59m4SUhBtMqK7oX14vc1h8i9q1GuveSi3zwE,True,16610,4152,23,11,12,GmqQKnMfFxkv6ChqGaZ2wmSFDow7R1x7WeRfU58GVvfw,946,5903,-4957,569
2021-12-26 01:49:23.348896,2021-12-25 19:50:36-05:00,1058,9yvyis25xBcKBXegVT7tNY6wo7JMv1dto2UqZsV9B2wp,Cjvjrroo59m4SUhBtMqK7oX14vc1h8i9q1GuveSi3zwE,True,12633,3158,18,9,9,3RdfgDvLvsdZG5Cf6hKiKMQMqfidyxHzjYvUx1FZpeHQ,750,3187,-2437,593
2021-12-26 17:01:31.731028,2021-12-26 11:40:33-05:00,1059,F9HRMjUNMmiSdUYrXrV1eUGHpm5x1fFc7Ef5JXdThUub,GKhiMaAWFaUyUAyWyzStHAWqcEfN1EPgVJ9rJ1cyktL,True,1110560,277640,1735,867,868,3RdfgDvLvsdZG5Cf6hKiKMQMqfidyxHzjYvUx1FZpeHQ,69400,290263,-220863,624
2021-12-27 02:22:31.057844,2021-12-26 20:45:00-05:00,1060,H2M1vELLnRSEATaqtbnWGJZGofwPqYoM5z8TwVxziZv,7oZc5aBcr1mFgMhWqAvSHQ7JXWKu3n5syNtQZ6Sq1w4K,True,363705392,90926348,558141,279070,279071,4BnQKPLuE3DMTtxp8MjUBytgnhvxqq3ZTqZHTVZo4JJh,22325658,123073132,-100747474,613
2021-12-27 02:22:31.057844,2021-12-26 20:47:35-05:00,1061,H2M1vELLnRSEATaqtbnWGJZGofwPqYoM5z8TwVxziZv,7oZc5aBcr1mFgMhWqAvSHQ7JXWKu3n5syNtQZ6Sq1w4K,True,277717213,69429303,420733,210366,210367,DddJ7EWCmYEEZETCBNgAUSg81Ls6fZtiAaY5ekJ5sXx1,16829348,97330574,-80501226,605
2021-12-27 04:29:24.849852,2021-12-26 22:59:42-05:00,1062,8USqxUyR8myKafnNybrE9Aj1K3982TQY1KkXccnNt3ZC,4q9X67SCKqaGXmJ9Fv77aUkjSQ7hJ8BaRs3FRLscNKQh,True,470925909,117731477,722841,361420,361421,3RdfgDvLvsdZG5Cf6hKiKMQMqfidyxHzjYvUx1FZpeHQ,28913652,100721338,-71807686,613
2021-12-27 04:29:24.849852,2021-12-26 22:59:43-05:00,1063,HYJJ5UhaX5frSVKX72D4wBep5SGKyRt1WRgoKb5oDqCF,GZa5zNdRdSA2uXnHUe7GzYAjUxxfXZkMzdyK9NERRDwQ,True,10105002,2526250,15634,7817,7817,3RdfgDvLvsdZG5Cf6hKiKMQMqfidyxHzjYvUx1FZpeHQ,625380,1805722,-1180342,618
2021-12-27 04:29:24.849852,2021-12-26 22:59:43-05:00,1064,3EkaWW2WfpdRsgX7KF2DxjW4DA5qyvHMRtUNrea7c5Bk,B9JxYbj471pp49bkZic3LWfWFVT75oJd3UzMcysYitdg,True,30640665,7660166,47511,23755,23756,4BnQKPLuE3DMTtxp8MjUBytgnhvxqq3ZTqZHTVZo4JJh,1900452,5395549,-3495097,620
2021-12-27 04:29:24.849852,2021-12-26 23:00:41-05:00,1065,7SBSVWCWENfJpg3Rd61kHjvj7rf5RchHeWChE42jdfk2,GNgZk4pw4cyetbovfqLtjdD5eEJTvJmrNbk572XnBeeN,True,14288496,3572124,22293,11146,11147,3RdfgDvLvsdZG5Cf6hKiKMQMqfidyxHzjYvUx1FZpeHQ,891744,2953863,-2062119,624
2021-12-27 04:29:24.849852,2021-12-26 23:00:51-05:00,1066,AasuXaniF7YC82s3Kvf6ANwnDtc5Ho1uDR14aKHDzN8Y,BpWNMCz2w5hLKvNm5Wo6ZHQ4DFEvmwwDzB2LQWs1br5A,True,2100637,525159,3252,1626,1626,3RdfgDvLvsdZG5Cf6hKiKMQMqfidyxHzjYvUx1FZpeHQ,130101,376370,-246269,619
2021-12-27 13:49:18.874476,2021-12-27 08:07:38-05:00,1067,4JA7B9i39w9drzVXZnibT4J73hSFgsm8ASbv2rTFYcYx,5dDX5YGxbuxz9ZUJYsdaGXqjcwVaAgn7b8ynuKEM92rZ,True,10541553,2635388,16495,8247,8248,3RdfgDvLvsdZG5Cf6hKiKMQMqfidyxHzjYvUx1FZpeHQ,659810,1884791,-1224981,625
2021-12-27 13:49:18.874476,2021-12-27 08:30:48-05:00,1068,92cQnCMBkPL8DmE4xYQXJVAQ8EXk3moXXVHaM2zQT4uj,A5MAQitMT3yojsCtjyq9pypZQP9Df6m95X5srsEXaxr6,True,13115650857,3278912714,20371973,10185986,10185987,3RdfgDvLvsdZG5Cf6hKiKMQMqfidyxHzjYvUx1FZpeHQ,814878952,3930529809,-3115650857,621
2021-12-27 13:56:20.231267,2021-12-27 08:51:05-05:00,1069,2pj53AmKNnmDG66nDGaeYP867KkVJnDp7GPHvszdBtcB,8iNqdeuaegF3ab9R2RWgE5f5Xm5AXyayGM5ks5pUzbUN,True,2015011,503752,3151,1575,1576,3RdfgDvLvsdZG5Cf6hKiKMQMqfidyxHzjYvUx1FZpeHQ,126046,457089,-331043,625
2021-12-27 13:56:20.231267,2021-12-27 08:54:45-05:00,1070,AGAzeNR1sJF4Crm8TqciuByU1vRXcC7xJjogsoaRG6CS,vkqKpHqtCH7qDvhCZe7iuE7RGbQumfkcvj9BMVLKw25,False,5448710,5448710,265917,13295,252622,3RdfgDvLvsdZG5Cf6hKiKMQMqfidyxHzjYvUx1FZpeHQ,265917,1026570,-760653,488
2021-12-27 13:56:20.231267,2021-12-27 08:54:45-05:00,1071,6ufi649W3L5k4Qssan4wSCg1JLcKcWkNCqtG1idP4hge,HxSjdnkeYChdEPFsC4uUs2YTUJsQUQWRUAusz7r12dcr,True,205190526,51297631,315306,157653,157653,3RdfgDvLvsdZG5Cf6hKiKMQMqfidyxHzjYvUx1FZpeHQ,12612264,39577902,-26965638,614
2021-12-27 13:56:20.231267,2021-12-27 08:54:48-05:00,1072,ENbudKxrT5FBwUCzE2sTKn4KtfQQRvfzLw9cJfY8uQpF,4nYt3hxFo9aRJ4CSzb2aBoMGn5bcoEKkPXT1J4e8ywg1,True,70380582,17595145,109774,54887,54887,3RdfgDvLvsdZG5Cf6hKiKMQMqfidyxHzjYvUx1FZpeHQ,4390997,13621206,-9230209,623
2021-12-27 13:56:20.231267,2021-12-27 08:54:48-05:00,1073,9yvyis25xBcKBXegVT7tNY6wo7JMv1dto2UqZsV9B2wp,Cjvjrroo59m4SUhBtMqK7oX14vc1h8i9q1GuveSi3zwE,False,9825,9825,374,18,356,3RdfgDvLvsdZG5Cf6hKiKMQMqfidyxHzjYvUx1FZpeHQ,374,2598,-2224,380
2021-12-27 14:18:24.240502,2021-12-27 09:08:15-05:00,1074,DUQrYznw1DRE27enfrokBvLdo4GoP9UjxrmuQmVF1JkE,7B9rLmHd6rwNDzALBtwFKf3Za83cNUwTuDa1jtjNHead,True,4404342,1101085,6866,3433,3433,3RdfgDvLvsdZG5Cf6hKiKMQMqfidyxHzjYvUx1FZpeHQ,274679,779021,-504342,623
2021-12-27 17:13:37.634656,2021-12-27 12:06:35-05:00,1075,F9HRMjUNMmiSdUYrXrV1eUGHpm5x1fFc7Ef5JXdThUub,GKhiMaAWFaUyUAyWyzStHAWqcEfN1EPgVJ9rJ1cyktL,True,847600,211900,1304,652,652,DddJ7EWCmYEEZETCBNgAUSg81Ls6fZtiAaY5ekJ5sXx1,52170,232538,-180368,615
2021-12-27 17:13:37.634656,2021-12-27 12:11:09-05:00,1076,3J2XaAfBHtw5cSCroXWnnbJsrqmRkTPJKfbQtfnRuut5,87SjN5LqbhfkteDvzfWaeWaUHsV9U1Un7hvQezvgH1y2,True,167508,41877,257,128,129,DddJ7EWCmYEEZETCBNgAUSg81Ls6fZtiAaY5ekJ5sXx1,10305,30611,-20306,615
2021-12-27 17:13:37.634656,2021-12-27 12:11:12-05:00,1077,D74HWhGZdCteDuU97K2xNpBhvCPPepybmK8mr6yrD8Bn,5YeUjuynaPzeHiVC1sDCwDSdwydL2r7Q9gFAEx9NR4f5,True,3171894,792973,4887,2443,2444,DddJ7EWCmYEEZETCBNgAUSg81Ls6fZtiAaY5ekJ5sXx1,195486,567380,-371894,616
2021-12-27 17:38:15.541635,2021-12-27 12:17:17-05:00,1078,7PMqAqBAN5T6NnYjTHcH9uoC8zxsGVsmgayqo5yA3KZu,C74BLRp5MhkQ5owc5V9Se9e67hw41FmcuJRphm1esarT,True,91942,22985,140,70,70,GmqQKnMfFxkv6ChqGaZ2wmSFDow7R1x7WeRfU58GVvfw,5617,17728,-12111,610
2021-12-27 17:38:15.541635,2021-12-27 12:31:39-05:00,1079,6qcLY13sMpqQHzJdn482HLwmy2BtbdTGZCFZFkwd9b88,9461aiueFqooh1Tk98wVVaBJW7HNxZ6yYGHHoByd45ZC,True,82042755,20510688,128345,64172,64173,4BnQKPLuE3DMTtxp8MjUBytgnhvxqq3ZTqZHTVZo4JJh,5133807,18153927,-13020120,625
2021-12-27 17:38:15.541635,2021-12-27 12:33:09-05:00,1080,8USqxUyR8myKafnNybrE9Aj1K3982TQY1KkXccnNt3ZC,4q9X67SCKqaGXmJ9Fv77aUkjSQ7hJ8BaRs3FRLscNKQh,True,358949952,89737488,556910,278455,278455,4BnQKPLuE3DMTtxp8MjUBytgnhvxqq3ZTqZHTVZo4JJh,22276411,81890584,-59614173,620
2021-12-27 17:38:15.541635,2021-12-27 12:33:13-05:00,1081,HYJJ5UhaX5frSVKX72D4wBep5SGKyRt1WRgoKb5oDqCF,GZa5zNdRdSA2uXnHUe7GzYAjUxxfXZkMzdyK9NERRDwQ,True,7707482,1926870,11940,5970,5970,4BnQKPLuE3DMTtxp8MjUBytgnhvxqq3ZTqZHTVZo4JJh,477607,1491595,-1013988,619
2021-12-27 17:38:15.541635,2021-12-27 12:33:14-05:00,1082,3EkaWW2WfpdRsgX7KF2DxjW4DA5qyvHMRtUNrea7c5Bk,B9JxYbj471pp49bkZic3LWfWFVT75oJd3UzMcysYitdg,True,23370669,5842667,36310,18155,18155,4BnQKPLuE3DMTtxp8MjUBytgnhvxqq3ZTqZHTVZo4JJh,1452434,4463957,-3011523,621
2021-12-27 17:38:15.541635,2021-12-27 12:33:25-05:00,1083,EWvEi3CEaUD43T3uv1AFqdwKW8gJpcUmGFk5PRtpQvkj,8MPPUiyuggSfCTg3ozVy2bdUUKT7y997MMhqLygWCA3G,True,2222492,555622,3447,1723,1724,72FwbpFGoLEazJEdpqNtPNefsadUrimUqma9wSoy4qiS,137898,390253,-252355,620
2021-12-27 17:38:15.541635,2021-12-27 12:35:36-05:00,1084,H2rotXR93uLmqeedqMwYi8P4ztdxwjcbz4UPR6tPqRXM,MVcJ2GhurPEZQxBdg7HCtE5Vcug4EM2exnh3ZDk1TAx,True,139200,34800,217,108,109,GmqQKnMfFxkv6ChqGaZ2wmSFDow7R1x7WeRfU58GVvfw,8695,27041,-18346,624
2021-12-28 17:28:16.129810,2021-12-28 12:10:43-05:00,1085,EvxABBE3Qf9df36w1kyQtM5eV59fZD6omqfZ3UdrfZr,5xbVDRe5vSvkZ7e17XnLpFiaSEpjnDVtfNiHFg5r2gEW,True,1031714998,257928749,1590793,795396,795397,3RdfgDvLvsdZG5Cf6hKiKMQMqfidyxHzjYvUx1FZpeHQ,63631747,240433857,-176802110,616
2021-12-28 17:45:11.259164,2021-12-28 12:38:05-05:00,1086,CeNw8HpwRNt1Y8CRMjs4kkdE96EHBKuynzjkZ7R9n8Cb,9D9KaqSZBvJeCjFEo8GdiEVRbPJmjYXNtZhwYNaB5XN7,True,306035481,76508870,478692,239346,239346,3RdfgDvLvsdZG5Cf6hKiKMQMqfidyxHzjYvUx1FZpeHQ,19147681,71408623,-52260942,625
2021-12-28 17:45:11.259164,2021-12-28 12:38:05-05:00,1087,H2fWYP5YT3wjGWjVdA7YbbkAvUzKkgWRPi8W4HcrrZXf,9U3ntCwgkK582upzgmT8c1fTpwQXUWffBFpHeNP22k1Y,True,3890236947,972559236,6084652,3042326,3042326,3RdfgDvLvsdZG5Cf6hKiKMQMqfidyxHzjYvUx1FZpeHQ,243386088,896749604,-653363516,625
2021-12-28 17:45:11.259164,2021-12-28 12:40:30-05:00,1088,F9KRqY62kex3RjWB7Mut8JVe37nHveLraPNjMyHQTm6L,8KvvjBh4JwnYsB8VnnCzsVsDPTWsz4UMEbaXat5GHn7o,True,6023322951,1505830737,9041088,4520544,4520544,3RdfgDvLvsdZG5Cf6hKiKMQMqfidyxHzjYvUx1FZpeHQ,361643553,1442602997,-1080959444,600
2021-12-28 18:17:27.354612,2021-12-28 13:14:36-05:00,1089,GRVxQPrPjaVfvzkiBqEKfG4CRYDWiBJW7rRe7WufrZWm,6cZVH6KnVZqdNfMYH8AL1BpjbJaJvWkYT7Dg2UGUSEB2,False,2573,2573,40,2,38,3RdfgDvLvsdZG5Cf6hKiKMQMqfidyxHzjYvUx1FZpeHQ,40,2800,-2760,155
2021-12-28 18:38:07.227242,2021-12-28 13:17:59-05:00,1090,B11F2FjBv4MmTo6KgFcuTmpXSuzf3aT3PR8gFY2wzKCq,HA457Y4CAYsXST9Ro9jXeBofohJgWnHWz8QkBPnKGbPW,False,11229,11229,408,20,388,4BnQKPLuE3DMTtxp8MjUBytgnhvxqq3ZTqZHTVZo4JJh,408,3186,-2778,363
2021-12-28 18:38:07.227242,2021-12-28 13:22:30-05:00,1091,2AcAQnJsQB84hYkerFWrRovuqdvH4jCuTBGtNETKLvRj,EKCRMgnwCxKfpa4q34rPMq2REyxC3y7CCwTe8Pf8XyLT,False,2105,2105,0,0,0,72FwbpFGoLEazJEdpqNtPNefsadUrimUqma9wSoy4qiS,0,3179,-3349,0
2021-12-28 18:38:07.227242,2021-12-28 13:34:05-05:00,1092,dRBhMzxmhPiZLaHmV9YZ2PrnDUjJtFGQSxAcKMX9u2n,EQsshsnYbSmCHn4tc7GgxLeEcoWw8tcmmiEogK3WVULR,False,7018,7018,105,5,100,3RdfgDvLvsdZG5Cf6hKiKMQMqfidyxHzjYvUx1FZpeHQ,105,3587,-3482,149
2021-12-28 18:52:00.625462,2021-12-28 13:43:54-05:00,1093,6jUqZhTtcnPxYyVLVYZiJwESpnFuQ7twWmLRYVPy4Kkn,Cjm3B78XwSmc92PoYDLN2NqCSqx2PSffwcWPe2e9UT92,False,4211,4211,64,3,61,72FwbpFGoLEazJEdpqNtPNefsadUrimUqma9wSoy4qiS,64,3540,-3476,151
2021-12-28 20:26:03.403233,2021-12-28 15:24:48-05:00,1094,8GRk93CoGj3kSTM1GBYwUcMxZdFW6d7ujuzDbVWMVtMG,789pJJeXVQKJDTegMhNyAe6dbhnzitdbU8VrAa9KE3qL,False,11463,11463,342,17,325,3RdfgDvLvsdZG5Cf6hKiKMQMqfidyxHzjYvUx1FZpeHQ,342,4029,-3687,298
2021-12-29 12:12:17.154649,2021-12-29 07:08:33-05:00,1095,HhwiZPKZBGa16oVi739s4qtMDMTwzWXc7iwNfX63t2UP,5AnbMbAFKy85yHt5y2M5S38nNkA1vT4ejY5NjGbRNUqn,True,171464294,42866073,268069,134034,134035,DddJ7EWCmYEEZETCBNgAUSg81Ls6fZtiAaY5ekJ5sXx1,10722781,39238287,-28515506,625
2021-12-29 12:48:27.337253,2021-12-29 07:17:25-05:00,1096,9WJBnVi84E926j7xEd566WzrZJkPJWRgmEnYj9vyjuad,4dLaFS5F7TGyLdwuJLMGkz3bSL53aHzd9ZfpNmhHxXeF,True,783600480,195900120,1178277,589138,589139,3RdfgDvLvsdZG5Cf6hKiKMQMqfidyxHzjYvUx1FZpeHQ,47131102,172322874,-125191772,601
2021-12-29 12:48:27.337253,2021-12-29 07:17:27-05:00,1097,6NJFN855M3Q3RLTDNo57gTgAmwPD6G2E3WvMb1m5eNCN,3YpqNnonsvXaRT4nCC3G5FZx1jjVtbDPc36LiR6WK5jR,True,3862982880,965745720,5399880,2699940,2699940,DddJ7EWCmYEEZETCBNgAUSg81Ls6fZtiAaY5ekJ5sXx1,215995207,1045420850,-829425643,559
2021-12-29 12:48:27.337253,2021-12-29 07:18:02-05:00,1098,9pEArHtaXLJT3Byxom7eHPqN33JQReQW7nc9sBM2WM2X,C42NkGyduwu7Rc7m5t53SQ72AkeD7NJMSemZBoc4QAYf,True,11833311033,2958327758,16562871,8281435,8281436,3RdfgDvLvsdZG5Cf6hKiKMQMqfidyxHzjYvUx1FZpeHQ,662514867,2450016802,-1787501935,559
2021-12-29 12:48:27.337253,2021-12-29 07:28:40-05:00,1099,CRaKcudjkQiSw5YPVjTLVdXvJskeGiHSYtq5ZcMPJhgQ,AgqTg3b3bAcaBmRidhNC4Uf9ZwNbeH52RQEqumWyuUs7,True,107086869,26771717,165997,82998,82999,3RdfgDvLvsdZG5Cf6hKiKMQMqfidyxHzjYvUx1FZpeHQ,6639910,24540416,-17900506,620
2021-12-29 12:48:27.337253,2021-12-29 07:28:40-05:00,1100,Ckqos6cdncPKj13DnCmDVZsZTqp6eS7277CRrT9WhcEr,AtUV8m7VQJvZq7GLCAHMf3jV7iamKEPnWVZHWuuVZQp1,True,153564312,38391078,239456,119728,119728,3RdfgDvLvsdZG5Cf6hKiKMQMqfidyxHzjYvUx1FZpeHQ,9578260,35177310,-25599050,623
2021-12-29 12:48:27.337253,2021-12-29 07:32:47-05:00,1101,EvxABBE3Qf9df36w1kyQtM5eV59fZD6omqfZ3UdrfZr,5xbVDRe5vSvkZ7e17XnLpFiaSEpjnDVtfNiHFg5r2gEW,True,760063992,190015998,1187106,593553,593553,3RdfgDvLvsdZG5Cf6hKiKMQMqfidyxHzjYvUx1FZpeHQ,47484240,193842784,-146358544,624
2021-12-29 13:33:33.149648,2021-12-29 08:22:38-05:00,1102,EAUFD16wab8qRMJ4H6updHGt4xFqgRCDeRHVCsLCTSTL,8vkfYSyCyBY9g4TZrp52jUcQj6udy9xAaA4fioRE2RXx,True,5418198374,1354549593,8315638,4157819,4157819,4BnQKPLuE3DMTtxp8MjUBytgnhvxqq3ZTqZHTVZo4JJh,332625538,1252178552,-919553014,613
2021-12-29 13:33:33.149648,2021-12-29 08:22:38-05:00,1103,CeNw8HpwRNt1Y8CRMjs4kkdE96EHBKuynzjkZ7R9n8Cb,9D9KaqSZBvJeCjFEo8GdiEVRbPJmjYXNtZhwYNaB5XN7,True,224981094,56245273,346478,173239,173239,4BnQKPLuE3DMTtxp8MjUBytgnhvxqq3ZTqZHTVZo4JJh,13859132,57603425,-43744293,616
2021-12-29 13:44:21.814634,2021-12-29 08:35:12-05:00,1104,HhwiZPKZBGa16oVi739s4qtMDMTwzWXc7iwNfX63t2UP,5AnbMbAFKy85yHt5y2M5S38nNkA1vT4ejY5NjGbRNUqn,True,125968038,31492009,195197,97598,97599,4BnQKPLuE3DMTtxp8MjUBytgnhvxqq3ZTqZHTVZo4JJh,7807915,31825081,-24017166,619
2021-12-29 23:30:01.199243,2021-12-29 18:16:49-05:00,1105,9KD2AifD5wFD4QkHYuawXbJgLWHrfj2QPF3fT8jhGVA5,Ga9gAqmkuHbqrr31sUFPqa1xa5WNxLWJWGPUaMxQqLdj,True,49611754,12402938,77327,38663,38664,DddJ7EWCmYEEZETCBNgAUSg81Ls6fZtiAaY5ekJ5sXx1,3093082,14135944,-11042862,623
2021-12-29 23:30:01.199243,2021-12-29 18:16:54-05:00,1106,3VdSA9CED9f5swRwHX2U15U7J6Muaq8VPnCNy9CaGDHe,2YYstfnfdYic5NWmEbcUEHpccNUVd1EhuCkExvMsoMk8,True,255570730,63892682,399587,199793,199794,DddJ7EWCmYEEZETCBNgAUSg81Ls6fZtiAaY5ekJ5sXx1,15983484,71306723,-55323239,625
2021-12-29 23:30:01.199243,2021-12-29 18:20:31-05:00,1107,5Rxuqgs4CaSKbfDXqBMFXkLTQ9dxrUjThXzoy3ouYVtK,BgvbKru66ebrGUcFFymGTmsaQv6GgcGMybiWaXqzBtwX,True,7883452,1970863,12228,6114,6114,DddJ7EWCmYEEZETCBNgAUSg81Ls6fZtiAaY5ekJ5sXx1,489153,2395996,-1906843,620
2021-12-29 23:30:01.199243,2021-12-29 18:22:18-05:00,1108,6NJFN855M3Q3RLTDNo57gTgAmwPD6G2E3WvMb1m5eNCN,3YpqNnonsvXaRT4nCC3G5FZx1jjVtbDPc36LiR6WK5jR,True,2866380132,716595033,4440194,2220097,2220097,DddJ7EWCmYEEZETCBNgAUSg81Ls6fZtiAaY5ekJ5sXx1,177607784,831129101,-653521317,619
2021-12-29 23:30:01.199243,2021-12-29 18:22:34-05:00,1109,8swGZMrPrLAxZd7MxTbkCL13k3DmAJUw41jCp6Xo6awW,3fKnX7yTNXAT4uMmXVdTy47ALJT8h8YSD3WiBb4BGuzH,True,8721681645,2180420411,13483113,6741556,6741557,DddJ7EWCmYEEZETCBNgAUSg81Ls6fZtiAaY5ekJ5sXx1,539324544,1590978753,-1051654209,618
2021-12-29 23:30:01.199243,2021-12-29 18:22:43-05:00,1110,36ByQojnxEckWdQTjqHfxKqCx9yjqWQsPsZyqaN72UWR,AZoirtS1fjX61agRM64tqThVinnJTh3BWgiHyNHPTgZP,True,30331059,7582764,47057,23528,23529,DddJ7EWCmYEEZETCBNgAUSg81Ls6fZtiAaY5ekJ5sXx1,1882295,8225487,-6343192,620
2021-12-29 23:30:01.199243,2021-12-29 18:22:54-05:00,1111,9WJBnVi84E926j7xEd566WzrZJkPJWRgmEnYj9vyjuad,4dLaFS5F7TGyLdwuJLMGkz3bSL53aHzd9ZfpNmhHxXeF,True,578200484,144550121,900527,450263,450264,4BnQKPLuE3DMTtxp8MjUBytgnhvxqq3ZTqZHTVZo4JJh,36021095,139439330,-103418235,622
2021-12-29 23:47:02.682327,2021-12-29 18:45:24-05:00,1112,9KD2AifD5wFD4QkHYuawXbJgLWHrfj2QPF3fT8jhGVA5,Ga9gAqmkuHbqrr31sUFPqa1xa5WNxLWJWGPUaMxQqLdj,True,36466907,9116726,56846,28423,28423,4BnQKPLuE3DMTtxp8MjUBytgnhvxqq3ZTqZHTVZo4JJh,2273846,11298519,-9024673,623
2021-12-29 23:47:02.682327,2021-12-29 18:45:29-05:00,1113,3VdSA9CED9f5swRwHX2U15U7J6Muaq8VPnCNy9CaGDHe,2YYstfnfdYic5NWmEbcUEHpccNUVd1EhuCkExvMsoMk8,True,187794637,46948659,292512,146256,146256,DddJ7EWCmYEEZETCBNgAUSg81Ls6fZtiAaY5ekJ5sXx1,11700486,57080212,-45379726,623
2021-12-29 23:47:02.682327,2021-12-29 18:46:01-05:00,1114,5Rxuqgs4CaSKbfDXqBMFXkLTQ9dxrUjThXzoy3ouYVtK,BgvbKru66ebrGUcFFymGTmsaQv6GgcGMybiWaXqzBtwX,True,5797037,1449259,9034,4517,4517,DddJ7EWCmYEEZETCBNgAUSg81Ls6fZtiAaY5ekJ5sXx1,361373,1907362,-1545989,623
2021-12-30 00:59:26.186722,2021-12-29 19:12:13-05:00,1115,Ckqos6cdncPKj13DnCmDVZsZTqp6eS7277CRrT9WhcEr,AtUV8m7VQJvZq7GLCAHMf3jV7iamKEPnWVZHWuuVZQp1,True,112823557,28205889,171847,85923,85924,4BnQKPLuE3DMTtxp8MjUBytgnhvxqq3ZTqZHTVZo4JJh,6873883,28423117,-21549234,609
2021-12-30 00:59:26.186722,2021-12-29 19:12:13-05:00,1116,CRaKcudjkQiSw5YPVjTLVdXvJskeGiHSYtq5ZcMPJhgQ,AgqTg3b3bAcaBmRidhNC4Uf9ZwNbeH52RQEqumWyuUs7,True,78676215,19669053,118865,59432,59433,4BnQKPLuE3DMTtxp8MjUBytgnhvxqq3ZTqZHTVZo4JJh,4754612,19819119,-15064507,604
2021-12-30 00:59:26.186722,2021-12-29 19:12:13-05:00,1117,67Z7ZGhNu5xxEh9BYKWcXp9m1T4tFiE1o1M16hCzUWQA,CT7YKWixz7BhTbvg5F6M5HCyPGnHoFLNFuDV9GhoLTo3,True,295095172,73773793,441135,220567,220568,DddJ7EWCmYEEZETCBNgAUSg81Ls6fZtiAaY5ekJ5sXx1,17645402,67515385,-49869983,597
2021-12-30 00:59:26.186722,2021-12-29 19:12:49-05:00,1118,9AAazXTqbJuu9dk56Ed9qgfi5p6zBsxttWivosT11uF3,6gGw9rZTv5UsS2Mz3kq7noUN2Qs64MnRboPMfxibo9wt,False,351001,351001,16648,832,15816,GmqQKnMfFxkv6ChqGaZ2wmSFDow7R1x7WeRfU58GVvfw,16648,91371,-74723,474
2021-12-30 00:59:26.186722,2021-12-29 19:17:04-05:00,1119,F9KRqY62kex3RjWB7Mut8JVe37nHveLraPNjMyHQTm6L,8KvvjBh4JwnYsB8VnnCzsVsDPTWsz4UMEbaXat5GHn7o,True,4442965822,1110741455,6778874,3389437,3389437,DddJ7EWCmYEEZETCBNgAUSg81Ls6fZtiAaY5ekJ5sXx1,271154966,1157602082,-886447116,610
2021-12-30 00:59:26.186722,2021-12-29 19:19:00-05:00,1120,78o5Fo5zQChqXNybPAvvBAu6bFeHu9H3Let9LqMF6xni,6zX84Ypi4DvMnSgFakPRoKHtRmXjnthTJwwDo2nExaAP,True,1063943142,265985785,1619409,809704,809705,DddJ7EWCmYEEZETCBNgAUSg81Ls6fZtiAaY5ekJ5sXx1,64776366,250723187,-185946821,608
2021-12-30 00:59:26.186722,2021-12-29 19:19:02-05:00,1121,EvxABBE3Qf9df36w1kyQtM5eV59fZD6omqfZ3UdrfZr,5xbVDRe5vSvkZ7e17XnLpFiaSEpjnDVtfNiHFg5r2gEW,True,558204806,139551201,855153,427576,427577,DddJ7EWCmYEEZETCBNgAUSg81Ls6fZtiAaY5ekJ5sXx1,34206126,155837577,-121631451,612
2021-12-30 00:59:26.186722,2021-12-29 19:19:07-05:00,1122,D3mXrJzhHf8qRaoCKLschUxAFoijFCFuT6bmNZH4W7Cj,9E3Xtqw7TncXWnbhAbFJMtuNmP6WS3ooGuptzyzw7UpA,True,4231921,1057980,6574,3287,3287,DddJ7EWCmYEEZETCBNgAUSg81Ls6fZtiAaY5ekJ5sXx1,262967,980546,-717579,621
2021-12-30 00:59:26.186722,2021-12-29 19:19:09-05:00,1123,6NJFN855M3Q3RLTDNo57gTgAmwPD6G2E3WvMb1m5eNCN,3YpqNnonsvXaRT4nCC3G5FZx1jjVtbDPc36LiR6WK5jR,True,2107862410,526965602,3271789,1635894,1635895,DddJ7EWCmYEEZETCBNgAUSg81Ls6fZtiAaY5ekJ5sXx1,130871583,663268180,-532396597,620
2021-12-30 00:59:26.186722,2021-12-29 19:19:11-05:00,1124,864zY9zuCktUurPTtdGeLvUATnDqHZpT1GeWUApsXh2m,CzatBrNJUi7MeyfbNhszRaPMidgt8Xkcmy5ZwFMP9RCs,True,759594415,189898603,1188677,594338,594339,DddJ7EWCmYEEZETCBNgAUSg81Ls6fZtiAaY5ekJ5sXx1,47547092,144977061,-97429969,625
2021-12-30 00:59:26.186722,2021-12-29 19:20:29-05:00,1125,8swGZMrPrLAxZd7MxTbkCL13k3DmAJUw41jCp6Xo6awW,3fKnX7yTNXAT4uMmXVdTy47ALJT8h8YSD3WiBb4BGuzH,True,6412754478,1603188619,9904867,4952433,4952434,DddJ7EWCmYEEZETCBNgAUSg81Ls6fZtiAaY5ekJ5sXx1,396194718,1316255360,-920060642,617
2021-12-30 02:39:56.253047,2021-12-29 21:07:53-05:00,1126,GKNBtZbwK4w9hyXD1r38NTGcTJhpjt8R9WFCzdXup9Tk,7RLaL2XoFuqrcCcPEB6FzPJzLnAhjQpwcRmDfdpRXFgB,True,492808723,123202180,749425,374712,374713,DddJ7EWCmYEEZETCBNgAUSg81Ls6fZtiAaY5ekJ5sXx1,29977015,137949562,-107972547,608
2021-12-30 02:39:56.253047,2021-12-29 21:07:56-05:00,1127,AoPQqPjLPi8fZiLkhMGLRj6oD5k2asrvJtCkpW19DvGr,H5Sgmf1VuY13iHjPuLJ2q9wtSdkXG1AQsEv2eq6zzm8Y,True,26572106,6643026,40611,20305,20306,72FwbpFGoLEazJEdpqNtPNefsadUrimUqma9wSoy4qiS,1624462,5615551,-3991089,611
2021-12-30 02:39:56.253047,2021-12-29 21:10:54-05:00,1128,FMdKLXhQEnNJtvM17ZX8jhaeMaSD9UgDuN3Kw7kMrd7K,5pURHYWB5LUGwJmWVBGH8p6oyR9NJvXnZk7uDVoiassv,True,129599198,32399799,201437,100718,100719,DddJ7EWCmYEEZETCBNgAUSg81Ls6fZtiAaY5ekJ5sXx1,8057517,31303330,-23245813,621
2021-12-30 02:39:56.253047,2021-12-29 21:13:56-05:00,1129,AaMCg49sJwNtdB5wHACg15TYAzzJXy8xtG4zuVXhKiVE,HbDYqDa9bewGPvsiaHRM9HmEvh1scPaUaGvqog66gYir,True,26825054,6706263,41498,20749,20749,DddJ7EWCmYEEZETCBNgAUSg81Ls6fZtiAaY5ekJ5sXx1,1659924,5672374,-4012450,618
2021-12-30 02:57:27.327125,2021-12-29 21:47:50-05:00,1130,EBUcTqh9AYyRokZRzLbPKL9ZmTUx6KcDEbBeuCLGwqYC,B5WSXfHzYQhUFE2T97GaiqSkeejTWKKGVjMkcFrxEvyJ,True,836057142,209014285,1291892,645946,645946,DddJ7EWCmYEEZETCBNgAUSg81Ls6fZtiAaY5ekJ5sXx1,51675680,178079465,-126403785,618
2021-12-30 03:28:49.399182,2021-12-29 22:22:33-05:00,1131,864zY9zuCktUurPTtdGeLvUATnDqHZpT1GeWUApsXh2m,CzatBrNJUi7MeyfbNhszRaPMidgt8Xkcmy5ZwFMP9RCs,True,557586950,139396737,855304,427652,427652,DddJ7EWCmYEEZETCBNgAUSg81Ls6fZtiAaY5ekJ5sXx1,34212168,119413158,-85200990,613
2021-12-30 03:40:06.677071,2021-12-29 22:28:31-05:00,1132,6cnA7PeqQgpZdA7jBg4yMzTusm8JJHRWBMup84ywJfYo,FLqcukY7RehqY6ACrwVJnGH3eRgRDe93K1jLYCQN2F3U,True,2178119576,544529894,3401494,1700747,1700747,DddJ7EWCmYEEZETCBNgAUSg81Ls6fZtiAaY5ekJ5sXx1,136059790,630442977,-494383187,624
2021-12-30 03:40:06.677071,2021-12-29 22:28:59-05:00,1133,FMdKLXhQEnNJtvM17ZX8jhaeMaSD9UgDuN3Kw7kMrd7K,5pURHYWB5LUGwJmWVBGH8p6oyR9NJvXnZk7uDVoiassv,True,95310269,23827567,149087,74543,74544,DddJ7EWCmYEEZETCBNgAUSg81Ls6fZtiAaY5ekJ5sXx1,5963499,25287603,-19324104,625
2021-12-30 03:40:06.677071,2021-12-29 22:34:05-05:00,1134,CeNw8HpwRNt1Y8CRMjs4kkdE96EHBKuynzjkZ7R9n8Cb,9D9KaqSZBvJeCjFEo8GdiEVRbPJmjYXNtZhwYNaB5XN7,True,165688907,41422226,259064,129532,129532,4BnQKPLuE3DMTtxp8MjUBytgnhvxqq3ZTqZHTVZo4JJh,10362580,46219427,-35856847,625
2021-12-30 17:54:21.822420,2021-12-30 12:50:26-05:00,1135,2hozff1tVYJh4ATwTCKvSyZvvTmKyssno13GPzCaKhLQ,6kPZRvAdRHrJSiMS9cwZHnAbWhy2QqveStK9matA3jqY,False,19885,19885,707,35,672,DddJ7EWCmYEEZETCBNgAUSg81Ls6fZtiAaY5ekJ5sXx1,707,5162,-4455,355
2021-12-30 19:12:28.790828,2021-12-30 14:12:26-05:00,1136,GJyrTzbmxTNogpckpAGoh2g7fGBoFSVpTnkiWwNbp2rY,5MHNDFp9mrkX4XJkuzLiAKcdUL7QftZehR6FT6VQnXFH,False,15206,15206,458,22,436,DddJ7EWCmYEEZETCBNgAUSg81Ls6fZtiAaY5ekJ5sXx1,458,4968,-4510,301
2021-12-31 03:53:28.767098,2021-12-30 22:52:56-05:00,1137,GNzuBQW1zfYkEQiaKygkRWy3XjDPZXFSTEMU8xeH1eyn,FGNV1bkuGLuTzbeAhxzAwUNYUHkmwfQhZZeVUnF5TpSy,False,19417,19417,860,43,817,DddJ7EWCmYEEZETCBNgAUSg81Ls6fZtiAaY5ekJ5sXx1,860,5884,-5024,442
2021-12-31 19:15:48.887314,2021-12-31 14:11:46-05:00,1138,2YcB3QQGWho5oogDd1nK3cpLQzwwwXGxybrhe2xDkDxq,5DjAUp6CxKStYTaXSnzjvYkfqCXfG8Y61bWw5UwbbE3q,True,77311240,19327810,119620,59810,59810,4BnQKPLuE3DMTtxp8MjUBytgnhvxqq3ZTqZHTVZo4JJh,4784823,21975411,-17190588,618
2021-12-31 19:15:48.887314,2021-12-31 14:11:46-05:00,1139,4gzW9gBbEMnNm1epY6MMJ1XfxGMtvn2mKFyKPQ2Gyb79,G6x862hmMJ2PLpyyPDwVPGapXjvEeNkqFRTAS3jWVozB,True,117785948,29446487,181507,90753,90754,DddJ7EWCmYEEZETCBNgAUSg81Ls6fZtiAaY5ekJ5sXx1,7260282,33755429,-26495147,616
2021-12-31 19:24:55.280278,2021-12-31 14:19:51-05:00,1140,BhiAaiZu7fF8ndggJrLyiFVCRq526cNBw7VaeascEmNL,4en8MipPi7vq15NGhpPMQfptNdEyhp2j7fpgxBBtjyfz,True,23538669,5884666,36312,18156,18156,GmqQKnMfFxkv6ChqGaZ2wmSFDow7R1x7WeRfU58GVvfw,1452490,4800305,-3347815,617
2021-12-31 19:24:55.280278,2021-12-31 14:19:56-05:00,1141,5gN3624v6n1zQ1BKtZi1e9ZLpbCa4MEfhgHySFB81Qfm,UXT3oB5ud18rBsygsfxwA93kQYdSNbbzTCjt4gtU2jP,True,31485813,7871453,48640,24320,24320,DddJ7EWCmYEEZETCBNgAUSg81Ls6fZtiAaY5ekJ5sXx1,1945610,6555663,-4610053,617
2021-12-31 19:24:55.280278,2021-12-31 14:20:00-05:00,1142,Cv5oVktxmqbU1SxraxH67NEWMKnjgA18R832Fhe9h74a,Cs7xBD4BDiohyopnaYDDChUtR9vmx7uwot6Qp9beQLzt,True,23848983,5962245,36134,18067,18067,DddJ7EWCmYEEZETCBNgAUSg81Ls6fZtiAaY5ekJ5sXx1,1445362,5039330,-3593968,606
2021-12-31 19:24:55.280278,2021-12-31 14:20:00-05:00,1143,8eTH6eJyyVeMno3UQkffeBg32xofKsQfkhLhXdtaf87s,BCFC7CPXrQPsUfJb2eYSht8GhaApWHpc49AeCXqaYq13,True,27287470,6821867,41215,20607,20608,DddJ7EWCmYEEZETCBNgAUSg81Ls6fZtiAaY5ekJ5sXx1,1648624,5637163,-3988539,604
2021-12-31 19:24:55.280278,2021-12-31 14:20:44-05:00,1144,Dng7By2saPu5TVxcvXidBe71ggBo8tiHkAXPi4kKL1tk,75ufEJmHbLHffphL7tvAXhGyftKLr1z2PXXoB2GGY5fG,True,25466948,6366736,38873,19436,19437,DddJ7EWCmYEEZETCBNgAUSg81Ls6fZtiAaY5ekJ5sXx1,1554956,5360952,-3805996,610
2021-12-31 19:24:55.280278,2021-12-31 14:20:44-05:00,1145,72L76qDRMK3M7X52zuuB9GVyvFFLDBZwFMpVjWjghXzA,4m2ZVuemUctu1edv4YJVAcjXzKwpbCmBujzoUmLDeA7h,True,27830896,6957723,42867,21433,21434,DddJ7EWCmYEEZETCBNgAUSg81Ls6fZtiAaY5ekJ5sXx1,1714703,5790713,-4076010,616
2021-12-31 19:24:55.280278,2021-12-31 14:20:44-05:00,1146,D58t4uTjFumsUeYFaKnpV8BRTEQEqKXBreFTdwGrott7,67p6kHDfVqQijfcwugvZK59c3aRRH9x3eHxruqH8WEqF,True,27194893,6798722,41482,20741,20741,4BnQKPLuE3DMTtxp8MjUBytgnhvxqq3ZTqZHTVZo4JJh,1659282,5830263,-4170981,610
2021-12-31 19:24:55.280278,2021-12-31 14:24:37-05:00,1147,4KMzwWHPeW51cxu4nMpbqCaqo96dMqaHWyRCGQktfQfd,F7q4GNYcbnZa8dJ4qovQwjmxpKpdEmdxQMXRPb9nQupa,True,27187928,6796981,41506,20753,20753,DddJ7EWCmYEEZETCBNgAUSg81Ls6fZtiAaY5ekJ5sXx1,1660250,5830890,-4170640,610
2021-12-31 19:31:34.169504,2021-12-31 14:25:00-05:00,1148,DGbj8tnqECzM9FG8j225Ap7A4Fdm3J1Ksm32JBFG7igv,Cd3D2UVwoSZLygM2e3UQppQANsokpmx5CNBs1C5zueay,True,24851603,6212900,38192,19096,19096,DddJ7EWCmYEEZETCBNgAUSg81Ls6fZtiAaY5ekJ5sXx1,1527692,5131890,-3604198,614
2021-12-31 19:31:34.169504,2021-12-31 14:25:00-05:00,1149,G25vsB3sDqRhHoSK4KwR1TywfrJDtpejVbbevEG9sQ9a,5xFC3Hm13magnAA9GD1EnwC9PrPoEfQ7omEa9p9zCrB1,True,33343903,8335975,51246,25623,25623,DddJ7EWCmYEEZETCBNgAUSg81Ls6fZtiAaY5ekJ5sXx1,2049856,6645520,-4595664,614
2021-12-31 19:31:34.169504,2021-12-31 14:26:49-05:00,1150,J1sBDjpdBZcsSBS5eg95SSRjRqmQUR9cXJCsLJu8yCUt,F5wRpD2senMkGbL8Uquqo8W9x5NQDDa268dHuVFAZCww,True,52185087,13046271,80554,40277,40277,DddJ7EWCmYEEZETCBNgAUSg81Ls6fZtiAaY5ekJ5sXx1,3222179,15095870,-11873691,617
2021-12-31 19:31:34.169504,2021-12-31 14:29:08-05:00,1151,Gbxc51WERLLeCtiHv7rDvE52aqF541RoQWG5n5aqErq6,4ngBoHbfXijLMqGKxFMNht9sbmxy2g5eqBmn8QsBmbx1,True,27252278,6813069,41433,20716,20717,DddJ7EWCmYEEZETCBNgAUSg81Ls6fZtiAaY5ekJ5sXx1,1657329,5911679,-4254350,608
2021-12-31 19:31:34.169504,2021-12-31 14:29:08-05:00,1152,BgoKAyBNaJ1geeQ2FcGSHEQDWATVD3w3wmcNHtj8Awu3,8Haz7duE2ycueaJsGdrGNnK79KGHwnzKBpoafC8RZGg2,True,405770317,101442579,623665,311832,311833,GmqQKnMfFxkv6ChqGaZ2wmSFDow7R1x7WeRfU58GVvfw,24946639,119842691,-94896052,614
2021-12-31 19:51:10.088764,2021-12-31 14:50:59-05:00,1153,3qyKG4juvhcDnhoSVAFibqJtk5i4q8vLVgvwzXtdk5KP,2ofR6Hdm8qgQfKnaNFouzzBs311xgPcxny4ViS7g2Wxo,True,11426146,2856536,17713,8856,8857,DddJ7EWCmYEEZETCBNgAUSg81Ls6fZtiAaY5ekJ5sXx1,708524,3337799,-2629275,620
2021-12-31 19:51:10.088764,2021-12-31 14:51:00-05:00,1154,6woJkgUd2cpQQQBEp1C2G9NsYAvPwYmZXXTd6AxhieMy,E6xCdLJbDq5qFsvHEffD1Qfqrsj19H81mbj7XMUXUPnr,True,281276482,70319120,433710,216855,216855,4BnQKPLuE3DMTtxp8MjUBytgnhvxqq3ZTqZHTVZo4JJh,17348428,83137007,-65788579,616
2021-12-31 19:51:10.088764,2021-12-31 14:51:00-05:00,1155,7iUx7JBwqUvPVPeCqMEXQdLccZJmaFYm1DUQiu3ouHa3,3EVZzhRmJnX9ZiBZZo9tenDtMogAyuA1yf2cKzvUWiuu,True,30933401,7733350,47777,23888,23889,4BnQKPLuE3DMTtxp8MjUBytgnhvxqq3ZTqZHTVZo4JJh,1911100,6857449,-4946349,617
2021-12-31 19:51:10.088764,2021-12-31 14:51:02-05:00,1156,DH2tcZVt4nHQbph6znZRrwcyhjwiNYtgeamu72vcC6nR,ACsbP5BDFQEHQHTsdrWTBShhEUh9HeAKsE7iwyK72v2p,True,13586313,3396578,20359,10179,10180,GmqQKnMfFxkv6ChqGaZ2wmSFDow7R1x7WeRfU58GVvfw,814390,4092606,-3278216,599
2021-12-31 19:57:49.679538,2021-12-31 14:53:52-05:00,1157,gMjmD7WioyUdQdwNqE5fobLcxPwoJv5rAvLmJaf8Jjw,5n77euFjVJiwKrnbYq1KpcENW1mzBZj2BuDGyzazrkJ8,True,24602062,6150514,38228,19114,19114,DddJ7EWCmYEEZETCBNgAUSg81Ls6fZtiAaY5ekJ5sXx1,1529132,5329136,-3800004,621
2021-12-31 19:57:49.679538,2021-12-31 14:57:03-05:00,1158,Buioe5v3DyFwD9nquW5XdYeVYbSABCyg79eUHEvtvfaW,7T9gi7prCcZJkYJMSB5Ef6Bu4pAuBw4XLvumSFnqKDSi,True,47708253,11927063,74313,37156,37157,4BnQKPLuE3DMTtxp8MjUBytgnhvxqq3ZTqZHTVZo4JJh,2972556,10688939,-7716383,623
2021-12-31 20:12:48.640618,2021-12-31 14:58:54-05:00,1159,HhwiZPKZBGa16oVi739s4qtMDMTwzWXc7iwNfX63t2UP,5AnbMbAFKy85yHt5y2M5S38nNkA1vT4ejY5NjGbRNUqn,True,93077709,23269427,145340,72670,72670,GmqQKnMfFxkv6ChqGaZ2wmSFDow7R1x7WeRfU58GVvfw,5813633,25225071,-19411438,624
2021-12-31 20:12:48.640618,2021-12-31 14:58:55-05:00,1160,Dn916KSmX3HqxT53hrxrbCrV3tdRMCPdaoiRLqetMrth,ATCXRiXgnjRRUbSTPBvtBXMENCqsViexSZbZ6aDaXXWA,True,34544208,8636051,52484,26242,26242,DddJ7EWCmYEEZETCBNgAUSg81Ls6fZtiAaY5ekJ5sXx1,2099361,7509543,-5410182,607
2021-12-31 23:45:49.711907,2021-12-31 18:44:51-05:00,1161,HwMdPKabtCSiMZPhXGZjxMKg7RVwxfHSJGt6FW6XKKN5,4Wuu74hfqpRHY6sB55hzSgqEkK4G6oYXZv4ZA21LUckA,False,28286997233,28286997233,956753970,47837698,908916272,4BnQKPLuE3DMTtxp8MjUBytgnhvxqq3ZTqZHTVZo4JJh,956753970,3880935817,-2924181847,338
2021-12-31 23:45:49.711907,2021-12-31 18:44:51-05:00,1162,D3o7CSh2zCAQ93BDomDCitZ4vuxC83wGPMwJEEyBJK4C,A4nDfpUZkdtuWRRWZkoNXc5Ux7JU1UJA2JTHgkHAfYyP,True,957309286786,239327321696,1363398843,681699421,681699422,DddJ7EWCmYEEZETCBNgAUSg81Ls6fZtiAaY5ekJ5sXx1,54535953759,95553013784,-41017060025,569
2021-12-31 23:45:49.711907,2021-12-31 18:45:14-05:00,1163,FT8vMZ46cTViEsKNLGWKCiLxW74XZaEaT9tZSYyhnoj4,C6KGHMjDtokQubok3Cve2WGVA2jo8RZfuFdSEunp7PYK,True,2735661823,683915455,3677674,1838837,1838837,DddJ7EWCmYEEZETCBNgAUSg81Ls6fZtiAaY5ekJ5sXx1,147106991,636119443,-489012452,537
2021-12-31 23:45:49.711907,2021-12-31 18:45:14-05:00,1164,78o5Fo5zQChqXNybPAvvBAu6bFeHu9H3Let9LqMF6xni,6zX84Ypi4DvMnSgFakPRoKHtRmXjnthTJwwDo2nExaAP,False,753078009,753078009,18426478,921323,17505155,DddJ7EWCmYEEZETCBNgAUSg81Ls6fZtiAaY5ekJ5sXx1,18426478,202803667,-184377189,244
2021-12-31 23:45:49.711907,2021-12-31 18:45:14-05:00,1165,4XmFWQBZ59MtJcCykXm4zEj8BGue8KHGish7L2e9Ph3p,GDUQsyQUv86vmbhg2yaDTuWb8w7Mt4phcDSFe1g2A35M,False,1414747,1414747,25176,1258,23918,DddJ7EWCmYEEZETCBNgAUSg81Ls6fZtiAaY5ekJ5sXx1,25176,366452,-341276,177
2021-12-31 23:45:49.711907,2021-12-31 18:45:14-05:00,1166,EvxABBE3Qf9df36w1kyQtM5eV59fZD6omqfZ3UdrfZr,5xbVDRe5vSvkZ7e17XnLpFiaSEpjnDVtfNiHFg5r2gEW,False,395524473,395524473,10300042,515002,9785040,DddJ7EWCmYEEZETCBNgAUSg81Ls6fZtiAaY5ekJ5sXx1,10300042,124663542,-114363500,260
2021-12-31 23:45:49.711907,2021-12-31 18:45:14-05:00,1167,F9KRqY62kex3RjWB7Mut8JVe37nHveLraPNjMyHQTm6L,8KvvjBh4JwnYsB8VnnCzsVsDPTWsz4UMEbaXat5GHn7o,False,3132020997,3132020997,64792308,3239615,61552693,DddJ7EWCmYEEZETCBNgAUSg81Ls6fZtiAaY5ekJ5sXx1,64792308,930501311,-865709003,206
2021-12-31 23:45:49.711907,2021-12-31 18:45:14-05:00,1168,7iSXvck8KZn9BSSTZMWUHeECTQxU9i2WJUh4cZisV3Y9,9oCtZiYjC8Rim1wXdhib9yrL3BKNaJrrDBj9WvcxdoJ9,False,2034823904,2034823904,71515523,3575776,67939747,DddJ7EWCmYEEZETCBNgAUSg81Ls6fZtiAaY5ekJ5sXx1,71515523,484838587,-413323064,351
2021-12-31 23:45:49.711907,2021-12-31 18:45:14-05:00,1169,D9UqfagwAQjJt8f7pi3UM2tdj7EeyFHtYi7uTzvnnMQM,5ojof7CaDX2tPd3mRQfCxAkiZAu8h8V1hrGPzBPQ782E,False,22760680780,22760680780,1103057788,55152889,1047904899,DddJ7EWCmYEEZETCBNgAUSg81Ls6fZtiAaY5ekJ5sXx1,1103057788,4118713766,-3015655978,484
2022-01-02 01:54:44.482449,2022-01-01 20:05:56-05:00,1170,6VKpd1VAySMQEwYntuQmP3s874FvkfKci6w24QptMBaW,CSf9ijFWhLQNjXWXy886FDhVnUMtWDZLMrJkJMRN864Y,False,6550,6550,0,0,0,3RdfgDvLvsdZG5Cf6hKiKMQMqfidyxHzjYvUx1FZpeHQ,0,4178,-4716,0
2022-01-02 01:54:44.482449,2022-01-01 20:10:04-05:00,1171,2mKyWa1DMvoBvN6Xhbje3pUBFRSh5MJHxca49jgFrxtV,EiorfKbKJZK1v57aUybpSFX297Hp2MgyWyiL1vMozmnS,False,6550,6550,0,0,0,DddJ7EWCmYEEZETCBNgAUSg81Ls6fZtiAaY5ekJ5sXx1,0,4643,-5184,0
2022-01-02 03:55:15.061154,2022-01-01 22:51:50-05:00,1172,6pUtYz474QrpATEZnfb3iFbTKYA65pNyKAo4TQZAjtqe,8dipRUXvxJiDLdHEtCPkso4vErbVwshHQiRfvSngBS9J,True,105307814372,26326953593,163008626,81504313,81504313,GmqQKnMfFxkv6ChqGaZ2wmSFDow7R1x7WeRfU58GVvfw,6520345049,19512592510,-12992247461,619
2022-01-03 20:31:06.812433,2022-01-03 15:29:00-05:00,1173,6eBSLXDMVoW2nG3n7s42RXDH8byY3C6n1RsUuegBLSrG,37dYrKnTXYer7Bu9xFfpArA4ZNo2B9bycFw9HywDtTRx,True,666395111,166598777,1038409,519204,519205,4BnQKPLuE3DMTtxp8MjUBytgnhvxqq3ZTqZHTVZo4JJh,41536363,108592057,-67055694,623
2022-01-03 20:31:06.812433,2022-01-03 15:29:17-05:00,1174,GKNBtZbwK4w9hyXD1r38NTGcTJhpjt8R9WFCzdXup9Tk,7RLaL2XoFuqrcCcPEB6FzPJzLnAhjQpwcRmDfdpRXFgB,True,366546232,91636558,570389,285194,285195,DddJ7EWCmYEEZETCBNgAUSg81Ls6fZtiAaY5ekJ5sXx1,22815595,106862701,-84047106,622
2022-01-03 20:31:06.812433,2022-01-03 15:29:20-05:00,1175,AoPQqPjLPi8fZiLkhMGLRj6oD5k2asrvJtCkpW19DvGr,H5Sgmf1VuY13iHjPuLJ2q9wtSdkXG1AQsEv2eq6zzm8Y,True,19702207,4925551,29839,14919,14920,DddJ7EWCmYEEZETCBNgAUSg81Ls6fZtiAaY5ekJ5sXx1,1193576,4414750,-3221174,605
2022-01-03 20:31:06.812433,2022-01-03 15:29:59-05:00,1176,67Z7ZGhNu5xxEh9BYKWcXp9m1T4tFiE1o1M16hCzUWQA,CT7YKWixz7BhTbvg5F6M5HCyPGnHoFLNFuDV9GhoLTo3,True,219228228,54807057,342933,171466,171467,4BnQKPLuE3DMTtxp8MjUBytgnhvxqq3ZTqZHTVZo4JJh,13717347,53213979,-39496632,625
2022-01-03 20:31:06.812433,2022-01-03 15:30:47-05:00,1177,CRaKcudjkQiSw5YPVjTLVdXvJskeGiHSYtq5ZcMPJhgQ,AgqTg3b3bAcaBmRidhNC4Uf9ZwNbeH52RQEqumWyuUs7,True,58394621,14598655,91290,45645,45645,DddJ7EWCmYEEZETCBNgAUSg81Ls6fZtiAaY5ekJ5sXx1,3651614,15562669,-11911055,625
2022-01-03 20:49:08.547687,2022-01-03 15:43:28-05:00,1178,AaMCg49sJwNtdB5wHACg15TYAzzJXy8xtG4zuVXhKiVE,HbDYqDa9bewGPvsiaHRM9HmEvh1scPaUaGvqog66gYir,True,19857128,4964281,29859,14929,14930,GmqQKnMfFxkv6ChqGaZ2wmSFDow7R1x7WeRfU58GVvfw,1194371,4470990,-3276619,601
2022-01-03 20:49:08.547687,2022-01-03 15:44:28-05:00,1179,Ckqos6cdncPKj13DnCmDVZsZTqp6eS7277CRrT9WhcEr,AtUV8m7VQJvZq7GLCAHMf3jV7iamKEPnWVZHWuuVZQp1,True,83641102,20910275,129814,64907,64907,DddJ7EWCmYEEZETCBNgAUSg81Ls6fZtiAaY5ekJ5sXx1,5192599,22331297,-17138698,620
2022-01-03 22:51:42.333313,2022-01-03 17:50:50-05:00,1180,8gt3CVkiYKuUhQmSq9EmF5cFnUcTGQjZ36xvFQ3kd3ew,EHnQP8MvSvyjgBGySktGBsg5LohAX9W1qL8Qxg8kAqYj,False,18014,18014,714,35,679,DddJ7EWCmYEEZETCBNgAUSg81Ls6fZtiAaY5ekJ5sXx1,714,7057,-6343,396
2022-01-04 15:54:28.856629,2022-01-04 10:45:49-05:00,1181,BQmgCbh8eiAMGXHpV9X95MnDYV9JjDuj2YAZgPfUCjmL,BUwxZXb3JAeF4goqMcxFNbakkErGqjgMFTEEMWzQtt1Q,False,17780,17780,56,2,54,DddJ7EWCmYEEZETCBNgAUSg81Ls6fZtiAaY5ekJ5sXx1,56,6414,-6358,31
2022-01-04 15:54:28.856629,2022-01-04 10:46:16-05:00,1182,FKzZwArvvSdbyAF6RKAPRBgMtzCvrUUAxESZgjvTwNXf,5MovQeB91aVJFzTj1kcSfHBBhxuN9r4dT8Q54KK4tgsr,True,23628,5907,29,14,15,DddJ7EWCmYEEZETCBNgAUSg81Ls6fZtiAaY5ekJ5sXx1,1190,7041,-5851,503
2022-01-04 17:31:46.097454,2022-01-04 12:20:25-05:00,1183,9ZfQ71NugTAKvYVCWavzg9esCyxUdtT4M46uR1hwWShA,8qLPvyxDDPckhq2dh5zdBcV4ttGSi9ziZ1Amo6xPBK1m,False,11229,11229,0,0,0,DddJ7EWCmYEEZETCBNgAUSg81Ls6fZtiAaY5ekJ5sXx1,0,7613,-8062,0
2022-01-04 18:02:25.162533,2022-01-04 12:59:27-05:00,1184,FKzZwArvvSdbyAF6RKAPRBgMtzCvrUUAxESZgjvTwNXf,5MovQeB91aVJFzTj1kcSfHBBhxuN9r4dT8Q54KK4tgsr,True,17546,4386,24,12,12,HfEnetJ7uBSmZWCjBNxdvv9HEC5nsW4wDV7wu6WnhWan,986,1925,-939,561
2022-01-04 18:44:56.941211,2022-01-04 13:38:35-05:00,1185,BhiAaiZu7fF8ndggJrLyiFVCRq526cNBw7VaeascEmNL,4en8MipPi7vq15NGhpPMQfptNdEyhp2j7fpgxBBtjyfz,True,17422199,4355549,27205,13602,13603,3RdfgDvLvsdZG5Cf6hKiKMQMqfidyxHzjYvUx1FZpeHQ,1088216,3835952,-2747736,624
2022-01-04 18:55:09.807727,2022-01-04 13:48:08-05:00,1186,4gzW9gBbEMnNm1epY6MMJ1XfxGMtvn2mKFyKPQ2Gyb79,G6x862hmMJ2PLpyyPDwVPGapXjvEeNkqFRTAS3jWVozB,True,87200230,21800057,135762,67881,67881,HfEnetJ7uBSmZWCjBNxdvv9HEC5nsW4wDV7wu6WnhWan,5430495,26443639,-21013144,622
2022-01-04 18:55:09.807727,2022-01-04 13:52:03-05:00,1187,5gN3624v6n1zQ1BKtZi1e9ZLpbCa4MEfhgHySFB81Qfm,UXT3oB5ud18rBsygsfxwA93kQYdSNbbzTCjt4gtU2jP,True,23266358,5816588,35654,17827,17827,HfEnetJ7uBSmZWCjBNxdvv9HEC5nsW4wDV7wu6WnhWan,1426162,5239357,-3813195,612
2022-01-04 18:55:09.807727,2022-01-04 13:52:06-05:00,1188,Cv5oVktxmqbU1SxraxH67NEWMKnjgA18R832Fhe9h74a,Cs7xBD4BDiohyopnaYDDChUtR9vmx7uwot6Qp9beQLzt,True,17673095,4418273,27514,13757,13757,HfEnetJ7uBSmZWCjBNxdvv9HEC5nsW4wDV7wu6WnhWan,1100592,4022502,-2921910,622
2022-01-04 18:55:09.807727,2022-01-04 13:52:22-05:00,1189,7LBZi7Ec4VKhtNJbFQYYY8CvFbsLPCvqmn8Rd5EVhn9n,CBgkKDhmsEa8Ug8nE9Yu95gLDbDQa9FNGpdjVRfEDXcq,True,1611442060,402860515,2519006,1259503,1259503,3RdfgDvLvsdZG5Cf6hKiKMQMqfidyxHzjYvUx1FZpeHQ,100760274,335265303,-234505029,625
2022-01-04 18:55:09.807727,2022-01-04 13:52:23-05:00,1190,8eTH6eJyyVeMno3UQkffeBg32xofKsQfkhLhXdtaf87s,BCFC7CPXrQPsUfJb2eYSht8GhaApWHpc49AeCXqaYq13,True,20192152,5048038,30655,15327,15328,HfEnetJ7uBSmZWCjBNxdvv9HEC5nsW4wDV7wu6WnhWan,1226214,4505631,-3279417,607
2022-01-04 18:55:09.807727,2022-01-04 13:52:29-05:00,1191,Dng7By2saPu5TVxcvXidBe71ggBo8tiHkAXPi4kKL1tk,75ufEJmHbLHffphL7tvAXhGyftKLr1z2PXXoB2GGY5fG,True,18848894,4712222,29104,14552,14552,HfEnetJ7uBSmZWCjBNxdvv9HEC5nsW4wDV7wu6WnhWan,1164188,4277840,-3113652,617
2022-01-04 18:55:09.807727,2022-01-04 13:52:44-05:00,1192,2YcB3QQGWho5oogDd1nK3cpLQzwwwXGxybrhe2xDkDxq,5DjAUp6CxKStYTaXSnzjvYkfqCXfG8Y61bWw5UwbbE3q,True,57186070,14296517,88337,44168,44169,DddJ7EWCmYEEZETCBNgAUSg81Ls6fZtiAaY5ekJ5sXx1,3533519,17236113,-13702594,617
2022-01-04 18:55:09.807727,2022-01-04 13:52:59-05:00,1193,D58t4uTjFumsUeYFaKnpV8BRTEQEqKXBreFTdwGrott7,67p6kHDfVqQijfcwugvZK59c3aRRH9x3eHxruqH8WEqF,True,20110342,5027585,30648,15324,15324,HfEnetJ7uBSmZWCjBNxdvv9HEC5nsW4wDV7wu6WnhWan,1225957,4652985,-3427028,609
2022-01-04 18:55:09.807727,2022-01-04 13:52:59-05:00,1194,72L76qDRMK3M7X52zuuB9GVyvFFLDBZwFMpVjWjghXzA,4m2ZVuemUctu1edv4YJVAcjXzKwpbCmBujzoUmLDeA7h,True,20599182,5149795,32189,16094,16095,3RdfgDvLvsdZG5Cf6hKiKMQMqfidyxHzjYvUx1FZpeHQ,1287577,4625280,-3337703,625
2022-01-04 18:55:09.807727,2022-01-04 13:53:15-05:00,1195,DGbj8tnqECzM9FG8j225Ap7A4Fdm3J1Ksm32JBFG7igv,Cd3D2UVwoSZLygM2e3UQppQANsokpmx5CNBs1C5zueay,True,18359412,4589852,27751,13875,13876,HfEnetJ7uBSmZWCjBNxdvv9HEC5nsW4wDV7wu6WnhWan,1110065,4098676,-2988611,604
2022-01-04 18:55:09.807727,2022-01-04 13:53:25-05:00,1196,G25vsB3sDqRhHoSK4KwR1TywfrJDtpejVbbevEG9sQ9a,5xFC3Hm13magnAA9GD1EnwC9PrPoEfQ7omEa9p9zCrB1,True,24636869,6159217,37234,18617,18617,DddJ7EWCmYEEZETCBNgAUSg81Ls6fZtiAaY5ekJ5sXx1,1489362,5315670,-3826308,604
2022-01-04 18:55:09.807727,2022-01-04 13:53:28-05:00,1197,4KMzwWHPeW51cxu4nMpbqCaqo96dMqaHWyRCGQktfQfd,F7q4GNYcbnZa8dJ4qovQwjmxpKpdEmdxQMXRPb9nQupa,True,20101511,5025377,30613,15306,15307,HfEnetJ7uBSmZWCjBNxdvv9HEC5nsW4wDV7wu6WnhWan,1224532,4654421,-3429889,609
2022-01-04 18:55:09.807727,2022-01-04 13:53:28-05:00,1198,J1sBDjpdBZcsSBS5eg95SSRjRqmQUR9cXJCsLJu8yCUt,F5wRpD2senMkGbL8Uquqo8W9x5NQDDa268dHuVFAZCww,True,38597755,9649438,59355,29677,29678,HfEnetJ7uBSmZWCjBNxdvv9HEC5nsW4wDV7wu6WnhWan,2374206,11831106,-9456900,615
2022-01-05 17:13:49.004657,2022-01-05 12:12:59-05:00,1199,FKzZwArvvSdbyAF6RKAPRBgMtzCvrUUAxESZgjvTwNXf,5MovQeB91aVJFzTj1kcSfHBBhxuN9r4dT8Q54KK4tgsr,False,6787,6787,0,0,0,HfEnetJ7uBSmZWCjBNxdvv9HEC5nsW4wDV7wu6WnhWan,0,1682,-7116,0
2022-01-05 17:40:11.998365,2022-01-05 12:36:56-05:00,1200,D3mXrJzhHf8qRaoCKLschUxAFoijFCFuT6bmNZH4W7Cj,9E3Xtqw7TncXWnbhAbFJMtuNmP6WS3ooGuptzyzw7UpA,True,3143048,785762,4916,2458,2458,DddJ7EWCmYEEZETCBNgAUSg81Ls6fZtiAaY5ekJ5sXx1,196671,765774,-569103,625
2022-01-05 17:52:22.055722,2022-01-05 12:49:27-05:00,1201,Mcbzp1LhZwpfmXTv1pqe9D1jCKHw443j9QKp6tUpzgM,8uforSMAKEih5jHfHp3gCqCvaugtCmhzVfVHA63Akz7F,True,108167278,27041819,167561,83780,83781,HfEnetJ7uBSmZWCjBNxdvv9HEC5nsW4wDV7wu6WnhWan,6702460,23522557,-16820097,619
2022-01-05 17:52:22.055722,2022-01-05 12:50:11-05:00,1202,Buioe5v3DyFwD9nquW5XdYeVYbSABCyg79eUHEvtvfaW,7T9gi7prCcZJkYJMSB5Ef6Bu4pAuBw4XLvumSFnqKDSi,True,35239976,8809994,53841,26920,26921,HfEnetJ7uBSmZWCjBNxdvv9HEC5nsW4wDV7wu6WnhWan,2153643,8482183,-6328540,611
2022-01-05 17:52:22.055722,2022-01-05 12:50:23-05:00,1203,HhwiZPKZBGa16oVi739s4qtMDMTwzWXc7iwNfX63t2UP,5AnbMbAFKy85yHt5y2M5S38nNkA1vT4ejY5NjGbRNUqn,True,68807192,17201798,106739,53369,53370,HfEnetJ7uBSmZWCjBNxdvv9HEC5nsW4wDV7wu6WnhWan,4269568,19829395,-15559827,620
2022-01-05 17:58:39.925054,2022-01-05 12:54:32-05:00,1204,8MKNsuGVaoYpdQy6NNyxDvRzh2DAquBUtri4nDsixUxs,D7M1SDmpZAs8vdPCCCa96UbDF15YQDxHmoGWB57tHiir,True,205165822,51291455,318490,159245,159245,DddJ7EWCmYEEZETCBNgAUSg81Ls6fZtiAaY5ekJ5sXx1,12739634,44514174,-31774540,620
2022-01-05 17:58:39.925054,2022-01-05 12:54:37-05:00,1205,6eBSLXDMVoW2nG3n7s42RXDH8byY3C6n1RsUuegBLSrG,37dYrKnTXYer7Bu9xFfpArA4ZNo2B9bycFw9HywDtTRx,True,491266683,122816670,764605,382302,382303,DddJ7EWCmYEEZETCBNgAUSg81Ls6fZtiAaY5ekJ5sXx1,30584215,89409185,-58824970,622
2022-01-05 18:16:30.664142,2022-01-05 12:58:56-05:00,1206,67Z7ZGhNu5xxEh9BYKWcXp9m1T4tFiE1o1M16hCzUWQA,CT7YKWixz7BhTbvg5F6M5HCyPGnHoFLNFuDV9GhoLTo3,True,161586951,40396737,252097,126048,126049,DddJ7EWCmYEEZETCBNgAUSg81Ls6fZtiAaY5ekJ5sXx1,10083887,42541040,-32457153,624
2022-01-05 18:16:30.664142,2022-01-05 12:59:05-05:00,1207,Ckqos6cdncPKj13DnCmDVZsZTqp6eS7277CRrT9WhcEr,AtUV8m7VQJvZq7GLCAHMf3jV7iamKEPnWVZHWuuVZQp1,True,61691716,15422929,96230,48115,48115,DddJ7EWCmYEEZETCBNgAUSg81Ls6fZtiAaY5ekJ5sXx1,3849217,17742461,-13893244,623
2022-01-05 18:16:30.664142,2022-01-05 12:59:05-05:00,1208,CRaKcudjkQiSw5YPVjTLVdXvJskeGiHSYtq5ZcMPJhgQ,AgqTg3b3bAcaBmRidhNC4Uf9ZwNbeH52RQEqumWyuUs7,True,43020094,10755023,66569,33284,33285,HfEnetJ7uBSmZWCjBNxdvv9HEC5nsW4wDV7wu6WnhWan,2662796,12372059,-9709263,618
2022-01-05 18:16:30.664142,2022-01-05 13:00:03-05:00,1209,Gbxc51WERLLeCtiHv7rDvE52aqF541RoQWG5n5aqErq6,4ngBoHbfXijLMqGKxFMNht9sbmxy2g5eqBmn8QsBmbx1,True,20196479,5049119,31153,15576,15577,3RdfgDvLvsdZG5Cf6hKiKMQMqfidyxHzjYvUx1FZpeHQ,1246146,4688696,-3442550,617
2022-01-05 18:16:30.664142,2022-01-05 13:03:30-05:00,1210,7iUx7JBwqUvPVPeCqMEXQdLccZJmaFYm1DUQiu3ouHa3,3EVZzhRmJnX9ZiBZZo9tenDtMogAyuA1yf2cKzvUWiuu,True,22910333,5727582,35739,17869,17870,HfEnetJ7uBSmZWCjBNxdvv9HEC5nsW4wDV7wu6WnhWan,1429586,5432315,-4002729,623
2022-01-05 18:16:30.664142,2022-01-05 13:05:10-05:00,1211,A7SMcwnq3DewryUj1jScnAboKGnuDVcW15F3ubNcG66Y,5qLCE37FdeWLCQnkfNJViFMGNcDeiELgE3VgPbBUuDGF,True,918825665,229706416,1425882,712941,712941,HfEnetJ7uBSmZWCjBNxdvv9HEC5nsW4wDV7wu6WnhWan,57035285,199206128,-142170843,620
2022-01-05 18:16:30.664142,2022-01-05 13:06:45-05:00,1212,D3mXrJzhHf8qRaoCKLschUxAFoijFCFuT6bmNZH4W7Cj,9E3Xtqw7TncXWnbhAbFJMtuNmP6WS3ooGuptzyzw7UpA,True,2310403,577600,3611,1805,1806,HfEnetJ7uBSmZWCjBNxdvv9HEC5nsW4wDV7wu6WnhWan,144469,618180,-473711,625
2022-01-05 18:16:30.664142,2022-01-05 13:08:05-05:00,1213,2NdwSLxsGok8PczpCZj9CVX2BymNU5MvHt7hWfGetg2M,8AQbDXeA6mD9QoZBFJcYbnHvZwKNxzA9CCHLAgdSfTA3,True,425476,106369,665,332,333,4BnQKPLuE3DMTtxp8MjUBytgnhvxqq3ZTqZHTVZo4JJh,26617,101018,-74401,625
2022-01-05 18:16:30.664142,2022-01-05 13:10:19-05:00,1214,Mcbzp1LhZwpfmXTv1pqe9D1jCKHw443j9QKp6tUpzgM,8uforSMAKEih5jHfHp3gCqCvaugtCmhzVfVHA63Akz7F,True,79584518,19896129,124501,62250,62251,4BnQKPLuE3DMTtxp8MjUBytgnhvxqq3ZTqZHTVZo4JJh,4980044,19136138,-14156094,625
2022-01-05 18:16:30.664142,2022-01-05 13:10:19-05:00,1215,Hy3kzXneDN6FUkiZctU1vWe97BYvj6yZ7QvQzehfWmNr,EhXgQg8BTniANV525RpY76z7Hrh6DuqrMChjqEoXfVJe,True,34662553,8665638,54046,27023,27023,4BnQKPLuE3DMTtxp8MjUBytgnhvxqq3ZTqZHTVZo4JJh,2161840,8938877,-6777037,623
2022-01-05 18:16:30.664142,2022-01-05 13:10:19-05:00,1216,2PHDkmat5jQ65XkJYhDSw6ZwHcKpSw85o8MaPFhfLBry,8NtkXoUPt4wkcqQJuPJYt5oq9hG4BdeY26dQrsybDWWX,True,448655612,112163902,697309,348654,348655,4BnQKPLuE3DMTtxp8MjUBytgnhvxqq3ZTqZHTVZo4JJh,27892379,75244997,-47352618,621
2022-01-05 18:16:30.664142,2022-01-05 13:10:45-05:00,1217,gMjmD7WioyUdQdwNqE5fobLcxPwoJv5rAvLmJaf8Jjw,5n77euFjVJiwKrnbYq1KpcENW1mzBZj2BuDGyzazrkJ8,True,18214608,4553652,28449,14224,14225,HfEnetJ7uBSmZWCjBNxdvv9HEC5nsW4wDV7wu6WnhWan,1137961,4226848,-3088887,624
2022-01-05 18:38:32.641788,2022-01-05 13:18:32-05:00,1218,7LRBswSEDBjJzQ4YurfTxLydh7tFS2jVn5V95Z6wL7ci,fD41VYGmk66MW46KKb23vAqQvUSDScgXnVdsHhJBZzu,True,4696718,1174179,7348,3674,3674,HfEnetJ7uBSmZWCjBNxdvv9HEC5nsW4wDV7wu6WnhWan,293931,997217,-703286,625
2022-01-05 19:13:12.613621,2022-01-05 14:11:19-05:00,1219,Buioe5v3DyFwD9nquW5XdYeVYbSABCyg79eUHEvtvfaW,7T9gi7prCcZJkYJMSB5Ef6Bu4pAuBw4XLvumSFnqKDSi,True,25957079,6489269,40446,20223,20223,4BnQKPLuE3DMTtxp8MjUBytgnhvxqq3ZTqZHTVZo4JJh,1617879,6837196,-5219317,623
2022-01-05 19:13:12.613621,2022-01-05 14:11:27-05:00,1220,EgU9hX6VK7YXeCgCHVaJAMekCcyZa2MVWdKra5pN7Gwv,7y8Ad9XY34bqREvheXHT2tr8Jy11D6X3pu7yLVtjU4QV,True,363273882,90818470,567325,283662,283663,4BnQKPLuE3DMTtxp8MjUBytgnhvxqq3ZTqZHTVZo4JJh,22693030,78485583,-55792553,624
2022-01-05 19:24:33.742112,2022-01-05 14:13:18-05:00,1221,H6tDNj9cHac223ckAnNfnC4bAJuNLBnf2pFk2iQdMzMP,28UL9dqgayCqCAexScXjdpobYGVDN44SGBVNAfBByk8C,True,2451616219,612904054,3834651,1917325,1917326,4BnQKPLuE3DMTtxp8MjUBytgnhvxqq3ZTqZHTVZo4JJh,153386069,662494032,-509107963,625
2022-01-05 19:24:33.742112,2022-01-05 14:13:19-05:00,1222,EEcTbsFTUEifcdbPyjBLkS943daEx1RpR8F3uZxKRZbT,8V3JzDQ1VWYQLas8fxUsWJZZHe4gEmn74RehtUwLw3k5,True,196139695,49034923,306615,153307,153308,HfEnetJ7uBSmZWCjBNxdvv9HEC5nsW4wDV7wu6WnhWan,12264622,41982583,-29717961,625
2022-01-05 19:24:33.742112,2022-01-05 14:13:56-05:00,1223,Gs3WP18hbzNpbBgiU39e6tfkggfCKRyNqPqJQcthuHFD,4XAY25YUma6gUdG2GdbXeivum3t21g93ZagfWGTZYkWZ,True,197568764,49392190,307404,153702,153702,DddJ7EWCmYEEZETCBNgAUSg81Ls6fZtiAaY5ekJ5sXx1,12296161,54551066,-42254905,622
2022-01-05 19:24:33.742112,2022-01-05 14:13:56-05:00,1224,HhwiZPKZBGa16oVi739s4qtMDMTwzWXc7iwNfX63t2UP,5AnbMbAFKy85yHt5y2M5S38nNkA1vT4ejY5NjGbRNUqn,True,50624609,12656152,79110,39555,39555,4BnQKPLuE3DMTtxp8MjUBytgnhvxqq3ZTqZHTVZo4JJh,3164409,15815099,-12650690,625
2022-01-05 19:24:33.742112,2022-01-05 14:19:09-05:00,1225,5jin5wXjQQ25nGM2ECrCXcg1a95vquh6kM7rMRru6Ke7,EKM657EQ8HWWgf4cssByoYHoXGjFfTspTKXAGmygAPQG,True,1373318936,343329734,2148835,1074417,1074418,DddJ7EWCmYEEZETCBNgAUSg81Ls6fZtiAaY5ekJ5sXx1,85953410,297474389,-211520979,625
2022-01-05 19:24:33.742112,2022-01-05 14:21:05-05:00,1226,2VyFcgZDH1HTEvD1XaWhwqBCMmZ1k6TmZ3fEpPcBZR9E,G1wFJETTpdoc7CfypGCzkq1jssXPfUkiuLjK2cwVZ9dJ,True,2934410,733602,4591,2295,2296,GmqQKnMfFxkv6ChqGaZ2wmSFDow7R1x7WeRfU58GVvfw,183642,673419,-489777,625
2022-01-05 19:24:33.742112,2022-01-05 14:21:26-05:00,1227,8MKNsuGVaoYpdQy6NNyxDvRzh2DAquBUtri4nDsixUxs,D7M1SDmpZAs8vdPCCCa96UbDF15YQDxHmoGWB57tHiir,True,150821006,37705251,232876,116438,116438,HfEnetJ7uBSmZWCjBNxdvv9HEC5nsW4wDV7wu6WnhWan,9315052,36199605,-26884553,617
2022-01-05 19:24:33.742112,2022-01-05 14:21:28-05:00,1228,F2v1YwVAwXLiUgsJ5uwn4qAAkTXitn1E75fJcPnGuAcy,5rdJ4H5GxPg4Juu77mGc7uya5LwEqLzDSRyG8mQ2mDbK,True,702730645,175682661,1098584,549292,549292,DddJ7EWCmYEEZETCBNgAUSg81Ls6fZtiAaY5ekJ5sXx1,43943378,152285701,-108342323,625
2022-01-05 19:24:33.742112,2022-01-05 14:21:28-05:00,1229,6eBSLXDMVoW2nG3n7s42RXDH8byY3C6n1RsUuegBLSrG,37dYrKnTXYer7Bu9xFfpArA4ZNo2B9bycFw9HywDtTRx,True,361358248,90339562,565037,282518,282519,4BnQKPLuE3DMTtxp8MjUBytgnhvxqq3ZTqZHTVZo4JJh,22601502,73813588,-51212086,625
2022-01-05 19:24:33.742112,2022-01-05 14:21:35-05:00,1230,Fd2HrzBAr4JobRPARZwpQHHVoSCEoog32A6tKMWAC1sK,BYappsar5sQf8VLem4wrLuTtrDFH9y8pEx1aMxfuU4Pq,True,1097175640,274293910,1716410,858205,858205,HfEnetJ7uBSmZWCjBNxdvv9HEC5nsW4wDV7wu6WnhWan,68656422,237750141,-169093719,625
2022-01-05 19:37:43.728639,2022-01-05 14:33:53-05:00,1231,8RmB8o4zux2sD48dEsKpsX475KRxTwdk8QULUDU9xx8R,AKSiZnb4YKVB6B86aPPqvyXquhvN9xqt45bexBCZ7nx,True,2305831644,576457911,3589292,1794646,1794646,DddJ7EWCmYEEZETCBNgAUSg81Ls6fZtiAaY5ekJ5sXx1,143571710,645971332,-502399622,622
2022-01-05 19:37:43.728639,2022-01-05 14:35:58-05:00,1232,CRaKcudjkQiSw5YPVjTLVdXvJskeGiHSYtq5ZcMPJhgQ,AgqTg3b3bAcaBmRidhNC4Uf9ZwNbeH52RQEqumWyuUs7,True,31653852,7913463,49347,24673,24674,HfEnetJ7uBSmZWCjBNxdvv9HEC5nsW4wDV7wu6WnhWan,1973903,9867083,-7893180,623
2022-01-05 19:37:43.728639,2022-01-05 14:35:58-05:00,1233,67Z7ZGhNu5xxEh9BYKWcXp9m1T4tFiE1o1M16hCzUWQA,CT7YKWixz7BhTbvg5F6M5HCyPGnHoFLNFuDV9GhoLTo3,True,118727103,29681775,183175,91587,91588,HfEnetJ7uBSmZWCjBNxdvv9HEC5nsW4wDV7wu6WnhWan,7327027,34133189,-26806162,617
2022-01-05 19:50:32.725554,2022-01-05 14:44:41-05:00,1234,9vcKW1GfrDZ3KLPh2pEVFF8ZyKqD1pJW1hiE8H98Av7S,C6Ki27mo4sCHu6u8UnR1p7WSgsTjFQxGGR9Lk9n5Rhjq,True,101490093,25372523,158097,79048,79049,DddJ7EWCmYEEZETCBNgAUSg81Ls6fZtiAaY5ekJ5sXx1,6323914,21567885,-15243971,623
2022-01-05 19:50:32.725554,2022-01-05 14:44:41-05:00,1235,Ckqos6cdncPKj13DnCmDVZsZTqp6eS7277CRrT9WhcEr,AtUV8m7VQJvZq7GLCAHMf3jV7iamKEPnWVZHWuuVZQp1,True,45357818,11339454,70652,35326,35326,HfEnetJ7uBSmZWCjBNxdvv9HEC5nsW4wDV7wu6WnhWan,2826094,14157024,-11330930,623
2022-01-05 19:50:32.725554,2022-01-05 14:45:11-05:00,1236,BgoKAyBNaJ1geeQ2FcGSHEQDWATVD3w3wmcNHtj8Awu3,8Haz7duE2ycueaJsGdrGNnK79KGHwnzKBpoafC8RZGg2,True,300614960,75153740,465769,232884,232885,4BnQKPLuE3DMTtxp8MjUBytgnhvxqq3ZTqZHTVZo4JJh,18630772,93518685,-74887913,619
2022-01-05 19:50:32.725554,2022-01-05 14:45:26-05:00,1237,AoPQqPjLPi8fZiLkhMGLRj6oD5k2asrvJtCkpW19DvGr,H5Sgmf1VuY13iHjPuLJ2q9wtSdkXG1AQsEv2eq6zzm8Y,True,14541829,3635457,22551,11275,11276,HfEnetJ7uBSmZWCjBNxdvv9HEC5nsW4wDV7wu6WnhWan,902041,3564321,-2662280,620
2022-01-05 19:50:32.725554,2022-01-05 14:45:36-05:00,1238,6woJkgUd2cpQQQBEp1C2G9NsYAvPwYmZXXTd6AxhieMy,E6xCdLJbDq5qFsvHEffD1Qfqrsj19H81mbj7XMUXUPnr,True,208222812,52055703,320069,160034,160035,DddJ7EWCmYEEZETCBNgAUSg81Ls6fZtiAaY5ekJ5sXx1,12802770,64886921,-52084151,614
2022-01-05 19:50:32.725554,2022-01-05 14:45:36-05:00,1239,AaMCg49sJwNtdB5wHACg15TYAzzJXy8xtG4zuVXhKiVE,HbDYqDa9bewGPvsiaHRM9HmEvh1scPaUaGvqog66gYir,True,14659640,3664909,22573,11286,11287,DddJ7EWCmYEEZETCBNgAUSg81Ls6fZtiAaY5ekJ5sXx1,902923,3607885,-2704962,615
2022-01-05 19:50:32.725554,2022-01-05 14:45:38-05:00,1240,Dn916KSmX3HqxT53hrxrbCrV3tdRMCPdaoiRLqetMrth,ATCXRiXgnjRRUbSTPBvtBXMENCqsViexSZbZ6aDaXXWA,True,25615546,6403885,40026,20013,20013,DddJ7EWCmYEEZETCBNgAUSg81Ls6fZtiAaY5ekJ5sXx1,1601040,5967858,-4366818,625
2022-01-05 19:50:32.725554,2022-01-05 14:45:38-05:00,1241,DH2tcZVt4nHQbph6znZRrwcyhjwiNYtgeamu72vcC6nR,ACsbP5BDFQEHQHTsdrWTBShhEUh9HeAKsE7iwyK72v2p,True,10092353,2523088,15747,7873,7874,4BnQKPLuE3DMTtxp8MjUBytgnhvxqq3ZTqZHTVZo4JJh,629889,3197180,-2567291,624
2022-01-05 19:50:32.725554,2022-01-05 14:46:02-05:00,1242,7jvKp6onXyWgwsFrFWj4hYTXJsYYD6ot5mn6rPFuJriy,J7N6HiozevJVTiY9hDEUs2ud5BwT5QSE7wnMBS1w5ie2,True,871002654,217750663,1354552,677276,677276,DddJ7EWCmYEEZETCBNgAUSg81Ls6fZtiAaY5ekJ5sXx1,54182117,251213174,-197031057,622
2022-01-05 19:50:32.725554,2022-01-05 14:46:11-05:00,1243,5gN3624v6n1zQ1BKtZi1e9ZLpbCa4MEfhgHySFB81Qfm,UXT3oB5ud18rBsygsfxwA93kQYdSNbbzTCjt4gtU2jP,True,17140527,4285131,26536,13268,13268,4BnQKPLuE3DMTtxp8MjUBytgnhvxqq3ZTqZHTVZo4JJh,1061448,4246646,-3185198,619
2022-01-05 19:50:32.725554,2022-01-05 14:46:15-05:00,1244,8eTH6eJyyVeMno3UQkffeBg32xofKsQfkhLhXdtaf87s,BCFC7CPXrQPsUfJb2eYSht8GhaApWHpc49AeCXqaYq13,True,14878840,3719709,22841,11420,11421,DddJ7EWCmYEEZETCBNgAUSg81Ls6fZtiAaY5ekJ5sXx1,913675,3652838,-2739163,614
2022-01-05 19:50:32.725554,2022-01-05 14:46:15-05:00,1245,Cv5oVktxmqbU1SxraxH67NEWMKnjgA18R832Fhe9h74a,Cs7xBD4BDiohyopnaYDDChUtR9vmx7uwot6Qp9beQLzt,True,13007988,3251996,20304,10152,10152,DddJ7EWCmYEEZETCBNgAUSg81Ls6fZtiAaY5ekJ5sXx1,812182,3258288,-2446106,624
2022-01-05 19:50:32.725554,2022-01-05 14:46:15-05:00,1246,D58t4uTjFumsUeYFaKnpV8BRTEQEqKXBreFTdwGrott7,67p6kHDfVqQijfcwugvZK59c3aRRH9x3eHxruqH8WEqF,True,14827750,3706936,23073,11536,11537,HfEnetJ7uBSmZWCjBNxdvv9HEC5nsW4wDV7wu6WnhWan,922931,3762188,-2839257,622
2022-01-05 19:50:32.725554,2022-01-05 14:46:15-05:00,1247,4KMzwWHPeW51cxu4nMpbqCaqo96dMqaHWyRCGQktfQfd,F7q4GNYcbnZa8dJ4qovQwjmxpKpdEmdxQMXRPb9nQupa,True,14817974,3704493,22942,11471,11471,4BnQKPLuE3DMTtxp8MjUBytgnhvxqq3ZTqZHTVZo4JJh,917698,3762270,-2844572,619
2022-01-05 19:50:32.725554,2022-01-05 14:46:31-05:00,1248,Gbxc51WERLLeCtiHv7rDvE52aqF541RoQWG5n5aqErq6,4ngBoHbfXijLMqGKxFMNht9sbmxy2g5eqBmn8QsBmbx1,True,14859546,3714886,23136,11568,11568,DddJ7EWCmYEEZETCBNgAUSg81Ls6fZtiAaY5ekJ5sXx1,925448,3795179,-2869731,622
2022-01-05 19:50:32.725554,2022-01-05 14:46:31-05:00,1249,72L76qDRMK3M7X52zuuB9GVyvFFLDBZwFMpVjWjghXzA,4m2ZVuemUctu1edv4YJVAcjXzKwpbCmBujzoUmLDeA7h,True,15155763,3788940,23626,11813,11813,4BnQKPLuE3DMTtxp8MjUBytgnhvxqq3ZTqZHTVZo4JJh,945047,3744124,-2799077,623
2022-01-05 19:50:32.725554,2022-01-05 14:46:31-05:00,1250,Dng7By2saPu5TVxcvXidBe71ggBo8tiHkAXPi4kKL1tk,75ufEJmHbLHffphL7tvAXhGyftKLr1z2PXXoB2GGY5fG,True,13878844,3469711,21543,10771,10772,4BnQKPLuE3DMTtxp8MjUBytgnhvxqq3ZTqZHTVZo4JJh,861753,3468023,-2606270,620
2022-01-05 19:50:32.725554,2022-01-05 14:46:45-05:00,1251,6uZobpBuFcQeYgZ4dApFi6iy4DB9GLHP1AAsQcCj6212,SGGFiPjjhscwroiWMqY4jTAHFw8eakpsEv35wNoHUPY,True,2491935923,622983979,3839766,1919883,1919883,HfEnetJ7uBSmZWCjBNxdvv9HEC5nsW4wDV7wu6WnhWan,153590673,486434570,-332843897,616
2022-01-05 19:50:32.725554,2022-01-05 14:46:59-05:00,1252,GKNBtZbwK4w9hyXD1r38NTGcTJhpjt8R9WFCzdXup9Tk,7RLaL2XoFuqrcCcPEB6FzPJzLnAhjQpwcRmDfdpRXFgB,True,269705110,67426277,417132,208566,208566,DddJ7EWCmYEEZETCBNgAUSg81Ls6fZtiAaY5ekJ5sXx1,16685281,84931979,-68246698,618
2022-01-05 19:50:32.725554,2022-01-05 14:47:03-05:00,1253,BhiAaiZu7fF8ndggJrLyiFVCRq526cNBw7VaeascEmNL,4en8MipPi7vq15NGhpPMQfptNdEyhp2j7fpgxBBtjyfz,True,12820038,3205009,20048,10024,10024,3RdfgDvLvsdZG5Cf6hKiKMQMqfidyxHzjYvUx1FZpeHQ,801951,3123641,-2321690,625
2022-01-05 19:50:32.725554,2022-01-05 14:47:03-05:00,1254,8BTja7VnFPe6M9BHTqg5LTpX6vd4ugTeWLzpq3oFP8WM,pscjH4sPnNL6zQBmvHjEEbix6BTstnsrSwGysNWyPkd,True,587133,146781,907,453,454,DddJ7EWCmYEEZETCBNgAUSg81Ls6fZtiAaY5ekJ5sXx1,36296,140309,-104013,618
2022-01-05 19:50:32.725554,2022-01-05 14:47:09-05:00,1255,7iUx7JBwqUvPVPeCqMEXQdLccZJmaFYm1DUQiu3ouHa3,3EVZzhRmJnX9ZiBZZo9tenDtMogAyuA1yf2cKzvUWiuu,True,16828356,4207088,25935,12967,12968,4BnQKPLuE3DMTtxp8MjUBytgnhvxqq3ZTqZHTVZo4JJh,1037437,4393883,-3356446,616
2022-01-05 19:50:32.725554,2022-01-05 14:47:09-05:00,1256,7bnCuBLXnPS3wDBunrzoV5qm1GwfnPfRBwV2f9Xzo3Aj,9Xd7GNcFrx7z66DRW8kK3d1jN4tzuiwv9jyDFbHUx9vW,True,598701,149674,932,466,466,DddJ7EWCmYEEZETCBNgAUSg81Ls6fZtiAaY5ekJ5sXx1,37312,144652,-107340,623
2022-01-05 19:50:32.725554,2022-01-05 14:47:09-05:00,1257,DGbj8tnqECzM9FG8j225Ap7A4Fdm3J1Ksm32JBFG7igv,Cd3D2UVwoSZLygM2e3UQppQANsokpmx5CNBs1C5zueay,True,13522720,3380679,20534,10267,10267,DddJ7EWCmYEEZETCBNgAUSg81Ls6fZtiAaY5ekJ5sXx1,821390,3325278,-2503888,607
2022-01-05 19:50:32.725554,2022-01-05 14:47:11-05:00,1258,GWEfWJimTKDJuxSTAb7SxkT3L3FhPPu8wJzYYF8H4SgD,BdeMcj3cMyKVPeF7Mt9Jdpxgzq9P6c79qJR6ctiiDauL,True,983320945,245830236,1529908,764954,764954,DddJ7EWCmYEEZETCBNgAUSg81Ls6fZtiAaY5ekJ5sXx1,61196324,199229425,-138033101,622
2022-01-05 19:50:32.725554,2022-01-05 14:49:09-05:00,1259,A7SMcwnq3DewryUj1jScnAboKGnuDVcW15F3ubNcG66Y,5qLCE37FdeWLCQnkfNJViFMGNcDeiELgE3VgPbBUuDGF,True,675892713,168973178,1056617,528308,528309,4BnQKPLuE3DMTtxp8MjUBytgnhvxqq3ZTqZHTVZo4JJh,42264697,162125136,-119860439,625
2022-01-05 19:50:32.725554,2022-01-05 14:50:18-05:00,1260,2PHDkmat5jQ65XkJYhDSw6ZwHcKpSw85o8MaPFhfLBry,8NtkXoUPt4wkcqQJuPJYt5oq9hG4BdeY26dQrsybDWWX,True,329824347,82456086,512098,256049,256049,DddJ7EWCmYEEZETCBNgAUSg81Ls6fZtiAaY5ekJ5sXx1,20483941,62666918,-42182977,621
2022-01-05 19:56:58.500064,2022-01-05 14:50:32-05:00,1261,D3mXrJzhHf8qRaoCKLschUxAFoijFCFuT6bmNZH4W7Cj,9E3Xtqw7TncXWnbhAbFJMtuNmP6WS3ooGuptzyzw7UpA,True,1698436,424609,2654,1327,1327,4BnQKPLuE3DMTtxp8MjUBytgnhvxqq3ZTqZHTVZo4JJh,106194,495845,-389651,625
2022-01-05 19:56:58.500064,2022-01-05 14:50:47-05:00,1262,2NdwSLxsGok8PczpCZj9CVX2BymNU5MvHt7hWfGetg2M,8AQbDXeA6mD9QoZBFJcYbnHvZwKNxzA9CCHLAgdSfTA3,True,312710,78177,487,243,244,4BnQKPLuE3DMTtxp8MjUBytgnhvxqq3ZTqZHTVZo4JJh,19501,81699,-62198,623
2022-01-05 19:56:58.500064,2022-01-05 14:51:17-05:00,1263,GJ3PbEfPK8jjrPgMmZtvN5fMSSy2dtiiAtZ8wcfgxVuc,FCUDVFb2TjDvehHE8fVBofqSykpb9W6Afc9QeHtj7te7,True,2249983607,562495901,3487599,1743799,1743800,3RdfgDvLvsdZG5Cf6hKiKMQMqfidyxHzjYvUx1FZpeHQ,139503965,652297255,-512793290,620
2022-01-05 19:56:58.500064,2022-01-05 14:51:23-05:00,1264,Mcbzp1LhZwpfmXTv1pqe9D1jCKHw443j9QKp6tUpzgM,8uforSMAKEih5jHfHp3gCqCvaugtCmhzVfVHA63Akz7F,True,58505089,14626272,91549,45774,45775,DddJ7EWCmYEEZETCBNgAUSg81Ls6fZtiAaY5ekJ5sXx1,3661982,15462398,-11800416,625
2022-01-05 19:56:58.500064,2022-01-05 14:51:23-05:00,1265,9jdfc9GFTecsdRuTjWFGX13niKKmeBxRgtv5j86uhSnU,HLWMShobjSkaLyXrNjgwVaUGVtbtdUSnr1XjqpXn1bLR,True,8586900,2146725,13297,6648,6649,4BnQKPLuE3DMTtxp8MjUBytgnhvxqq3ZTqZHTVZo4JJh,531898,1819271,-1287373,619
2022-01-05 19:56:58.500064,2022-01-05 14:51:39-05:00,1266,G25vsB3sDqRhHoSK4KwR1TywfrJDtpejVbbevEG9sQ9a,5xFC3Hm13magnAA9GD1EnwC9PrPoEfQ7omEa9p9zCrB1,True,18171187,4542796,28221,14110,14111,3RdfgDvLvsdZG5Cf6hKiKMQMqfidyxHzjYvUx1FZpeHQ,1128855,4320689,-3191834,621
2022-01-05 19:56:58.500064,2022-01-05 14:51:45-05:00,1267,7LBZi7Ec4VKhtNJbFQYYY8CvFbsLPCvqmn8Rd5EVhn9n,CBgkKDhmsEa8Ug8nE9Yu95gLDbDQa9FNGpdjVRfEDXcq,True,1184886367,296221591,1841983,920991,920992,4BnQKPLuE3DMTtxp8MjUBytgnhvxqq3ZTqZHTVZo4JJh,73679338,273293020,-199613682,621
2022-01-05 19:56:58.500064,2022-01-05 14:51:48-05:00,1268,CUhCSd7jHvycC89L6EqMoDWcWVTXXHhAeXVyB4362qZg,J7B9JBV1xR8a7DKKrw3JwGusY4H2bSQuyHtod2Fzf4jq,True,26216201,6554050,40829,20414,20415,4BnQKPLuE3DMTtxp8MjUBytgnhvxqq3ZTqZHTVZo4JJh,1633187,6076986,-4443799,622
2022-01-05 19:56:58.500064,2022-01-05 14:51:48-05:00,1269,2YcB3QQGWho5oogDd1nK3cpLQzwwwXGxybrhe2xDkDxq,5DjAUp6CxKStYTaXSnzjvYkfqCXfG8Y61bWw5UwbbE3q,True,42100582,10525145,65635,32817,32818,4BnQKPLuE3DMTtxp8MjUBytgnhvxqq3ZTqZHTVZo4JJh,2625416,13706309,-11080893,623
2022-01-05 19:56:58.500064,2022-01-05 14:51:56-05:00,1270,4gzW9gBbEMnNm1epY6MMJ1XfxGMtvn2mKFyKPQ2Gyb79,G6x862hmMJ2PLpyyPDwVPGapXjvEeNkqFRTAS3jWVozB,True,64098465,16024616,98653,49326,49327,72FwbpFGoLEazJEdpqNtPNefsadUrimUqma9wSoy4qiS,3946139,21024755,-17078616,615
2022-01-05 19:56:58.500064,2022-01-05 14:52:17-05:00,1271,7LRBswSEDBjJzQ4YurfTxLydh7tFS2jVn5V95Z6wL7ci,fD41VYGmk66MW46KKb23vAqQvUSDScgXnVdsHhJBZzu,True,3452529,863132,5399,2699,2700,4BnQKPLuE3DMTtxp8MjUBytgnhvxqq3ZTqZHTVZo4JJh,215967,813442,-597475,625
2022-01-05 19:56:58.500064,2022-01-05 14:52:26-05:00,1272,Hy3kzXneDN6FUkiZctU1vWe97BYvj6yZ7QvQzehfWmNr,EhXgQg8BTniANV525RpY76z7Hrh6DuqrMChjqEoXfVJe,True,25488018,6372004,39886,19943,19943,3RdfgDvLvsdZG5Cf6hKiKMQMqfidyxHzjYvUx1FZpeHQ,1595467,7187148,-5591681,625
2022-01-05 19:56:58.500064,2022-01-05 14:53:29-05:00,1273,HAk9c831TRUhvpoK4d7PTqfJuJhSjnJUXWpnYsH85bDJ,DVSa3CJrVLTHAeFYjEF89ZjWRm86QwruUk2Y8RvGpjsr,True,647652,161911,1012,506,506,4BnQKPLuE3DMTtxp8MjUBytgnhvxqq3ZTqZHTVZo4JJh,40481,153875,-113394,625
2022-01-05 19:56:58.500064,2022-01-05 14:54:08-05:00,1274,EgU9hX6VK7YXeCgCHVaJAMekCcyZa2MVWdKra5pN7Gwv,7y8Ad9XY34bqREvheXHT2tr8Jy11D6X3pu7yLVtjU4QV,True,266967568,66741892,415946,207973,207973,HfEnetJ7uBSmZWCjBNxdvv9HEC5nsW4wDV7wu6WnhWan,16637861,63971024,-47333163,623
2022-01-05 19:56:58.500064,2022-01-05 14:54:08-05:00,1275,Buioe5v3DyFwD9nquW5XdYeVYbSABCyg79eUHEvtvfaW,7T9gi7prCcZJkYJMSB5Ef6Bu4pAuBw4XLvumSFnqKDSi,True,19066343,4766585,29399,14699,14700,4BnQKPLuE3DMTtxp8MjUBytgnhvxqq3ZTqZHTVZo4JJh,1175966,5491926,-4315960,616
2022-01-05 19:56:58.500064,2022-01-05 14:54:47-05:00,1276,7aKxZg1aoLuB51JUw7fruF77ts7SWoB7pcLBZKHZMynr,AAnbLY82UGULqaDNdyJHrYu7X3hGaBuiTkGWmh8qKTc,True,182012666565,45503166640,282829961,141414980,141414981,DddJ7EWCmYEEZETCBNgAUSg81Ls6fZtiAaY5ekJ5sXx1,11313198446,1026613000,10286585446,621
2022-01-05 19:56:58.500064,2022-01-05 14:54:51-05:00,1277,gMjmD7WioyUdQdwNqE5fobLcxPwoJv5rAvLmJaf8Jjw,5n77euFjVJiwKrnbYq1KpcENW1mzBZj2BuDGyzazrkJ8,True,13387534,3346883,20865,10432,10433,DddJ7EWCmYEEZETCBNgAUSg81Ls6fZtiAaY5ekJ5sXx1,834625,3424716,-2590091,623
2022-01-05 19:56:58.500064,2022-01-05 14:54:51-05:00,1278,BAzH5niE2GX9CHGn3jK6Wv8Dd59PT95dX4dgfZXWoLPT,YNRnuEoNBPFsr7W91gc85TXAdA4ZnXfF2x951zbeRKF,True,604431,151106,937,468,469,DddJ7EWCmYEEZETCBNgAUSg81Ls6fZtiAaY5ekJ5sXx1,37485,145518,-108033,620
2022-01-05 19:56:58.500064,2022-01-05 14:55:00-05:00,1279,EEcTbsFTUEifcdbPyjBLkS943daEx1RpR8F3uZxKRZbT,8V3JzDQ1VWYQLas8fxUsWJZZHe4gEmn74RehtUwLw3k5,True,144057246,36014311,222762,111381,111381,4BnQKPLuE3DMTtxp8MjUBytgnhvxqq3ZTqZHTVZo4JJh,8910481,34246741,-25336260,618
2022-01-05 19:56:58.500064,2022-01-05 14:55:04-05:00,1280,H6tDNj9cHac223ckAnNfnC4bAJuNLBnf2pFk2iQdMzMP,28UL9dqgayCqCAexScXjdpobYGVDN44SGBVNAfBByk8C,True,1800446066,450111516,2782132,1391066,1391066,4BnQKPLuE3DMTtxp8MjUBytgnhvxqq3ZTqZHTVZo4JJh,111285319,531425483,-420140164,618
2022-01-05 19:56:58.500064,2022-01-05 14:55:27-05:00,1281,Gs3WP18hbzNpbBgiU39e6tfkggfCKRyNqPqJQcthuHFD,4XAY25YUma6gUdG2GdbXeivum3t21g93ZagfWGTZYkWZ,True,145269518,36317379,227042,113521,113521,HfEnetJ7uBSmZWCjBNxdvv9HEC5nsW4wDV7wu6WnhWan,9081701,43680168,-34598467,625
2022-01-05 19:56:58.500064,2022-01-05 14:55:31-05:00,1282,HhwiZPKZBGa16oVi739s4qtMDMTwzWXc7iwNfX63t2UP,5AnbMbAFKy85yHt5y2M5S38nNkA1vT4ejY5NjGbRNUqn,True,37211486,9302871,58208,29104,29104,DddJ7EWCmYEEZETCBNgAUSg81Ls6fZtiAaY5ekJ5sXx1,2328328,12573336,-10245008,625
2022-01-05 20:10:17.052010,2022-01-05 14:57:00-05:00,1283,36ByQojnxEckWdQTjqHfxKqCx9yjqWQsPsZyqaN72UWR,AZoirtS1fjX61agRM64tqThVinnJTh3BWgiHyNHPTgZP,True,22451736,5612933,34682,17341,17341,DddJ7EWCmYEEZETCBNgAUSg81Ls6fZtiAaY5ekJ5sXx1,1387317,6442076,-5054759,617
2022-01-05 20:10:17.052010,2022-01-05 14:57:44-05:00,1284,5jin5wXjQQ25nGM2ECrCXcg1a95vquh6kM7rMRru6Ke7,EKM657EQ8HWWgf4cssByoYHoXGjFfTspTKXAGmygAPQG,True,1009219274,252304818,1575866,787933,787933,HfEnetJ7uBSmZWCjBNxdvv9HEC5nsW4wDV7wu6WnhWan,63034647,242458248,-179423601,624
2022-01-05 20:10:17.052010,2022-01-05 14:58:12-05:00,1285,3njiRuSRMXRzKmamyiR72Hc38PU8UDDmWdfPhgxmGxEW,5WoF3gkgygyNNbwxWgVfqGWkExcDixuzgJQQjXEZQ6J5,True,6840306938,1710076734,10680227,5340113,5340114,HfEnetJ7uBSmZWCjBNxdvv9HEC5nsW4wDV7wu6WnhWan,427209087,2760874243,-2333665156,624
2022-01-05 20:10:17.052010,2022-01-05 14:58:18-05:00,1286,J1sBDjpdBZcsSBS5eg95SSRjRqmQUR9cXJCsLJu8yCUt,F5wRpD2senMkGbL8Uquqo8W9x5NQDDa268dHuVFAZCww,True,28412966,7103241,43966,21983,21983,HfEnetJ7uBSmZWCjBNxdvv9HEC5nsW4wDV7wu6WnhWan,1758646,9404196,-7645550,618
2022-01-05 20:10:17.052010,2022-01-05 14:58:55-05:00,1287,8MKNsuGVaoYpdQy6NNyxDvRzh2DAquBUtri4nDsixUxs,D7M1SDmpZAs8vdPCCCa96UbDF15YQDxHmoGWB57tHiir,True,110970781,27742695,173430,86715,86715,HfEnetJ7uBSmZWCjBNxdvv9HEC5nsW4wDV7wu6WnhWan,6937202,29245751,-22308549,625
2022-01-05 20:10:17.052010,2022-01-05 14:59:38-05:00,1288,BgoKAyBNaJ1geeQ2FcGSHEQDWATVD3w3wmcNHtj8Awu3,8Haz7duE2ycueaJsGdrGNnK79KGHwnzKBpoafC8RZGg2,True,221085196,55271299,344724,172362,172362,HfEnetJ7uBSmZWCjBNxdvv9HEC5nsW4wDV7wu6WnhWan,13788979,74332236,-60543257,623
2022-01-05 20:10:17.052010,2022-01-05 15:00:07-05:00,1289,F2v1YwVAwXLiUgsJ5uwn4qAAkTXitn1E75fJcPnGuAcy,5rdJ4H5GxPg4Juu77mGc7uya5LwEqLzDSRyG8mQ2mDbK,True,516602335,129150583,806393,403196,403197,4BnQKPLuE3DMTtxp8MjUBytgnhvxqq3ZTqZHTVZo4JJh,32255729,123961513,-91705784,624
2022-01-05 20:10:17.052010,2022-01-05 15:00:11-05:00,1290,Fd2HrzBAr4JobRPARZwpQHHVoSCEoog32A6tKMWAC1sK,BYappsar5sQf8VLem4wrLuTtrDFH9y8pEx1aMxfuU4Pq,True,806661777,201665444,1262402,631201,631201,4BnQKPLuE3DMTtxp8MjUBytgnhvxqq3ZTqZHTVZo4JJh,50496115,193544626,-143048511,625
2022-01-05 20:10:17.052010,2022-01-05 15:00:12-05:00,1291,2VyFcgZDH1HTEvD1XaWhwqBCMmZ1k6TmZ3fEpPcBZR9E,G1wFJETTpdoc7CfypGCzkq1jssXPfUkiuLjK2cwVZ9dJ,True,2156573,539142,3358,1679,1679,72FwbpFGoLEazJEdpqNtPNefsadUrimUqma9wSoy4qiS,134333,545902,-411569,622
2022-01-05 20:10:17.052010,2022-01-05 15:00:16-05:00,1292,6eBSLXDMVoW2nG3n7s42RXDH8byY3C6n1RsUuegBLSrG,37dYrKnTXYer7Bu9xFfpArA4ZNo2B9bycFw9HywDtTRx,True,265643183,66410795,414680,207340,207340,HfEnetJ7uBSmZWCjBNxdvv9HEC5nsW4wDV7wu6WnhWan,16587215,60372671,-43785456,624
2022-01-05 20:10:17.052010,2022-01-05 15:06:12-05:00,1293,FtNFtrFpUxLGDP3KTusCxgWMiDqXErcBLzPHVXDwTvNH,FnJfrBQYt9arf1sY3MJn9r8ZWGgjG8mVt5X8pcond5p,True,592163,148039,921,460,461,HfEnetJ7uBSmZWCjBNxdvv9HEC5nsW4wDV7wu6WnhWan,36863,143988,-107125,622
2022-01-05 20:10:17.052010,2022-01-05 15:06:14-05:00,1294,56488NdcUy6Hi6X5SLs2GFtW5pG4u5wJpH7vHdxTCx4z,tGgXjJeVr3W2m3T2NXPCqpBEd6HJKE2cRsgCyiDZQy4,True,315867272,78966817,486476,243238,243238,DddJ7EWCmYEEZETCBNgAUSg81Ls6fZtiAaY5ekJ5sXx1,19459041,103591769,-84132728,616
2022-01-05 20:10:17.052010,2022-01-05 15:06:16-05:00,1295,6woJkgUd2cpQQQBEp1C2G9NsYAvPwYmZXXTd6AxhieMy,E6xCdLJbDq5qFsvHEffD1Qfqrsj19H81mbj7XMUXUPnr,True,153207695,38301923,237643,118821,118822,HfEnetJ7uBSmZWCjBNxdvv9HEC5nsW4wDV7wu6WnhWan,9505749,51528901,-42023152,620
2022-01-05 20:10:17.052010,2022-01-05 15:06:16-05:00,1296,AoPQqPjLPi8fZiLkhMGLRj6oD5k2asrvJtCkpW19DvGr,H5Sgmf1VuY13iHjPuLJ2q9wtSdkXG1AQsEv2eq6zzm8Y,True,10696916,2674228,16707,8353,8354,DddJ7EWCmYEEZETCBNgAUSg81Ls6fZtiAaY5ekJ5sXx1,668318,2874487,-2206169,624
2022-01-05 20:10:17.052010,2022-01-05 15:06:19-05:00,1297,BtnTjb4mghmBK9KnLp2JzyGqfKB8tHskrGL4MzjAdF6V,BLStL7zka6qakHMhY4V6jKJT5agS1LtWMdWBZ1eP1Vi7,True,668280,167068,1043,521,522,HfEnetJ7uBSmZWCjBNxdvv9HEC5nsW4wDV7wu6WnhWan,41754,164156,-122402,624
2022-01-05 20:10:17.052010,2022-01-05 15:06:24-05:00,1298,AaMCg49sJwNtdB5wHACg15TYAzzJXy8xtG4zuVXhKiVE,HbDYqDa9bewGPvsiaHRM9HmEvh1scPaUaGvqog66gYir,True,10791584,2697895,16884,8442,8442,4BnQKPLuE3DMTtxp8MjUBytgnhvxqq3ZTqZHTVZo4JJh,675392,2907264,-2231872,625
2022-01-05 20:10:17.052010,2022-01-05 15:06:49-05:00,1299,DH2tcZVt4nHQbph6znZRrwcyhjwiNYtgeamu72vcC6nR,ACsbP5BDFQEHQHTsdrWTBShhEUh9HeAKsE7iwyK72v2p,True,7405234,1851308,11231,5615,5616,4BnQKPLuE3DMTtxp8MjUBytgnhvxqq3ZTqZHTVZo4JJh,449261,2538762,-2089501,606
2022-01-05 20:10:17.052010,2022-01-05 15:07:13-05:00,1300,7mYQ2DJZ1YYMpNbpA93hCDtzQDhEHjAGxLJt2g4KeYTW,8nTKeruC3wiPjT7VytdM2gX7msjwbHxTkyhsR88GJgpc,True,212278932,53069733,325835,162917,162918,4BnQKPLuE3DMTtxp8MjUBytgnhvxqq3ZTqZHTVZo4JJh,13033412,45754480,-32721068,613
2022-01-05 20:10:17.052010,2022-01-05 15:07:13-05:00,1301,Dn916KSmX3HqxT53hrxrbCrV3tdRMCPdaoiRLqetMrth,ATCXRiXgnjRRUbSTPBvtBXMENCqsViexSZbZ6aDaXXWA,True,18828016,4707003,29356,14678,14678,4BnQKPLuE3DMTtxp8MjUBytgnhvxqq3ZTqZHTVZo4JJh,1174265,4833030,-3658765,623
2022-01-05 20:10:17.052010,2022-01-05 15:07:13-05:00,1302,8eTH6eJyyVeMno3UQkffeBg32xofKsQfkhLhXdtaf87s,BCFC7CPXrQPsUfJb2eYSht8GhaApWHpc49AeCXqaYq13,True,10953558,2738389,17087,8543,8544,4BnQKPLuE3DMTtxp8MjUBytgnhvxqq3ZTqZHTVZo4JJh,683512,2943461,-2259949,624
2022-01-05 20:10:17.052010,2022-01-05 15:07:13-05:00,1303,5gN3624v6n1zQ1BKtZi1e9ZLpbCa4MEfhgHySFB81Qfm,UXT3oB5ud18rBsygsfxwA93kQYdSNbbzTCjt4gtU2jP,True,12605446,3151361,19572,9786,9786,4BnQKPLuE3DMTtxp8MjUBytgnhvxqq3ZTqZHTVZo4JJh,782890,3421743,-2638853,621
2022-01-05 20:10:17.052010,2022-01-05 15:07:14-05:00,1304,FoYrQCyDQ75YMNvkgTULbVHYmdrsoFJHohBLPfeF5rEH,DUyVhESZMDUS6Rqsz92CnW2KbWzAs6soEzZqD59XAKzY,True,262487590,65621897,392279,196139,196140,4BnQKPLuE3DMTtxp8MjUBytgnhvxqq3ZTqZHTVZo4JJh,15691177,80170560,-64479383,597
2022-01-05 20:10:17.052010,2022-01-05 15:07:31-05:00,1305,67Z7ZGhNu5xxEh9BYKWcXp9m1T4tFiE1o1M16hCzUWQA,CT7YKWixz7BhTbvg5F6M5HCyPGnHoFLNFuDV9GhoLTo3,True,87387416,21846854,136540,68270,68270,4BnQKPLuE3DMTtxp8MjUBytgnhvxqq3ZTqZHTVZo4JJh,5461628,27224265,-21762637,624
2022-01-05 20:10:17.052010,2022-01-05 15:07:31-05:00,1306,EmGW2aAG69ssWqCtbfDocRaM2u3TJsczn2HHP9jdmRvD,aypkDKsp9uqAB4F6mwvm5LofpsrFBuZT2MMWtE2eHdB,True,17260610,4315152,26503,13251,13252,4BnQKPLuE3DMTtxp8MjUBytgnhvxqq3ZTqZHTVZo4JJh,1060146,3797516,-2737370,614
2022-01-05 20:10:17.052010,2022-01-05 15:07:31-05:00,1307,ANQkPUoMjLHyRtypeKzxsKW1DFauQsh9SnB3rRgRXM1Y,7RHAExWpG8Q3PXwKhJs2yXmYK9WogGydvFYpx28p6pgr,True,1940668508,485167127,2981094,1490547,1490547,HfEnetJ7uBSmZWCjBNxdvv9HEC5nsW4wDV7wu6WnhWan,119243765,604468201,-485224436,614
2022-01-05 20:10:17.052010,2022-01-05 15:07:35-05:00,1308,8RmB8o4zux2sD48dEsKpsX475KRxTwdk8QULUDU9xx8R,AKSiZnb4YKVB6B86aPPqvyXquhvN9xqt45bexBCZ7nx,True,1693283982,423320995,2585537,1292768,1292769,4BnQKPLuE3DMTtxp8MjUBytgnhvxqq3ZTqZHTVZo4JJh,103421506,516349533,-412928027,610
2022-01-05 20:10:17.052010,2022-01-05 15:07:59-05:00,1309,7jvKp6onXyWgwsFrFWj4hYTXJsYYD6ot5mn6rPFuJriy,J7N6HiozevJVTiY9hDEUs2ud5BwT5QSE7wnMBS1w5ie2,True,640245650,160061412,992146,496073,496073,4BnQKPLuE3DMTtxp8MjUBytgnhvxqq3ZTqZHTVZo4JJh,39685876,200469198,-160783322,619
2022-01-05 20:10:17.052010,2022-01-05 15:07:59-05:00,1310,D58t4uTjFumsUeYFaKnpV8BRTEQEqKXBreFTdwGrott7,67p6kHDfVqQijfcwugvZK59c3aRRH9x3eHxruqH8WEqF,True,10897846,2724461,16876,8438,8438,DddJ7EWCmYEEZETCBNgAUSg81Ls6fZtiAaY5ekJ5sXx1,675078,3027492,-2352414,619
2022-01-05 20:10:17.052010,2022-01-05 15:07:59-05:00,1311,4KMzwWHPeW51cxu4nMpbqCaqo96dMqaHWyRCGQktfQfd,F7q4GNYcbnZa8dJ4qovQwjmxpKpdEmdxQMXRPb9nQupa,True,10892187,2723046,16789,8394,8395,72FwbpFGoLEazJEdpqNtPNefsadUrimUqma9wSoy4qiS,671592,3026318,-2354726,616
2022-01-05 20:10:17.052010,2022-01-05 15:07:59-05:00,1312,72L76qDRMK3M7X52zuuB9GVyvFFLDBZwFMpVjWjghXzA,4m2ZVuemUctu1edv4YJVAcjXzKwpbCmBujzoUmLDeA7h,True,11144607,2786151,17436,8718,8718,4BnQKPLuE3DMTtxp8MjUBytgnhvxqq3ZTqZHTVZo4JJh,697440,3018967,-2321527,625
2022-01-05 20:10:17.052010,2022-01-05 15:08:05-05:00,1313,Dng7By2saPu5TVxcvXidBe71ggBo8tiHkAXPi4kKL1tk,75ufEJmHbLHffphL7tvAXhGyftKLr1z2PXXoB2GGY5fG,True,10205987,2551496,15885,7942,7943,4BnQKPLuE3DMTtxp8MjUBytgnhvxqq3ZTqZHTVZo4JJh,635431,2793282,-2157851,622
2022-01-05 20:10:17.052010,2022-01-05 15:08:08-05:00,1314,Cv5oVktxmqbU1SxraxH67NEWMKnjgA18R832Fhe9h74a,Cs7xBD4BDiohyopnaYDDChUtR9vmx7uwot6Qp9beQLzt,True,9557699,2389424,14802,7401,7401,4BnQKPLuE3DMTtxp8MjUBytgnhvxqq3ZTqZHTVZo4JJh,592095,2624971,-2032876,619
2022-01-05 20:10:17.052010,2022-01-05 15:08:08-05:00,1315,GKNBtZbwK4w9hyXD1r38NTGcTJhpjt8R9WFCzdXup9Tk,7RLaL2XoFuqrcCcPEB6FzPJzLnAhjQpwcRmDfdpRXFgB,True,198345311,49586327,307793,153896,153897,4BnQKPLuE3DMTtxp8MjUBytgnhvxqq3ZTqZHTVZo4JJh,12311747,67431347,-55119600,620
2022-01-05 20:10:17.052010,2022-01-05 15:08:11-05:00,1316,EBUcTqh9AYyRokZRzLbPKL9ZmTUx6KcDEbBeuCLGwqYC,B5WSXfHzYQhUFE2T97GaiqSkeejTWKKGVjMkcFrxEvyJ,True,609830202,152457550,926635,463317,463318,HfEnetJ7uBSmZWCjBNxdvv9HEC5nsW4wDV7wu6WnhWan,37065422,149105311,-112039889,607
2022-01-05 20:10:17.052010,2022-01-05 15:08:22-05:00,1317,6uZobpBuFcQeYgZ4dApFi6iy4DB9GLHP1AAsQcCj6212,SGGFiPjjhscwroiWMqY4jTAHFw8eakpsEv35wNoHUPY,True,1832647097,458161772,2832400,1416200,1416200,4BnQKPLuE3DMTtxp8MjUBytgnhvxqq3ZTqZHTVZo4JJh,113296031,399290182,-285994151,618
2022-01-05 20:10:17.052010,2022-01-05 15:08:28-05:00,1318,Gbxc51WERLLeCtiHv7rDvE52aqF541RoQWG5n5aqErq6,4ngBoHbfXijLMqGKxFMNht9sbmxy2g5eqBmn8QsBmbx1,True,10919893,2729973,16891,8445,8446,3RdfgDvLvsdZG5Cf6hKiKMQMqfidyxHzjYvUx1FZpeHQ,675651,3052719,-2377068,618
2022-01-05 20:10:17.052010,2022-01-05 15:08:29-05:00,1319,BhiAaiZu7fF8ndggJrLyiFVCRq526cNBw7VaeascEmNL,4en8MipPi7vq15NGhpPMQfptNdEyhp2j7fpgxBBtjyfz,True,9424179,2356044,14742,7371,7371,3RdfgDvLvsdZG5Cf6hKiKMQMqfidyxHzjYvUx1FZpeHQ,589703,2521823,-1932120,625
2022-01-05 20:10:17.052010,2022-01-05 15:08:45-05:00,1320,DGbj8tnqECzM9FG8j225Ap7A4Fdm3J1Ksm32JBFG7igv,Cd3D2UVwoSZLygM2e3UQppQANsokpmx5CNBs1C5zueay,True,9955141,2488785,15311,7655,7656,3RdfgDvLvsdZG5Cf6hKiKMQMqfidyxHzjYvUx1FZpeHQ,612451,2677270,-2064819,615
2022-01-05 20:10:17.052010,2022-01-05 15:08:59-05:00,1321,GWEfWJimTKDJuxSTAb7SxkT3L3FhPPu8wJzYYF8H4SgD,BdeMcj3cMyKVPeF7Mt9Jdpxgzq9P6c79qJR6ctiiDauL,True,722883314,180720828,1124384,562192,562192,4BnQKPLuE3DMTtxp8MjUBytgnhvxqq3ZTqZHTVZo4JJh,44975396,163120383,-118144987,622
2022-01-05 20:10:17.052010,2022-01-05 15:09:00-05:00,1322,8BTja7VnFPe6M9BHTqg5LTpX6vd4ugTeWLzpq3oFP8WM,pscjH4sPnNL6zQBmvHjEEbix6BTstnsrSwGysNWyPkd,True,431915,107977,672,336,336,HfEnetJ7uBSmZWCjBNxdvv9HEC5nsW4wDV7wu6WnhWan,26903,113353,-86450,622
2022-01-05 20:10:17.052010,2022-01-05 15:09:01-05:00,1323,CRaKcudjkQiSw5YPVjTLVdXvJskeGiHSYtq5ZcMPJhgQ,AgqTg3b3bAcaBmRidhNC4Uf9ZwNbeH52RQEqumWyuUs7,True,23275897,5818974,36339,18169,18170,HfEnetJ7uBSmZWCjBNxdvv9HEC5nsW4wDV7wu6WnhWan,1453582,7837967,-6384385,624
2022-01-05 20:10:17.052010,2022-01-05 15:09:22-05:00,1324,9vcKW1GfrDZ3KLPh2pEVFF8ZyKqD1pJW1hiE8H98Av7S,C6Ki27mo4sCHu6u8UnR1p7WSgsTjFQxGGR9Lk9n5Rhjq,True,74608724,18652181,115904,57952,57952,4BnQKPLuE3DMTtxp8MjUBytgnhvxqq3ZTqZHTVZo4JJh,4636173,17578069,-12941896,621
2022-01-05 20:10:17.052010,2022-01-05 15:09:27-05:00,1325,Ckqos6cdncPKj13DnCmDVZsZTqp6eS7277CRrT9WhcEr,AtUV8m7VQJvZq7GLCAHMf3jV7iamKEPnWVZHWuuVZQp1,True,33340612,8335153,51709,25854,25855,HfEnetJ7uBSmZWCjBNxdvv9HEC5nsW4wDV7wu6WnhWan,2068395,11244361,-9175966,620
2022-01-05 20:10:17.052010,2022-01-05 15:10:06-05:00,1326,HGJoZvLakWfSDFwuvShNBc4kCf7nP7VqzyM3mELpbFEf,12Qn5jin7QvsBngXqYAv4UstyG3b6nRf1jsLp9Dp8G7k,True,434887831,108721957,671278,335639,335639,4BnQKPLuE3DMTtxp8MjUBytgnhvxqq3ZTqZHTVZo4JJh,26851138,91912807,-65061669,617
2022-01-05 20:10:17.052010,2022-01-05 15:10:12-05:00,1327,4gzW9gBbEMnNm1epY6MMJ1XfxGMtvn2mKFyKPQ2Gyb79,G6x862hmMJ2PLpyyPDwVPGapXjvEeNkqFRTAS3jWVozB,True,47162813,11790703,73274,36637,36637,4BnQKPLuE3DMTtxp8MjUBytgnhvxqq3ZTqZHTVZo4JJh,2930991,16651050,-13720059,621
2022-01-05 20:30:06.452899,2022-01-05 15:10:17-05:00,1328,G25vsB3sDqRhHoSK4KwR1TywfrJDtpejVbbevEG9sQ9a,5xFC3Hm13magnAA9GD1EnwC9PrPoEfQ7omEa9p9zCrB1,True,13362836,3340708,20830,10415,10415,4BnQKPLuE3DMTtxp8MjUBytgnhvxqq3ZTqZHTVZo4JJh,833235,3492670,-2659435,623
2022-01-05 20:30:06.452899,2022-01-05 15:10:28-05:00,1329,7iUx7JBwqUvPVPeCqMEXQdLccZJmaFYm1DUQiu3ouHa3,3EVZzhRmJnX9ZiBZZo9tenDtMogAyuA1yf2cKzvUWiuu,True,12381428,3095356,19236,9618,9618,HfEnetJ7uBSmZWCjBNxdvv9HEC5nsW4wDV7wu6WnhWan,769446,3526623,-2757177,621
2022-01-05 20:30:06.452899,2022-01-05 15:10:48-05:00,1330,7bnCuBLXnPS3wDBunrzoV5qm1GwfnPfRBwV2f9Xzo3Aj,9Xd7GNcFrx7z66DRW8kK3d1jN4tzuiwv9jyDFbHUx9vW,True,440139,110033,686,343,343,HfEnetJ7uBSmZWCjBNxdvv9HEC5nsW4wDV7wu6WnhWan,27442,116838,-89396,623
2022-01-05 20:30:06.452899,2022-01-05 15:11:18-05:00,1331,3WcJUt8jQ1ngL3ZCGo6dFrc3GmTMTYtzeDva7mri2Tqx,HeG1Pz2oMjqtkfsRMsbqP3VpatnVEQzcWmKDVoFp4Htr,True,434619136,108654784,664336,332168,332168,4BnQKPLuE3DMTtxp8MjUBytgnhvxqq3ZTqZHTVZo4JJh,26573465,91903829,-65330364,611
2022-01-05 20:30:06.452899,2022-01-05 15:11:50-05:00,1332,A7SMcwnq3DewryUj1jScnAboKGnuDVcW15F3ubNcG66Y,5qLCE37FdeWLCQnkfNJViFMGNcDeiELgE3VgPbBUuDGF,True,496475849,124118962,765631,382815,382816,4BnQKPLuE3DMTtxp8MjUBytgnhvxqq3ZTqZHTVZo4JJh,30625271,130967501,-100342230,616
2022-01-05 20:30:06.452899,2022-01-05 15:11:59-05:00,1333,E1wp3bmkcY3eiEYyGYwhTCsr7BZ7RfPa5DJTZFupcFwj,452hVdYkD5SDDrA6hv6DLPFvyS8PvR2P6DPNScGxWTsW,True,17396362,4349090,26770,13385,13385,4BnQKPLuE3DMTtxp8MjUBytgnhvxqq3ZTqZHTVZo4JJh,1070824,3672442,-2601618,615
2022-01-05 21:03:51.466853,2022-01-05 15:56:09-05:00,1334,7LBZi7Ec4VKhtNJbFQYYY8CvFbsLPCvqmn8Rd5EVhn9n,CBgkKDhmsEa8Ug8nE9Yu95gLDbDQa9FNGpdjVRfEDXcq,True,871453704,217863426,1363133,681566,681567,HfEnetJ7uBSmZWCjBNxdvv9HEC5nsW4wDV7wu6WnhWan,54525359,221465700,-166940341,625
2022-01-05 21:03:51.466853,2022-01-05 15:56:33-05:00,1335,9WJBnVi84E926j7xEd566WzrZJkPJWRgmEnYj9vyjuad,4dLaFS5F7TGyLdwuJLMGkz3bSL53aHzd9ZfpNmhHxXeF,True,427985035,106996258,669051,334525,334526,4BnQKPLuE3DMTtxp8MjUBytgnhvxqq3ZTqZHTVZo4JJh,26762076,110005147,-83243071,625
2022-01-05 21:21:16.518883,2022-01-05 16:18:14-05:00,1336,D3mXrJzhHf8qRaoCKLschUxAFoijFCFuT6bmNZH4W7Cj,9E3Xtqw7TncXWnbhAbFJMtuNmP6WS3ooGuptzyzw7UpA,True,1249001,312250,1950,975,975,4BnQKPLuE3DMTtxp8MjUBytgnhvxqq3ZTqZHTVZo4JJh,78007,395072,-317065,624
2022-01-05 21:21:16.518883,2022-01-05 16:19:00-05:00,1337,EQUZQWk4WLT6LFeWZs3P9AQufFcoZouFETfhyxvuS2JM,Byc2mLXArmkjQPWaxCJksHZD2XpZyCQ2FRtDJyztU81V,True,2050813395,512703348,3186325,1593162,1593163,72FwbpFGoLEazJEdpqNtPNefsadUrimUqma9wSoy4qiS,127453035,651257952,-523804917,621
2022-01-05 21:21:16.518883,2022-01-05 16:19:00-05:00,1338,9jdfc9GFTecsdRuTjWFGX13niKKmeBxRgtv5j86uhSnU,HLWMShobjSkaLyXrNjgwVaUGVtbtdUSnr1XjqpXn1bLR,True,6320509,1580127,9883,4941,4942,4BnQKPLuE3DMTtxp8MjUBytgnhvxqq3ZTqZHTVZo4JJh,395354,1480551,-1085197,625
2022-01-05 21:21:16.518883,2022-01-05 16:19:00-05:00,1339,2NdwSLxsGok8PczpCZj9CVX2BymNU5MvHt7hWfGetg2M,8AQbDXeA6mD9QoZBFJcYbnHvZwKNxzA9CCHLAgdSfTA3,True,229872,57468,355,177,178,4BnQKPLuE3DMTtxp8MjUBytgnhvxqq3ZTqZHTVZo4JJh,14223,65533,-51310,618
2022-01-05 21:21:16.518883,2022-01-05 16:19:00-05:00,1340,Ar5QB4VBcUyzSCG23z2QNAbrWY55NbHCr1MNN6P2GAmh,BusFGTiDrJmxzwGUxWz9b3SFF3eseqtgh2DRHqyAwyVe,True,9975936,2493984,15453,7726,7727,72FwbpFGoLEazJEdpqNtPNefsadUrimUqma9wSoy4qiS,618125,2131980,-1513855,619
2022-01-05 21:21:16.518883,2022-01-05 16:19:02-05:00,1341,GJ3PbEfPK8jjrPgMmZtvN5fMSSy2dtiiAtZ8wcfgxVuc,FCUDVFb2TjDvehHE8fVBofqSykpb9W6Afc9QeHtj7te7,True,1656078075,414019518,2591706,1295853,1295853,DddJ7EWCmYEEZETCBNgAUSg81Ls6fZtiAaY5ekJ5sXx1,103668251,519710062,-416041811,625
2022-01-05 21:21:16.518883,2022-01-05 16:19:29-05:00,1342,Mcbzp1LhZwpfmXTv1pqe9D1jCKHw443j9QKp6tUpzgM,8uforSMAKEih5jHfHp3gCqCvaugtCmhzVfVHA63Akz7F,True,43017201,10754300,67110,33555,33555,HfEnetJ7uBSmZWCjBNxdvv9HEC5nsW4wDV7wu6WnhWan,2684416,12396369,-9711953,624
2022-01-05 21:21:16.518883,2022-01-05 16:20:06-05:00,1343,7LRBswSEDBjJzQ4YurfTxLydh7tFS2jVn5V95Z6wL7ci,fD41VYGmk66MW46KKb23vAqQvUSDScgXnVdsHhJBZzu,True,2538031,634507,3944,1972,1972,4BnQKPLuE3DMTtxp8MjUBytgnhvxqq3ZTqZHTVZo4JJh,157761,657234,-499473,621
2022-01-05 21:21:16.518883,2022-01-05 16:20:07-05:00,1344,8VT2nxz5ZYDJFd9uL2XZwEXxChd9pjuMJNMAcutZubL1,EhAkiRbouzUAWtqQFsN8HEEfi46UVN8H8tyBP7CbgeLe,True,197607,49401,306,153,153,4BnQKPLuE3DMTtxp8MjUBytgnhvxqq3ZTqZHTVZo4JJh,12262,48300,-36038,620
2022-01-05 21:21:16.518883,2022-01-05 16:20:38-05:00,1345,Buioe5v3DyFwD9nquW5XdYeVYbSABCyg79eUHEvtvfaW,7T9gi7prCcZJkYJMSB5Ef6Bu4pAuBw4XLvumSFnqKDSi,True,14035578,3508894,21860,10930,10930,4BnQKPLuE3DMTtxp8MjUBytgnhvxqq3ZTqZHTVZo4JJh,874412,4375565,-3501153,622
2022-01-05 21:21:16.518883,2022-01-05 16:20:50-05:00,1346,5hUZ9uQFcYnjAQVVaGLJWdKyg7y1XMpoo8osQ9DeY7Xd,BdYiKWsjuzJLcHh3814mJ4xQ9JxoQKKcr7AHZ7Vxoavq,True,873361,218340,1358,679,679,72FwbpFGoLEazJEdpqNtPNefsadUrimUqma9wSoy4qiS,54354,180839,-126485,622
2022-01-05 21:32:40.815757,2022-01-05 16:24:34-05:00,1347,Hy3kzXneDN6FUkiZctU1vWe97BYvj6yZ7QvQzehfWmNr,EhXgQg8BTniANV525RpY76z7Hrh6DuqrMChjqEoXfVJe,True,18734835,4683708,29158,14579,14579,3RdfgDvLvsdZG5Cf6hKiKMQMqfidyxHzjYvUx1FZpeHQ,1166344,5741288,-4574944,622
2022-01-05 21:32:40.815757,2022-01-05 16:25:26-05:00,1348,EEcTbsFTUEifcdbPyjBLkS943daEx1RpR8F3uZxKRZbT,8V3JzDQ1VWYQLas8fxUsWJZZHe4gEmn74RehtUwLw3k5,True,106011726,26502931,164904,82452,82452,3RdfgDvLvsdZG5Cf6hKiKMQMqfidyxHzjYvUx1FZpeHQ,6596165,27629716,-21033551,622
2022-01-05 21:32:40.815757,2022-01-05 16:25:28-05:00,1349,EgU9hX6VK7YXeCgCHVaJAMekCcyZa2MVWdKra5pN7Gwv,7y8Ad9XY34bqREvheXHT2tr8Jy11D6X3pu7yLVtjU4QV,True,196191141,49047785,301892,150946,150946,HfEnetJ7uBSmZWCjBNxdvv9HEC5nsW4wDV7wu6WnhWan,12075701,51610612,-39534911,615
2022-01-05 21:32:40.815757,2022-01-05 16:25:40-05:00,1350,H6tDNj9cHac223ckAnNfnC4bAJuNLBnf2pFk2iQdMzMP,28UL9dqgayCqCAexScXjdpobYGVDN44SGBVNAfBByk8C,True,1325140768,331285192,2063877,1031938,1031939,72FwbpFGoLEazJEdpqNtPNefsadUrimUqma9wSoy4qiS,82555098,422877990,-340322892,622
2022-01-05 21:32:40.815757,2022-01-05 16:27:56-05:00,1351,2YcB3QQGWho5oogDd1nK3cpLQzwwwXGxybrhe2xDkDxq,5DjAUp6CxKStYTaXSnzjvYkfqCXfG8Y61bWw5UwbbE3q,True,30950333,7737583,48162,24081,24081,HfEnetJ7uBSmZWCjBNxdvv9HEC5nsW4wDV7wu6WnhWan,1926505,10862306,-8935801,622
2022-01-05 21:32:40.815757,2022-01-05 16:28:55-05:00,1352,gMjmD7WioyUdQdwNqE5fobLcxPwoJv5rAvLmJaf8Jjw,5n77euFjVJiwKrnbYq1KpcENW1mzBZj2BuDGyzazrkJ8,True,9843442,2460860,15328,7664,7664,HfEnetJ7uBSmZWCjBNxdvv9HEC5nsW4wDV7wu6WnhWan,613152,2752932,-2139780,622
2022-01-05 21:32:40.815757,2022-01-05 16:29:02-05:00,1353,Gs3WP18hbzNpbBgiU39e6tfkggfCKRyNqPqJQcthuHFD,4XAY25YUma6gUdG2GdbXeivum3t21g93ZagfWGTZYkWZ,True,106808108,26702026,166715,83357,83358,4BnQKPLuE3DMTtxp8MjUBytgnhvxqq3ZTqZHTVZo4JJh,6668638,34761649,-28093011,624
2022-01-05 21:32:40.815757,2022-01-05 16:29:09-05:00,1354,HhwiZPKZBGa16oVi739s4qtMDMTwzWXc7iwNfX63t2UP,5AnbMbAFKy85yHt5y2M5S38nNkA1vT4ejY5NjGbRNUqn,True,27354254,6838563,42504,21252,21252,HfEnetJ7uBSmZWCjBNxdvv9HEC5nsW4wDV7wu6WnhWan,1700166,9938294,-8238128,621
2022-01-05 21:32:40.815757,2022-01-05 16:29:11-05:00,1355,2PHDkmat5jQ65XkJYhDSw6ZwHcKpSw85o8MaPFhfLBry,8NtkXoUPt4wkcqQJuPJYt5oq9hG4BdeY26dQrsybDWWX,True,242582521,60645630,377166,188583,188583,4BnQKPLuE3DMTtxp8MjUBytgnhvxqq3ZTqZHTVZo4JJh,15086672,51510286,-36423614,621
2022-01-05 21:32:40.815757,2022-01-05 16:29:11-05:00,1356,BxXXWywnC3dSyLPJHt7owfBhgSiBWzkuD3T8hGYLqCH6,4vuwEBXXbXFMPmbJJJRop4FCWGyKR1sXhBc3EWF6MiB8,True,1881367009,470341752,2910649,1455324,1455325,HfEnetJ7uBSmZWCjBNxdvv9HEC5nsW4wDV7wu6WnhWan,116425964,607033789,-490607825,618
2022-01-05 21:32:40.815757,2022-01-05 16:31:59-05:00,1357,BgoKAyBNaJ1geeQ2FcGSHEQDWATVD3w3wmcNHtj8Awu3,8Haz7duE2ycueaJsGdrGNnK79KGHwnzKBpoafC8RZGg2,True,162167715,40541928,243874,121937,121937,HfEnetJ7uBSmZWCjBNxdvv9HEC5nsW4wDV7wu6WnhWan,9754992,58809340,-49054348,601
2022-01-05 21:32:40.815757,2022-01-05 16:32:04-05:00,1358,J1sBDjpdBZcsSBS5eg95SSRjRqmQUR9cXJCsLJu8yCUt,F5wRpD2senMkGbL8Uquqo8W9x5NQDDa268dHuVFAZCww,True,20846108,5211527,31138,15569,15569,HfEnetJ7uBSmZWCjBNxdvv9HEC5nsW4wDV7wu6WnhWan,1245529,7443321,-6197792,597
2022-01-05 21:42:21.297267,2022-01-05 16:33:58-05:00,1359,6woJkgUd2cpQQQBEp1C2G9NsYAvPwYmZXXTd6AxhieMy,E6xCdLJbDq5qFsvHEffD1Qfqrsj19H81mbj7XMUXUPnr,True,112695325,28173831,176020,88010,88010,4BnQKPLuE3DMTtxp8MjUBytgnhvxqq3ZTqZHTVZo4JJh,7040835,40768995,-33728160,624
2022-01-05 21:42:21.297267,2022-01-05 16:34:02-05:00,1360,36ByQojnxEckWdQTjqHfxKqCx9yjqWQsPsZyqaN72UWR,AZoirtS1fjX61agRM64tqThVinnJTh3BWgiHyNHPTgZP,True,16499919,4124979,25199,12599,12600,HfEnetJ7uBSmZWCjBNxdvv9HEC5nsW4wDV7wu6WnhWan,1007998,5137966,-4129968,610
2022-01-05 21:42:21.297267,2022-01-05 16:34:28-05:00,1361,3VdSA9CED9f5swRwHX2U15U7J6Muaq8VPnCNy9CaGDHe,2YYstfnfdYic5NWmEbcUEHpccNUVd1EhuCkExvMsoMk8,True,138891541,34722885,213714,106857,106857,HfEnetJ7uBSmZWCjBNxdvv9HEC5nsW4wDV7wu6WnhWan,8548576,44540378,-35991802,615
2022-01-05 21:42:21.297267,2022-01-05 16:34:37-05:00,1362,9KD2AifD5wFD4QkHYuawXbJgLWHrfj2QPF3fT8jhGVA5,Ga9gAqmkuHbqrr31sUFPqa1xa5WNxLWJWGPUaMxQqLdj,True,26960211,6740052,41284,20642,20642,HfEnetJ7uBSmZWCjBNxdvv9HEC5nsW4wDV7wu6WnhWan,1651370,8810835,-7159465,612
2022-01-05 21:42:21.297267,2022-01-05 16:34:41-05:00,1363,8sneA6wAg6geVDJ1g7YWg4R1PfjuRVzeHp1nUBJinhZa,14i1uWtmcTjrdbg3DSr9vzd5NBnxqsn1A4QdgFBZqeYM,True,2390566,597640,3724,1862,1862,HfEnetJ7uBSmZWCjBNxdvv9HEC5nsW4wDV7wu6WnhWan,148984,529795,-380811,623
2022-01-05 21:42:21.297267,2022-01-05 16:35:30-05:00,1364,5Rxuqgs4CaSKbfDXqBMFXkLTQ9dxrUjThXzoy3ouYVtK,BgvbKru66ebrGUcFFymGTmsaQv6GgcGMybiWaXqzBtwX,True,4287988,1071997,6614,3307,3307,HfEnetJ7uBSmZWCjBNxdvv9HEC5nsW4wDV7wu6WnhWan,264581,1484334,-1219753,617
2022-01-05 21:42:21.297267,2022-01-05 16:36:10-05:00,1365,3njiRuSRMXRzKmamyiR72Hc38PU8UDDmWdfPhgxmGxEW,5WoF3gkgygyNNbwxWgVfqGWkExcDixuzgJQQjXEZQ6J5,True,5029261543,1257315385,7817179,3908589,3908590,4BnQKPLuE3DMTtxp8MjUBytgnhvxqq3ZTqZHTVZo4JJh,312687194,2164281661,-1851594467,621
2022-01-05 21:42:21.297267,2022-01-05 16:36:11-05:00,1366,5PbrpM9kjzF4R2eW2UTcRVXnhqWdRQWHZJXKLN43N8WC,6ip4ocbyHusy8CsVvcrpiRCUp2nq9cY8bHpTcUU3Wztq,True,156133363,39033340,241580,120790,120790,4BnQKPLuE3DMTtxp8MjUBytgnhvxqq3ZTqZHTVZo4JJh,9663216,33511673,-23848457,618
2022-01-05 21:42:21.297267,2022-01-05 16:36:11-05:00,1367,5jin5wXjQQ25nGM2ECrCXcg1a95vquh6kM7rMRru6Ke7,EKM657EQ8HWWgf4cssByoYHoXGjFfTspTKXAGmygAPQG,True,741489642,185372410,1140258,570129,570129,72FwbpFGoLEazJEdpqNtPNefsadUrimUqma9wSoy4qiS,45610354,195610073,-149999719,615
2022-01-05 21:42:21.297267,2022-01-05 16:36:23-05:00,1368,8MKNsuGVaoYpdQy6NNyxDvRzh2DAquBUtri4nDsixUxs,D7M1SDmpZAs8vdPCCCa96UbDF15YQDxHmoGWB57tHiir,True,81615820,20403955,127622,63811,63811,4BnQKPLuE3DMTtxp8MjUBytgnhvxqq3ZTqZHTVZo4JJh,5104880,23448647,-18343767,625
2022-01-05 21:42:21.297267,2022-01-05 16:36:34-05:00,1369,3Lv2XpiD4KBUHq7Zx6u3zNhpXoySodXHH8o8f5yaaPxG,H6TN4rhpBXkEH3mZnymYNcKfmnxRH2uzfwzeLH2q6ahP,True,3682048,920512,5759,2879,2880,72FwbpFGoLEazJEdpqNtPNefsadUrimUqma9wSoy4qiS,230376,794524,-564148,625
2022-01-05 21:42:21.297267,2022-01-05 16:37:12-05:00,1370,2VyFcgZDH1HTEvD1XaWhwqBCMmZ1k6TmZ3fEpPcBZR9E,G1wFJETTpdoc7CfypGCzkq1jssXPfUkiuLjK2cwVZ9dJ,True,1586036,396509,2477,1238,1239,4BnQKPLuE3DMTtxp8MjUBytgnhvxqq3ZTqZHTVZo4JJh,99118,439192,-340074,624
2022-01-05 21:42:21.297267,2022-01-05 16:37:59-05:00,1371,HAk9c831TRUhvpoK4d7PTqfJuJhSjnJUXWpnYsH85bDJ,DVSa3CJrVLTHAeFYjEF89ZjWRm86QwruUk2Y8RvGpjsr,True,475726,118930,733,366,367,HfEnetJ7uBSmZWCjBNxdvv9HEC5nsW4wDV7wu6WnhWan,29342,124406,-95064,616
2022-01-05 21:42:21.297267,2022-01-05 16:38:12-05:00,1372,F2v1YwVAwXLiUgsJ5uwn4qAAkTXitn1E75fJcPnGuAcy,5rdJ4H5GxPg4Juu77mGc7uya5LwEqLzDSRyG8mQ2mDbK,True,379723841,94930960,590293,295146,295147,4BnQKPLuE3DMTtxp8MjUBytgnhvxqq3ZTqZHTVZo4JJh,23611731,100120870,-76509139,621
2022-01-05 21:42:21.297267,2022-01-05 16:38:21-05:00,1373,AoPQqPjLPi8fZiLkhMGLRj6oD5k2asrvJtCkpW19DvGr,H5Sgmf1VuY13iHjPuLJ2q9wtSdkXG1AQsEv2eq6zzm8Y,True,7863726,1965931,12279,6139,6140,4BnQKPLuE3DMTtxp8MjUBytgnhvxqq3ZTqZHTVZo4JJh,491166,2304757,-1813591,624
2022-01-05 21:42:21.297267,2022-01-05 16:38:21-05:00,1374,8RmB8o4zux2sD48dEsKpsX475KRxTwdk8QULUDU9xx8R,AKSiZnb4YKVB6B86aPPqvyXquhvN9xqt45bexBCZ7nx,True,1247466030,311866507,1949465,974732,974733,HfEnetJ7uBSmZWCjBNxdvv9HEC5nsW4wDV7wu6WnhWan,77978632,410193072,-332214440,625
2022-01-05 21:42:21.297267,2022-01-05 16:38:21-05:00,1375,Fd2HrzBAr4JobRPARZwpQHHVoSCEoog32A6tKMWAC1sK,BYappsar5sQf8VLem4wrLuTtrDFH9y8pEx1aMxfuU4Pq,True,592921456,148230364,924688,462344,462344,4BnQKPLuE3DMTtxp8MjUBytgnhvxqq3ZTqZHTVZo4JJh,36987548,156353414,-119365866,623
2022-01-05 21:42:21.297267,2022-01-05 16:38:31-05:00,1376,8NdcaYUC1X5CP7FMDip78uqtqmCt8GcZdCzLRTYTihmb,9Ei1K9bXWXSXcBfeX5exPSXGCAu62WSKzvnnd4wHvyVh,True,2584084,646021,3981,1990,1991,4BnQKPLuE3DMTtxp8MjUBytgnhvxqq3ZTqZHTVZo4JJh,159262,574615,-415353,616
2022-01-05 21:42:21.297267,2022-01-05 16:38:32-05:00,1377,6eBSLXDMVoW2nG3n7s42RXDH8byY3C6n1RsUuegBLSrG,37dYrKnTXYer7Bu9xFfpArA4ZNo2B9bycFw9HywDtTRx,True,195042014,48760503,298143,149071,149072,HfEnetJ7uBSmZWCjBNxdvv9HEC5nsW4wDV7wu6WnhWan,11925755,48955716,-37029961,611
2022-01-05 21:42:21.297267,2022-01-05 16:38:35-05:00,1378,DH2tcZVt4nHQbph6znZRrwcyhjwiNYtgeamu72vcC6nR,ACsbP5BDFQEHQHTsdrWTBShhEUh9HeAKsE7iwyK72v2p,True,5452617,1363154,8397,4198,4199,72FwbpFGoLEazJEdpqNtPNefsadUrimUqma9wSoy4qiS,335906,2004342,-1668436,616
2022-01-05 21:42:21.297267,2022-01-05 16:38:44-05:00,1379,AaMCg49sJwNtdB5wHACg15TYAzzJXy8xtG4zuVXhKiVE,HbDYqDa9bewGPvsiaHRM9HmEvh1scPaUaGvqog66gYir,True,7929785,1982446,12326,6163,6163,4BnQKPLuE3DMTtxp8MjUBytgnhvxqq3ZTqZHTVZo4JJh,493057,2330868,-1837811,621
2022-01-05 21:42:21.297267,2022-01-05 16:38:44-05:00,1380,EmGW2aAG69ssWqCtbfDocRaM2u3TJsczn2HHP9jdmRvD,aypkDKsp9uqAB4F6mwvm5LofpsrFBuZT2MMWtE2eHdB,True,12700696,3175174,19630,9815,9815,4BnQKPLuE3DMTtxp8MjUBytgnhvxqq3ZTqZHTVZo4JJh,785208,3083000,-2297792,618
2022-01-05 21:42:21.297267,2022-01-05 16:38:48-05:00,1381,ANQkPUoMjLHyRtypeKzxsKW1DFauQsh9SnB3rRgRXM1Y,7RHAExWpG8Q3PXwKhJs2yXmYK9WogGydvFYpx28p6pgr,True,1428026711,357006677,2209374,1104687,1104687,HfEnetJ7uBSmZWCjBNxdvv9HEC5nsW4wDV7wu6WnhWan,88374993,479796321,-391421328,618
2022-01-05 21:42:21.297267,2022-01-05 16:38:59-05:00,1382,67Z7ZGhNu5xxEh9BYKWcXp9m1T4tFiE1o1M16hCzUWQA,CT7YKWixz7BhTbvg5F6M5HCyPGnHoFLNFuDV9GhoLTo3,True,64218109,16054527,99600,49800,49800,4BnQKPLuE3DMTtxp8MjUBytgnhvxqq3ZTqZHTVZo4JJh,3984039,21628528,-17644489,620
2022-01-05 21:42:21.297267,2022-01-05 16:39:04-05:00,1383,864zY9zuCktUurPTtdGeLvUATnDqHZpT1GeWUApsXh2m,CzatBrNJUi7MeyfbNhszRaPMidgt8Xkcmy5ZwFMP9RCs,True,407472930,101868232,631656,315828,315828,HfEnetJ7uBSmZWCjBNxdvv9HEC5nsW4wDV7wu6WnhWan,25266246,99895194,-74628948,620
2022-01-05 21:42:21.297267,2022-01-05 16:39:27-05:00,1384,CRaKcudjkQiSw5YPVjTLVdXvJskeGiHSYtq5ZcMPJhgQ,AgqTg3b3bAcaBmRidhNC4Uf9ZwNbeH52RQEqumWyuUs7,True,17112914,4278228,26706,13353,13353,4BnQKPLuE3DMTtxp8MjUBytgnhvxqq3ZTqZHTVZo4JJh,1068277,6200580,-5132303,624
2022-01-05 21:55:22.169714,2022-01-05 16:54:52-05:00,1385,HVZkXeDR3mc8oB9qFFwCK4RXpPojdcHk9tRGep6xtKGK,Bh3py7awPejWqeTMxtAgF7mPotL2Asxf8YrYJykq9nBt,True,130194521,32548630,202052,101026,101026,DddJ7EWCmYEEZETCBNgAUSg81Ls6fZtiAaY5ekJ5sXx1,8082099,27898300,-19816201,620
2022-01-05 21:55:22.169714,2022-01-05 16:54:52-05:00,1386,Ckqos6cdncPKj13DnCmDVZsZTqp6eS7277CRrT9WhcEr,AtUV8m7VQJvZq7GLCAHMf3jV7iamKEPnWVZHWuuVZQp1,True,24511950,6127987,37901,18950,18951,DddJ7EWCmYEEZETCBNgAUSg81Ls6fZtiAaY5ekJ5sXx1,1516068,8891561,-7375493,618
2022-01-05 21:55:22.169714,2022-01-05 16:54:52-05:00,1387,9vcKW1GfrDZ3KLPh2pEVFF8ZyKqD1pJW1hiE8H98Av7S,C6Ki27mo4sCHu6u8UnR1p7WSgsTjFQxGGR9Lk9n5Rhjq,True,54846531,13711632,84858,42429,42429,DddJ7EWCmYEEZETCBNgAUSg81Ls6fZtiAaY5ekJ5sXx1,3394349,14210823,-10816474,618
2022-01-05 21:55:22.169714,2022-01-05 16:54:52-05:00,1388,7PzGZgzieFyyFs1dbajkNQgVxooFUNZrj1bUsQvrSwbp,A2gDREmSmJTBPPw3sbKVY3smC9wbHMDdv87gr4Tr2ES7,True,56153797,14038449,87784,43892,43892,DddJ7EWCmYEEZETCBNgAUSg81Ls6fZtiAaY5ekJ5sXx1,3511398,12164205,-8652807,625
2022-01-05 21:55:22.169714,2022-01-05 16:55:16-05:00,1389,3qnPsgqW11AcDEmyjmJquPcPLyE3EdJQuVLJ5kinDrd3,86rZadBB7emKio76aFTahpbrFtxd9tqZ4Mxgzaavq2xU,True,3116421,779105,4804,2402,2402,DddJ7EWCmYEEZETCBNgAUSg81Ls6fZtiAaY5ekJ5sXx1,192198,675777,-483579,616
2022-01-05 21:55:22.169714,2022-01-05 16:55:21-05:00,1390,HGJoZvLakWfSDFwuvShNBc4kCf7nP7VqzyM3mELpbFEf,12Qn5jin7QvsBngXqYAv4UstyG3b6nRf1jsLp9Dp8G7k,True,319931239,79982809,496308,248154,248154,DddJ7EWCmYEEZETCBNgAUSg81Ls6fZtiAaY5ekJ5sXx1,19852334,74884532,-55032198,620
2022-01-05 22:04:04.071316,2022-01-05 17:00:15-05:00,1391,BAzH5niE2GX9CHGn3jK6Wv8Dd59PT95dX4dgfZXWoLPT,YNRnuEoNBPFsr7W91gc85TXAdA4ZnXfF2x951zbeRKF,True,444723,111179,695,347,348,DddJ7EWCmYEEZETCBNgAUSg81Ls6fZtiAaY5ekJ5sXx1,27836,117466,-89630,625
2022-01-05 22:04:04.071316,2022-01-05 17:01:21-05:00,1392,DR7XL3qweFyTKDatQYS2LacqGLv2368cnGuWpEpk4hSL,Fd3BYCiiQfThDJsxBUNwYTMP8eNCrnXMVzE1wpejJqXa,True,94117,23529,147,73,74,DddJ7EWCmYEEZETCBNgAUSg81Ls6fZtiAaY5ekJ5sXx1,5891,27404,-21513,625
2022-01-05 22:04:04.071316,2022-01-05 17:01:21-05:00,1393,3WcJUt8jQ1ngL3ZCGo6dFrc3GmTMTYtzeDva7mri2Tqx,HeG1Pz2oMjqtkfsRMsbqP3VpatnVEQzcWmKDVoFp4Htr,True,320256779,80064194,500439,250219,250220,DddJ7EWCmYEEZETCBNgAUSg81Ls6fZtiAaY5ekJ5sXx1,20017579,74724237,-54706658,625
2022-01-05 22:04:04.071316,2022-01-05 17:02:20-05:00,1394,Fcr4Y1XTnNv1xuGnAdssPRAxxu3gcdone44fBqvup7sB,JDjFXehdM1oz63wXop6pYpWoB4ptr7Dma8ZhTGH1HzTq,True,239011827375,59752956843,369124171,184562085,184562086,DddJ7EWCmYEEZETCBNgAUSg81Ls6fZtiAaY5ekJ5sXx1,14764966840,71580937355,-56815970515,617
2022-01-05 22:04:04.071316,2022-01-05 17:02:27-05:00,1395,CUhCSd7jHvycC89L6EqMoDWcWVTXXHhAeXVyB4362qZg,J7B9JBV1xR8a7DKKrw3JwGusY4H2bSQuyHtod2Fzf4jq,True,19129113,4782278,26486,13243,13243,DddJ7EWCmYEEZETCBNgAUSg81Ls6fZtiAaY5ekJ5sXx1,1059450,4925360,-3865910,553
2022-01-05 22:04:04.071316,2022-01-05 17:02:28-05:00,1396,GRve31SsUSCKaBMxgnLDfjWkp3cg6vB7NAZddTxgwmPS,7QjpYFUFhh1njvaevNzwr58ULBrvepXNGZ4LY9YzbKKn,True,876954773,219238693,1192913,596456,596457,4BnQKPLuE3DMTtxp8MjUBytgnhvxqq3ZTqZHTVZo4JJh,47716533,204871759,-157155226,544
2022-01-05 22:04:04.071316,2022-01-05 17:02:30-05:00,1397,FtNFtrFpUxLGDP3KTusCxgWMiDqXErcBLzPHVXDwTvNH,FnJfrBQYt9arf1sY3MJn9r8ZWGgjG8mVt5X8pcond5p,True,434904,108723,665,332,333,DddJ7EWCmYEEZETCBNgAUSg81Ls6fZtiAaY5ekJ5sXx1,26612,116180,-89568,611
2022-01-05 22:04:04.071316,2022-01-05 17:02:32-05:00,1398,56488NdcUy6Hi6X5SLs2GFtW5pG4u5wJpH7vHdxTCx4z,tGgXjJeVr3W2m3T2NXPCqpBEd6HJKE2cRsgCyiDZQy4,True,232242085,58060520,356615,178307,178308,DddJ7EWCmYEEZETCBNgAUSg81Ls6fZtiAaY5ekJ5sXx1,14264621,82023582,-67758961,614
2022-01-05 22:04:04.071316,2022-01-05 17:02:32-05:00,1399,BtnTjb4mghmBK9KnLp2JzyGqfKB8tHskrGL4MzjAdF6V,BLStL7zka6qakHMhY4V6jKJT5agS1LtWMdWBZ1eP1Vi7,True,491187,122795,764,382,382,DddJ7EWCmYEEZETCBNgAUSg81Ls6fZtiAaY5ekJ5sXx1,30562,132392,-101830,622
2022-01-05 22:04:04.071316,2022-01-05 17:02:54-05:00,1400,7aKxZg1aoLuB51JUw7fruF77ts7SWoB7pcLBZKHZMynr,AAnbLY82UGULqaDNdyJHrYu7X3hGaBuiTkGWmh8qKTc,True,133769432311,33442358076,206400481,103200240,103200241,72FwbpFGoLEazJEdpqNtPNefsadUrimUqma9wSoy4qiS,8256019246,3547657465,4708361781,617
2022-01-05 22:04:04.071316,2022-01-05 17:03:01-05:00,1401,BWtXpiXn1bomr28mGfQFTx1Kd58CQipEnKmeweYowDEC,9jws1qkXvWAdEtBvURVEeGcGJzt4zG2gh8AJESvjKKrx,True,2116301172,529075293,3147280,1573640,1573640,DddJ7EWCmYEEZETCBNgAUSg81Ls6fZtiAaY5ekJ5sXx1,125891230,676240849,-550349619,594
2022-01-05 22:04:04.071316,2022-01-05 17:03:16-05:00,1402,6cnA7PeqQgpZdA7jBg4yMzTusm8JJHRWBMup84ywJfYo,FLqcukY7RehqY6ACrwVJnGH3eRgRDe93K1jLYCQN2F3U,True,1588507338,397126834,2444282,1222141,1222141,HfEnetJ7uBSmZWCjBNxdvv9HEC5nsW4wDV7wu6WnhWan,97771311,513818548,-416047237,615
2022-01-05 22:04:04.071316,2022-01-05 17:03:33-05:00,1403,7vKmhLV45Q5etXhJL5ng8rxWhYSiUCDmAbGnwBPr7zcx,cP6xPeuHLnjr858QK1F9qYn7rJpEbPy7wEJHoju6oV7,True,687936476,171984119,1067018,533509,533509,HfEnetJ7uBSmZWCjBNxdvv9HEC5nsW4wDV7wu6WnhWan,42680730,150834270,-108153540,620
2022-01-05 22:24:27.673446,2022-01-05 17:07:57-05:00,1404,E1wp3bmkcY3eiEYyGYwhTCsr7BZ7RfPa5DJTZFupcFwj,452hVdYkD5SDDrA6hv6DLPFvyS8PvR2P6DPNScGxWTsW,True,12811791,3202947,20029,10014,10015,DddJ7EWCmYEEZETCBNgAUSg81Ls6fZtiAaY5ekJ5sXx1,801196,2987893,-2186697,625
2022-01-05 22:24:27.673446,2022-01-05 17:07:57-05:00,1405,A7SMcwnq3DewryUj1jScnAboKGnuDVcW15F3ubNcG66Y,5qLCE37FdeWLCQnkfNJViFMGNcDeiELgE3VgPbBUuDGF,True,365561689,91390422,571348,285674,285674,4BnQKPLuE3DMTtxp8MjUBytgnhvxqq3ZTqZHTVZo4JJh,22853937,104907598,-82053661,625
2022-01-05 22:24:27.673446,2022-01-05 17:07:57-05:00,1406,7jvKp6onXyWgwsFrFWj4hYTXJsYYD6ot5mn6rPFuJriy,J7N6HiozevJVTiY9hDEUs2ud5BwT5QSE7wnMBS1w5ie2,True,471168842,117792210,736550,368275,368275,4BnQKPLuE3DMTtxp8MjUBytgnhvxqq3ZTqZHTVZo4JJh,29462038,159066980,-129604942,625
2022-01-05 22:24:27.673446,2022-01-05 17:11:39-05:00,1407,FMdKLXhQEnNJtvM17ZX8jhaeMaSD9UgDuN3Kw7kMrd7K,5pURHYWB5LUGwJmWVBGH8p6oyR9NJvXnZk7uDVoiassv,True,69574835,17393708,108846,54423,54423,HfEnetJ7uBSmZWCjBNxdvv9HEC5nsW4wDV7wu6WnhWan,4353848,20755151,-16401303,625
2022-01-05 22:24:27.673446,2022-01-05 17:12:27-05:00,1408,DvuRmJkfn6FQczUKgYeaSCqwy2NTMunuAKNrnmxMvnzS,7LpWTX9dgBtW75kfEoB5WuNsDwEdw5s8CYSHh3J4qagM,True,1762659459,440664864,2681105,1340552,1340553,DddJ7EWCmYEEZETCBNgAUSg81Ls6fZtiAaY5ekJ5sXx1,107244238,464370659,-357126421,608
2022-01-05 22:24:27.673446,2022-01-05 17:12:32-05:00,1409,EBUcTqh9AYyRokZRzLbPKL9ZmTUx6KcDEbBeuCLGwqYC,B5WSXfHzYQhUFE2T97GaiqSkeejTWKKGVjMkcFrxEvyJ,True,448685464,112171366,685278,342639,342639,HfEnetJ7uBSmZWCjBNxdvv9HEC5nsW4wDV7wu6WnhWan,27411142,120140929,-92729787,610
2022-01-05 22:24:27.673446,2022-01-05 17:13:09-05:00,1410,GaEpNGa8jnwSRvjzzEMYkZe1pKcr2eiZtePrqFxpABjB,5CFZHuyWbJv14zPdX5dSQDREgHrCb4vsFvB6hLiEe3Ji,True,2418234,604558,3748,1874,1874,DddJ7EWCmYEEZETCBNgAUSg81Ls6fZtiAaY5ekJ5sXx1,149959,531725,-381766,620
2022-01-05 22:24:27.673446,2022-01-05 17:13:09-05:00,1411,AKxRtcdpi7gWhAuL8ENj7zhgeQezzEXe9TSANE6bQoRA,2YH4vrU9deP8Cu6E8Hzf8GqKG1yVjv5pdz4FE7r5YKir,True,108653119,27163279,168048,84024,84024,DddJ7EWCmYEEZETCBNgAUSg81Ls6fZtiAaY5ekJ5sXx1,6721935,23457361,-16735426,618
2022-01-05 22:24:27.673446,2022-01-05 17:13:09-05:00,1412,89CkXnSZnr52Zsoh48efv9MQacrkB6GMtrbEpNJSyA2H,HcvRBS4Z22CpYgDNgm4TVF4AVXFDuYzBUAFcdHAwdpg4,True,47587474,11896868,73683,36841,36842,4BnQKPLuE3DMTtxp8MjUBytgnhvxqq3ZTqZHTVZo4JJh,2947351,10294733,-7347382,619
2022-01-05 22:24:27.673446,2022-01-05 17:13:53-05:00,1413,Mcbzp1LhZwpfmXTv1pqe9D1jCKHw443j9QKp6tUpzgM,8uforSMAKEih5jHfHp3gCqCvaugtCmhzVfVHA63Akz7F,True,31633885,7908471,49481,24740,24741,DddJ7EWCmYEEZETCBNgAUSg81Ls6fZtiAaY5ekJ5sXx1,1979251,9892246,-7912995,625
2022-01-05 22:24:27.673446,2022-01-05 17:13:53-05:00,1414,GJ3PbEfPK8jjrPgMmZtvN5fMSSy2dtiiAtZ8wcfgxVuc,FCUDVFb2TjDvehHE8fVBofqSykpb9W6Afc9QeHtj7te7,True,1216604127,304151031,1881861,940930,940931,DddJ7EWCmYEEZETCBNgAUSg81Ls6fZtiAaY5ekJ5sXx1,75274465,412780991,-337506526,618
2022-01-05 22:24:27.673446,2022-01-05 17:13:53-05:00,1415,D3mXrJzhHf8qRaoCKLschUxAFoijFCFuT6bmNZH4W7Cj,9E3Xtqw7TncXWnbhAbFJMtuNmP6WS3ooGuptzyzw7UpA,True,916666,229166,1392,696,696,DddJ7EWCmYEEZETCBNgAUSg81Ls6fZtiAaY5ekJ5sXx1,55711,313595,-257884,607
2022-01-05 22:24:27.673446,2022-01-05 17:13:53-05:00,1416,Ar5QB4VBcUyzSCG23z2QNAbrWY55NbHCr1MNN6P2GAmh,BusFGTiDrJmxzwGUxWz9b3SFF3eseqtgh2DRHqyAwyVe,True,7328275,1832068,11172,5586,5586,DddJ7EWCmYEEZETCBNgAUSg81Ls6fZtiAaY5ekJ5sXx1,446901,1735971,-1289070,609
2022-01-05 22:24:27.673446,2022-01-05 17:13:54-05:00,1417,2NdwSLxsGok8PczpCZj9CVX2BymNU5MvHt7hWfGetg2M,8AQbDXeA6mD9QoZBFJcYbnHvZwKNxzA9CCHLAgdSfTA3,True,168863,42215,256,128,128,DddJ7EWCmYEEZETCBNgAUSg81Ls6fZtiAaY5ekJ5sXx1,10279,52303,-42024,608
2022-01-05 22:24:27.673446,2022-01-05 17:13:54-05:00,1418,EQUZQWk4WLT6LFeWZs3P9AQufFcoZouFETfhyxvuS2JM,Byc2mLXArmkjQPWaxCJksHZD2XpZyCQ2FRtDJyztU81V,True,1506517907,376629476,2306101,1153050,1153051,4BnQKPLuE3DMTtxp8MjUBytgnhvxqq3ZTqZHTVZo4JJh,92244064,516721799,-424477735,612
2022-01-05 22:24:27.673446,2022-01-05 17:13:55-05:00,1419,9jdfc9GFTecsdRuTjWFGX13niKKmeBxRgtv5j86uhSnU,HLWMShobjSkaLyXrNjgwVaUGVtbtdUSnr1XjqpXn1bLR,True,4642901,1160725,7166,3583,3583,4BnQKPLuE3DMTtxp8MjUBytgnhvxqq3ZTqZHTVZo4JJh,286664,1198044,-911380,617
2022-01-05 22:24:27.673446,2022-01-05 17:13:56-05:00,1420,EV21gv8jEvXtmGDoGRNm5LJEvTBccLMZyVDCLsp54jP3,DGxxoU52aQNoUQcxdvQtv2H5q2PhK6TGkLgNSaFgnZrb,True,70716115,17679028,110170,55085,55085,DddJ7EWCmYEEZETCBNgAUSg81Ls6fZtiAaY5ekJ5sXx1,4406836,16668708,-12261872,623
2022-01-05 22:24:27.673446,2022-01-05 17:14:00-05:00,1421,BZxJ6CtrVoiU86DMMieMeDFLNWtMpHGTvZfM7nyay6o4,6CRxRR8bisRLHFJBFWjyumYuy7j4C4PkjYH1K8gXhdWD,True,30440113,7610027,47249,23624,23625,4BnQKPLuE3DMTtxp8MjUBytgnhvxqq3ZTqZHTVZo4JJh,1889971,5449858,-3559887,620
2022-01-05 22:24:27.673446,2022-01-05 17:14:00-05:00,1422,5gN3624v6n1zQ1BKtZi1e9ZLpbCa4MEfhgHySFB81Qfm,UXT3oB5ud18rBsygsfxwA93kQYdSNbbzTCjt4gtU2jP,True,9269349,2317336,14376,7188,7188,DddJ7EWCmYEEZETCBNgAUSg81Ls6fZtiAaY5ekJ5sXx1,575063,2738941,-2163878,620
2022-01-05 22:24:27.673446,2022-01-05 17:14:02-05:00,1423,4KMzwWHPeW51cxu4nMpbqCaqo96dMqaHWyRCGQktfQfd,F7q4GNYcbnZa8dJ4qovQwjmxpKpdEmdxQMXRPb9nQupa,True,8018814,2004703,12533,6266,6267,DddJ7EWCmYEEZETCBNgAUSg81Ls6fZtiAaY5ekJ5sXx1,501334,2417707,-1916373,625
2022-01-05 22:24:27.673446,2022-01-05 17:14:17-05:00,1424,Dn916KSmX3HqxT53hrxrbCrV3tdRMCPdaoiRLqetMrth,ATCXRiXgnjRRUbSTPBvtBXMENCqsViexSZbZ6aDaXXWA,True,13829456,3457363,21199,10599,10600,HfEnetJ7uBSmZWCjBNxdvv9HEC5nsW4wDV7wu6WnhWan,847962,3883597,-3035635,613
2022-01-05 22:24:27.673446,2022-01-05 17:14:21-05:00,1425,6NJFN855M3Q3RLTDNo57gTgAmwPD6G2E3WvMb1m5eNCN,3YpqNnonsvXaRT4nCC3G5FZx1jjVtbDPc36LiR6WK5jR,True,1561074354,390268588,2438270,1219135,1219135,4BnQKPLuE3DMTtxp8MjUBytgnhvxqq3ZTqZHTVZo4JJh,97530800,516836344,-419305544,624
2022-01-05 22:24:27.673446,2022-01-05 17:14:42-05:00,1426,8BTja7VnFPe6M9BHTqg5LTpX6vd4ugTeWLzpq3oFP8WM,pscjH4sPnNL6zQBmvHjEEbix6BTstnsrSwGysNWyPkd,True,317444,79360,491,245,246,HfEnetJ7uBSmZWCjBNxdvv9HEC5nsW4wDV7wu6WnhWan,19660,90995,-71335,619
2022-01-05 22:24:27.673446,2022-01-05 17:14:45-05:00,1427,7LRBswSEDBjJzQ4YurfTxLydh7tFS2jVn5V95Z6wL7ci,fD41VYGmk66MW46KKb23vAqQvUSDScgXnVdsHhJBZzu,True,1865609,466402,2884,1442,1442,DddJ7EWCmYEEZETCBNgAUSg81Ls6fZtiAaY5ekJ5sXx1,115369,527890,-412521,618
2022-01-05 22:24:27.673446,2022-01-05 17:14:45-05:00,1428,2PHDkmat5jQ65XkJYhDSw6ZwHcKpSw85o8MaPFhfLBry,8NtkXoUPt4wkcqQJuPJYt5oq9hG4BdeY26dQrsybDWWX,True,178387979,44596994,278070,139035,139035,4BnQKPLuE3DMTtxp8MjUBytgnhvxqq3ZTqZHTVZo4JJh,11122813,41989793,-30866980,623
2022-01-05 22:24:27.673446,2022-01-05 17:14:45-05:00,1429,5hUZ9uQFcYnjAQVVaGLJWdKyg7y1XMpoo8osQ9DeY7Xd,BdYiKWsjuzJLcHh3814mJ4xQ9JxoQKKcr7AHZ7Vxoavq,True,642273,160568,1001,500,501,4BnQKPLuE3DMTtxp8MjUBytgnhvxqq3ZTqZHTVZo4JJh,40065,147677,-107612,623
2022-01-05 22:24:27.673446,2022-01-05 17:14:46-05:00,1430,8eTH6eJyyVeMno3UQkffeBg32xofKsQfkhLhXdtaf87s,BCFC7CPXrQPsUfJb2eYSht8GhaApWHpc49AeCXqaYq13,True,8047432,2011858,12392,6196,6196,4BnQKPLuE3DMTtxp8MjUBytgnhvxqq3ZTqZHTVZo4JJh,495694,2358395,-1862701,615
2022-01-05 22:24:27.673446,2022-01-05 17:14:51-05:00,1431,8VT2nxz5ZYDJFd9uL2XZwEXxChd9pjuMJNMAcutZubL1,EhAkiRbouzUAWtqQFsN8HEEfi46UVN8H8tyBP7CbgeLe,True,145254,36313,224,112,112,4BnQKPLuE3DMTtxp8MjUBytgnhvxqq3ZTqZHTVZo4JJh,8963,38944,-29981,617
2022-01-05 22:24:27.673446,2022-01-05 17:14:58-05:00,1432,Gbxc51WERLLeCtiHv7rDvE52aqF541RoQWG5n5aqErq6,4ngBoHbfXijLMqGKxFMNht9sbmxy2g5eqBmn8QsBmbx1,True,8034567,2008641,12505,6252,6253,DddJ7EWCmYEEZETCBNgAUSg81Ls6fZtiAaY5ekJ5sXx1,500233,2438389,-1938156,622
2022-01-05 22:24:27.673446,2022-01-05 17:14:59-05:00,1433,7bnCuBLXnPS3wDBunrzoV5qm1GwfnPfRBwV2f9Xzo3Aj,9Xd7GNcFrx7z66DRW8kK3d1jN4tzuiwv9jyDFbHUx9vW,True,323564,80889,503,251,252,DddJ7EWCmYEEZETCBNgAUSg81Ls6fZtiAaY5ekJ5sXx1,20137,93729,-73592,622
2022-01-05 22:24:27.673446,2022-01-05 17:15:00-05:00,1434,FoYrQCyDQ75YMNvkgTULbVHYmdrsoFJHohBLPfeF5rEH,DUyVhESZMDUS6Rqsz92CnW2KbWzAs6soEzZqD59XAKzY,True,193690894,48422723,301672,150836,150836,DddJ7EWCmYEEZETCBNgAUSg81Ls6fZtiAaY5ekJ5sXx1,12066898,63602236,-51535338,622
2022-01-05 22:24:27.673446,2022-01-05 17:15:07-05:00,1435,D58t4uTjFumsUeYFaKnpV8BRTEQEqKXBreFTdwGrott7,67p6kHDfVqQijfcwugvZK59c3aRRH9x3eHxruqH8WEqF,True,8013714,2003427,12386,6193,6193,HfEnetJ7uBSmZWCjBNxdvv9HEC5nsW4wDV7wu6WnhWan,495461,2419445,-1923984,618
2022-01-05 22:24:27.673446,2022-01-05 17:15:12-05:00,1436,EgU9hX6VK7YXeCgCHVaJAMekCcyZa2MVWdKra5pN7Gwv,7y8Ad9XY34bqREvheXHT2tr8Jy11D6X3pu7yLVtjU4QV,True,144425360,36106340,225361,112680,112681,HfEnetJ7uBSmZWCjBNxdvv9HEC5nsW4wDV7wu6WnhWan,9014444,41383904,-32369460,624
2022-01-05 22:24:27.673446,2022-01-05 17:15:12-05:00,1437,Buioe5v3DyFwD9nquW5XdYeVYbSABCyg79eUHEvtvfaW,7T9gi7prCcZJkYJMSB5Ef6Bu4pAuBw4XLvumSFnqKDSi,True,10314547,2578636,15936,7968,7968,HfEnetJ7uBSmZWCjBNxdvv9HEC5nsW4wDV7wu6WnhWan,637461,3475465,-2838004,618
2022-01-05 22:24:27.673446,2022-01-05 17:15:16-05:00,1438,CFFpbRxYEP18rqEGxxyG3bzSV13Lv7nfSmZvtUK17kCP,824UwqH2JcFsqYBk9MZ8tTnpka9udTL6WGX35YFtAJQk,True,56096239,14024059,86532,43266,43266,4BnQKPLuE3DMTtxp8MjUBytgnhvxqq3ZTqZHTVZo4JJh,3461307,12119142,-8657835,617
2022-01-05 22:24:27.673446,2022-01-05 17:15:27-05:00,1439,3g1debT8Z2efQPuMNSDPUNZzDqarBG2acErsZ4HP7QGA,42wDHagxr5Nno3mUx6kyYGDjwR98aedRbh3ByB468agB,True,275704,68926,429,214,215,DddJ7EWCmYEEZETCBNgAUSg81Ls6fZtiAaY5ekJ5sXx1,17188,60173,-42985,623
2022-01-05 22:24:27.673446,2022-01-05 17:15:54-05:00,1440,ASrkgcVQ9iMDvTbji6xdpzXU4G4hRNhZ4BzseVxGjDnp,3N8MqUxgfh6T7MQu3JQqYUHDiUYSy5AnXY1SmSMmpdBo,True,6694017710,1673504427,10309163,5154581,5154582,DddJ7EWCmYEEZETCBNgAUSg81Ls6fZtiAaY5ekJ5sXx1,412366552,1626997115,-1214630563,616
2022-01-05 22:24:27.673446,2022-01-05 17:16:12-05:00,1441,9WJBnVi84E926j7xEd566WzrZJkPJWRgmEnYj9vyjuad,4dLaFS5F7TGyLdwuJLMGkz3bSL53aHzd9ZfpNmhHxXeF,True,314477377,78619344,486704,243352,243352,HfEnetJ7uBSmZWCjBNxdvv9HEC5nsW4wDV7wu6WnhWan,19468180,88418904,-68950724,619
2022-01-05 22:24:27.673446,2022-01-05 17:16:16-05:00,1442,HdfQweV1KuYSpWdycZbpGrUc8yMcY3ZczLn1agKXMJaf,G1Ae1PZHkANkwFnhUKS1tvdFEv8dAFeojBkezh6rUNMh,True,109351636,27337908,164239,82119,82120,72FwbpFGoLEazJEdpqNtPNefsadUrimUqma9wSoy4qiS,6569576,28598470,-22028894,600
2022-01-05 22:24:27.673446,2022-01-05 17:16:19-05:00,1443,8swGZMrPrLAxZd7MxTbkCL13k3DmAJUw41jCp6Xo6awW,3fKnX7yTNXAT4uMmXVdTy47ALJT8h8YSD3WiBb4BGuzH,True,4735423201,1183855800,7021313,3510656,3510657,4BnQKPLuE3DMTtxp8MjUBytgnhvxqq3ZTqZHTVZo4JJh,280852558,1046608376,-765755818,593
2022-01-05 22:24:27.673446,2022-01-05 17:16:20-05:00,1444,Cv5oVktxmqbU1SxraxH67NEWMKnjgA18R832Fhe9h74a,Cs7xBD4BDiohyopnaYDDChUtR9vmx7uwot6Qp9beQLzt,True,7025288,1756321,10793,5396,5397,4BnQKPLuE3DMTtxp8MjUBytgnhvxqq3ZTqZHTVZo4JJh,431737,2099383,-1667646,614
2022-01-05 22:24:27.673446,2022-01-05 17:16:20-05:00,1445,Dng7By2saPu5TVxcvXidBe71ggBo8tiHkAXPi4kKL1tk,75ufEJmHbLHffphL7tvAXhGyftKLr1z2PXXoB2GGY5fG,True,7498833,1874708,11527,5763,5764,4BnQKPLuE3DMTtxp8MjUBytgnhvxqq3ZTqZHTVZo4JJh,461093,2235142,-1774049,614
2022-01-05 22:24:27.673446,2022-01-05 17:16:32-05:00,1446,72L76qDRMK3M7X52zuuB9GVyvFFLDBZwFMpVjWjghXzA,4m2ZVuemUctu1edv4YJVAcjXzKwpbCmBujzoUmLDeA7h,True,8190159,2047539,12716,6358,6358,HfEnetJ7uBSmZWCjBNxdvv9HEC5nsW4wDV7wu6WnhWan,508678,2418123,-1909445,621
2022-01-05 22:24:27.673446,2022-01-05 17:17:06-05:00,1447,H6tDNj9cHac223ckAnNfnC4bAJuNLBnf2pFk2iQdMzMP,28UL9dqgayCqCAexScXjdpobYGVDN44SGBVNAfBByk8C,True,972932187,243233046,1482210,741105,741105,4BnQKPLuE3DMTtxp8MjUBytgnhvxqq3ZTqZHTVZo4JJh,59288409,335467334,-276178925,609
2022-01-05 22:24:27.673446,2022-01-05 17:17:06-05:00,1448,EEcTbsFTUEifcdbPyjBLkS943daEx1RpR8F3uZxKRZbT,8V3JzDQ1VWYQLas8fxUsWJZZHe4gEmn74RehtUwLw3k5,True,77836480,19459120,118414,59207,59207,4BnQKPLuE3DMTtxp8MjUBytgnhvxqq3ZTqZHTVZo4JJh,4736592,22184153,-17447561,608
2022-01-05 22:24:27.673446,2022-01-05 17:17:06-05:00,1449,HhwiZPKZBGa16oVi739s4qtMDMTwzWXc7iwNfX63t2UP,5AnbMbAFKy85yHt5y2M5S38nNkA1vT4ejY5NjGbRNUqn,True,20113212,5028303,31235,15617,15618,4BnQKPLuE3DMTtxp8MjUBytgnhvxqq3ZTqZHTVZo4JJh,1249407,7830489,-6581082,621
2022-01-05 22:24:27.673446,2022-01-05 17:17:06-05:00,1450,BxXXWywnC3dSyLPJHt7owfBhgSiBWzkuD3T8hGYLqCH6,4vuwEBXXbXFMPmbJJJRop4FCWGyKR1sXhBc3EWF6MiB8,True,1383642487,345910621,2143378,1071689,1071689,4BnQKPLuE3DMTtxp8MjUBytgnhvxqq3ZTqZHTVZo4JJh,85735155,481100844,-395365689,619
2022-01-05 22:24:27.673446,2022-01-05 17:17:06-05:00,1451,7W6ih2ZGXaE6tvuQFUPCvc7NvEJHy7UffgoVX3ZPdLXt,6uQCkeMjEXHBQxE2HD33RM1zyTsSko1fYZA1mWUggJ5B,True,373697,93424,578,289,289,4BnQKPLuE3DMTtxp8MjUBytgnhvxqq3ZTqZHTVZo4JJh,23138,86449,-63311,619
2022-01-05 22:24:27.673446,2022-01-05 17:17:06-05:00,1452,ECuu1L4QGdemZ7FjAjVAAxYN6piinweY7Fuk5csVovfT,Amd8WGcpdtB8yoA83R1BUT5uryuqoKbcBexYacbrbGVX,True,44386852,11096713,68402,34201,34201,4BnQKPLuE3DMTtxp8MjUBytgnhvxqq3ZTqZHTVZo4JJh,2736117,8159298,-5423181,616
2022-01-05 22:24:27.673446,2022-01-05 17:17:06-05:00,1453,7iUx7JBwqUvPVPeCqMEXQdLccZJmaFYm1DUQiu3ouHa3,3EVZzhRmJnX9ZiBZZo9tenDtMogAyuA1yf2cKzvUWiuu,True,9105198,2276299,14141,7070,7071,4BnQKPLuE3DMTtxp8MjUBytgnhvxqq3ZTqZHTVZo4JJh,565649,2814408,-2248759,621
2022-01-05 22:24:27.673446,2022-01-05 17:17:31-05:00,1454,8sneA6wAg6geVDJ1g7YWg4R1PfjuRVzeHp1nUBJinhZa,14i1uWtmcTjrdbg3DSr9vzd5NBnxqsn1A4QdgFBZqeYM,True,1756998,439249,2723,1361,1362,72FwbpFGoLEazJEdpqNtPNefsadUrimUqma9wSoy4qiS,108943,430481,-321538,620
2022-01-05 22:24:27.673446,2022-01-05 17:17:33-05:00,1455,6dr65yANjSMmfBeKAuSxG3i16S9vMgF1CQ3zDyzh55Pn,EhrE5QpnshD41S4zPEBy2A5q2Gs2mwUrbHGo6WnT9zDP,True,4853615,1213403,7591,3795,3796,4BnQKPLuE3DMTtxp8MjUBytgnhvxqq3ZTqZHTVZo4JJh,303648,1450033,-1146385,625
2022-01-05 22:24:27.673446,2022-01-05 17:17:33-05:00,1456,GH6Q9E1jZPTTp46aDd57UNZPNS2D6PBSwyLL3EHSjGn2,2XvwZXNsrPWx4EfPvhTP933bzCC3SJHDQ8xARfrXdVY9,True,286465379,71616344,442337,221168,221169,4BnQKPLuE3DMTtxp8MjUBytgnhvxqq3ZTqZHTVZo4JJh,17693512,170228133,-152534621,617
2022-01-05 22:24:27.673446,2022-01-05 17:17:33-05:00,1457,5PbrpM9kjzF4R2eW2UTcRVXnhqWdRQWHZJXKLN43N8WC,6ip4ocbyHusy8CsVvcrpiRCUp2nq9cY8bHpTcUU3Wztq,True,114884790,28721197,179334,89667,89667,4BnQKPLuE3DMTtxp8MjUBytgnhvxqq3ZTqZHTVZo4JJh,7173362,27275109,-20101747,624
2022-01-05 22:24:27.673446,2022-01-05 17:17:37-05:00,1458,5jin5wXjQQ25nGM2ECrCXcg1a95vquh6kM7rMRru6Ke7,EKM657EQ8HWWgf4cssByoYHoXGjFfTspTKXAGmygAPQG,True,545598948,136399737,844872,422436,422436,72FwbpFGoLEazJEdpqNtPNefsadUrimUqma9wSoy4qiS,33794891,156816976,-123022085,619
2022-01-05 22:24:27.673446,2022-01-05 17:17:47-05:00,1459,864zY9zuCktUurPTtdGeLvUATnDqHZpT1GeWUApsXh2m,CzatBrNJUi7MeyfbNhszRaPMidgt8Xkcmy5ZwFMP9RCs,True,299740604,74935151,468831,234415,234416,4BnQKPLuE3DMTtxp8MjUBytgnhvxqq3ZTqZHTVZo4JJh,18753262,80594752,-61841490,625
2022-01-05 22:24:27.673446,2022-01-05 17:18:42-05:00,1460,F2v1YwVAwXLiUgsJ5uwn4qAAkTXitn1E75fJcPnGuAcy,5rdJ4H5GxPg4Juu77mGc7uya5LwEqLzDSRyG8mQ2mDbK,True,279274225,69818556,435557,217778,217779,4BnQKPLuE3DMTtxp8MjUBytgnhvxqq3ZTqZHTVZo4JJh,17422303,80323866,-62901563,623
2022-01-05 22:24:27.673446,2022-01-05 17:18:42-05:00,1461,Hy3kzXneDN6FUkiZctU1vWe97BYvj6yZ7QvQzehfWmNr,EhXgQg8BTniANV525RpY76z7Hrh6DuqrMChjqEoXfVJe,True,13774222,3443555,21430,10715,10715,HfEnetJ7uBSmZWCjBNxdvv9HEC5nsW4wDV7wu6WnhWan,857209,4565325,-3708116,622
2022-01-05 22:24:27.673446,2022-01-05 17:18:44-05:00,1462,GGGyesjbt7h2XHHp9u8vpiWGugFwEbrtYaKrNQSDhQd7,8tydo1ZjGHmPBSqU33tywB3f9szdsHk1ckGFe4Ay5pgs,True,730848250,182712062,1115848,557924,557924,4BnQKPLuE3DMTtxp8MjUBytgnhvxqq3ZTqZHTVZo4JJh,44633948,376424320,-331790372,610
2022-01-05 22:24:27.673446,2022-01-05 17:18:44-05:00,1463,6eBSLXDMVoW2nG3n7s42RXDH8byY3C6n1RsUuegBLSrG,37dYrKnTXYer7Bu9xFfpArA4ZNo2B9bycFw9HywDtTRx,True,143605832,35901458,222763,111381,111382,4BnQKPLuE3DMTtxp8MjUBytgnhvxqq3ZTqZHTVZo4JJh,8910550,39358976,-30448426,620
2022-01-05 22:24:27.673446,2022-01-05 17:18:44-05:00,1464,BWtXpiXn1bomr28mGfQFTx1Kd58CQipEnKmeweYowDEC,9jws1qkXvWAdEtBvURVEeGcGJzt4zG2gh8AJESvjKKrx,True,1561300182,390325045,2420456,1210228,1210228,4BnQKPLuE3DMTtxp8MjUBytgnhvxqq3ZTqZHTVZo4JJh,96818253,535669863,-438851610,620
2022-01-05 22:24:27.673446,2022-01-05 17:18:45-05:00,1465,DAku12iueL13vRoTpKLyqdGaLQ2rWF6REe8Dr8soFvNs,H2vVH3LxkhGe6x6Mdwy67BYwTKNQM6XayKx7mhrwyfJM,True,6457406,1614351,9990,4995,4995,72FwbpFGoLEazJEdpqNtPNefsadUrimUqma9wSoy4qiS,399611,1942205,-1542594,618
2022-01-05 22:24:27.673446,2022-01-05 17:18:53-05:00,1466,8MKNsuGVaoYpdQy6NNyxDvRzh2DAquBUtri4nDsixUxs,D7M1SDmpZAs8vdPCCCa96UbDF15YQDxHmoGWB57tHiir,True,59935704,14983926,92095,46047,46048,72FwbpFGoLEazJEdpqNtPNefsadUrimUqma9wSoy4qiS,3683825,18717861,-15034036,614
2022-01-05 22:24:27.673446,2022-01-05 17:18:55-05:00,1467,3Lv2XpiD4KBUHq7Zx6u3zNhpXoySodXHH8o8f5yaaPxG,H6TN4rhpBXkEH3mZnymYNcKfmnxRH2uzfwzeLH2q6ahP,True,2703963,675990,4156,2078,2078,4BnQKPLuE3DMTtxp8MjUBytgnhvxqq3ZTqZHTVZo4JJh,166265,646950,-480685,614
2022-01-05 22:24:27.673446,2022-01-05 17:19:07-05:00,1468,3njiRuSRMXRzKmamyiR72Hc38PU8UDDmWdfPhgxmGxEW,5WoF3gkgygyNNbwxWgVfqGWkExcDixuzgJQQjXEZQ6J5,True,3692772100,923193025,5615791,2807895,2807896,4BnQKPLuE3DMTtxp8MjUBytgnhvxqq3ZTqZHTVZo4JJh,224631659,1692711522,-1468079863,608
2022-01-05 22:24:27.673446,2022-01-05 17:19:20-05:00,1469,6cnA7PeqQgpZdA7jBg4yMzTusm8JJHRWBMup84ywJfYo,FLqcukY7RehqY6ACrwVJnGH3eRgRDe93K1jLYCQN2F3U,True,1168186810,292046702,1803333,901666,901667,4BnQKPLuE3DMTtxp8MjUBytgnhvxqq3ZTqZHTVZo4JJh,72133335,407454791,-335321456,617
2022-01-05 22:24:27.673446,2022-01-05 17:19:20-05:00,1470,DmEVzPyCKnm89v481V2ic57vyikwwMja75uVZ2rjvjfp,38fPZzP4NwTtx7Qu6DLSqx9Sv8e5CQbSrr2BMvVmSy4J,True,343789755,85947438,533363,266681,266682,72FwbpFGoLEazJEdpqNtPNefsadUrimUqma9wSoy4qiS,21334521,122390513,-101055992,620
2022-01-05 22:24:27.673446,2022-01-05 17:19:23-05:00,1471,DMgPzJnMQfvpk6LWscs9V9CwnYDj4CEUgKB9S65WsTaY,BZRSLH1Vw1BQwXTZtBcgUYqmFF7TuzYxAaZ8TXUKwLUQ,True,93391,23347,144,72,72,4BnQKPLuE3DMTtxp8MjUBytgnhvxqq3ZTqZHTVZo4JJh,5788,31918,-26130,619
2022-01-05 22:24:27.673446,2022-01-05 17:19:34-05:00,1472,D3o7CSh2zCAQ93BDomDCitZ4vuxC83wGPMwJEEyBJK4C,A4nDfpUZkdtuWRRWZkoNXc5Ux7JU1UJA2JTHgkHAfYyP,True,710192325908,177548081477,1110360150,555180075,555180075,DddJ7EWCmYEEZETCBNgAUSg81Ls6fZtiAaY5ekJ5sXx1,44414406027,93092246258,-48677840231,625
2022-01-05 22:24:27.673446,2022-01-05 17:19:39-05:00,1473,CRW3nidAs2C3irLsEMsnffCvcjZH3wMBoKXG8PRp1Ss8,GD2un4iqMrnZ1kKnGLbzaSQy5iKjGSHHDN58tKibtHN3,True,846041738,211510434,1304331,652165,652166,DddJ7EWCmYEEZETCBNgAUSg81Ls6fZtiAaY5ekJ5sXx1,52173259,206131521,-153958262,616
2022-01-05 22:24:27.673446,2022-01-05 17:19:39-05:00,1474,2WobKrHvenN7m5ctpit6rEH4F5xUFF59akTQPGvpDG8J,67np4AWjFMWZRuvNnW6tVVQqWfzT9X3nvMaEyn36ityr,False,3431577913,3431577913,141689911,7084495,134605416,DddJ7EWCmYEEZETCBNgAUSg81Ls6fZtiAaY5ekJ5sXx1,141689911,1090222964,-948533053,412
2022-01-05 22:24:27.673446,2022-01-05 17:19:39-05:00,1475,Fcr4Y1XTnNv1xuGnAdssPRAxxu3gcdone44fBqvup7sB,JDjFXehdM1oz63wXop6pYpWoB4ptr7Dma8ZhTGH1HzTq,True,173648692884,43412173221,219641625,109820812,109820813,HfEnetJ7uBSmZWCjBNxdvv9HEC5nsW4wDV7wu6WnhWan,8785665021,58997186055,-50211521034,505
2022-01-05 22:24:27.673446,2022-01-05 17:19:40-05:00,1476,GWEfWJimTKDJuxSTAb7SxkT3L3FhPPu8wJzYYF8H4SgD,BdeMcj3cMyKVPeF7Mt9Jdpxgzq9P6c79qJR6ctiiDauL,True,529644267,132411066,779363,389681,389682,4BnQKPLuE3DMTtxp8MjUBytgnhvxqq3ZTqZHTVZo4JJh,31174535,132308604,-101134069,588
2022-01-05 22:24:27.673446,2022-01-05 17:19:40-05:00,1477,Gs3WP18hbzNpbBgiU39e6tfkggfCKRyNqPqJQcthuHFD,4XAY25YUma6gUdG2GdbXeivum3t21g93ZagfWGTZYkWZ,True,78365401,19591349,118626,59313,59313,DddJ7EWCmYEEZETCBNgAUSg81Ls6fZtiAaY5ekJ5sXx1,4745050,27555562,-22810512,605
2022-01-05 22:24:27.673446,2022-01-05 17:19:40-05:00,1478,7g3w8AzDms9SfbLDmgaH12toMFUHUd3Stx5c8KebUKxm,12wPjZucRWRH1nEBju4J1D9iAc93H1dDQtcEJzYRbZVN,False,32181128,32181128,891084,44554,846530,DddJ7EWCmYEEZETCBNgAUSg81Ls6fZtiAaY5ekJ5sXx1,891084,8414956,-7523872,276
2022-01-05 22:24:27.673446,2022-01-05 17:19:40-05:00,1479,FT8vMZ46cTViEsKNLGWKCiLxW74XZaEaT9tZSYyhnoj4,C6KGHMjDtokQubok3Cve2WGVA2jo8RZfuFdSEunp7PYK,False,1943487524,1943487524,41379347,2068967,39310380,4BnQKPLuE3DMTtxp8MjUBytgnhvxqq3ZTqZHTVZo4JJh,41379347,516651277,-475271930,212
2022-01-05 22:24:27.673446,2022-01-05 17:19:40-05:00,1480,872kcnRQ6wXcqDyqveM7qfuzhpKUtvzbX6E8gjYStB8H,4sZWxT7Lgr6WsAGFXSRKi7iTcX9iCYzmLQaPBQdgxtWC,False,25657282300,25657282300,1201827580,60091379,1141736201,4BnQKPLuE3DMTtxp8MjUBytgnhvxqq3ZTqZHTVZo4JJh,1201827580,6207958726,-5006131146,468
2022-01-05 22:24:27.673446,2022-01-05 17:19:40-05:00,1481,J1sBDjpdBZcsSBS5eg95SSRjRqmQUR9cXJCsLJu8yCUt,F5wRpD2senMkGbL8Uquqo8W9x5NQDDa268dHuVFAZCww,True,15380814,3845203,23958,11979,11979,4BnQKPLuE3DMTtxp8MjUBytgnhvxqq3ZTqZHTVZo4JJh,958358,5860476,-4902118,623
2022-01-05 22:24:27.673446,2022-01-05 17:19:40-05:00,1482,7LBZi7Ec4VKhtNJbFQYYY8CvFbsLPCvqmn8Rd5EVhn9n,CBgkKDhmsEa8Ug8nE9Yu95gLDbDQa9FNGpdjVRfEDXcq,True,639235314,159808828,965406,482703,482703,4BnQKPLuE3DMTtxp8MjUBytgnhvxqq3ZTqZHTVZo4JJh,38616266,178187074,-139570808,604
2022-01-05 22:24:27.673446,2022-01-05 17:19:40-05:00,1483,EYt1Pzqfwnd4iXSmcpw4T3Edmm1y3GnRhCjcQEEK4Atj,EHqporfvvfg7UQPsjv5tsgZE8u9yyRuEU2DdLpQeXy85,False,40197624388,40197624388,902998671,45149933,857848738,4BnQKPLuE3DMTtxp8MjUBytgnhvxqq3ZTqZHTVZo4JJh,902998671,9739572291,-8836573620,224
2022-01-05 22:24:27.673446,2022-01-05 17:19:40-05:00,1484,56488NdcUy6Hi6X5SLs2GFtW5pG4u5wJpH7vHdxTCx4z,tGgXjJeVr3W2m3T2NXPCqpBEd6HJKE2cRsgCyiDZQy4,True,169353636,42338408,227001,113500,113501,4BnQKPLuE3DMTtxp8MjUBytgnhvxqq3ZTqZHTVZo4JJh,9080077,64727810,-55647733,536
2022-01-05 22:24:27.673446,2022-01-05 17:19:40-05:00,1485,BAzH5niE2GX9CHGn3jK6Wv8Dd59PT95dX4dgfZXWoLPT,YNRnuEoNBPFsr7W91gc85TXAdA4ZnXfF2x951zbeRKF,True,324367,81090,448,224,224,4BnQKPLuE3DMTtxp8MjUBytgnhvxqq3ZTqZHTVZo4JJh,17924,94327,-76403,552
2022-01-05 22:24:27.673446,2022-01-05 17:19:40-05:00,1486,7mYQ2DJZ1YYMpNbpA93hCDtzQDhEHjAGxLJt2g4KeYTW,8nTKeruC3wiPjT7VytdM2gX7msjwbHxTkyhsR88GJgpc,True,154826447,38706611,206964,103482,103482,4BnQKPLuE3DMTtxp8MjUBytgnhvxqq3ZTqZHTVZo4JJh,8278565,37202725,-28924160,534
2022-01-05 22:24:27.673446,2022-01-05 17:19:40-05:00,1487,GKNBtZbwK4w9hyXD1r38NTGcTJhpjt8R9WFCzdXup9Tk,7RLaL2XoFuqrcCcPEB6FzPJzLnAhjQpwcRmDfdpRXFgB,True,144916270,36229067,202948,101474,101474,4BnQKPLuE3DMTtxp8MjUBytgnhvxqq3ZTqZHTVZo4JJh,8117941,53300943,-45183002,560
2022-01-05 22:24:27.673446,2022-01-05 17:19:40-05:00,1488,BhiAaiZu7fF8ndggJrLyiFVCRq526cNBw7VaeascEmNL,4en8MipPi7vq15NGhpPMQfptNdEyhp2j7fpgxBBtjyfz,True,6880537,1720133,9624,4812,4812,4BnQKPLuE3DMTtxp8MjUBytgnhvxqq3ZTqZHTVZo4JJh,384978,2021668,-1636690,559
2022-01-05 22:24:27.673446,2022-01-05 17:19:40-05:00,1489,FiEP5hTUpXeQadRim55G4Xfzht8KZQG8WpTuzLX4x5rD,GqXWAjECWr1X29tDHK1Pj3s9ecRXXXNrbaWmMYHCp5Pj,False,35000765,35000765,915329,45766,869563,4BnQKPLuE3DMTtxp8MjUBytgnhvxqq3ZTqZHTVZo4JJh,915329,9905764,-8990435,261
2022-01-05 22:24:27.673446,2022-01-05 17:19:40-05:00,1490,2YcB3QQGWho5oogDd1nK3cpLQzwwwXGxybrhe2xDkDxq,5DjAUp6CxKStYTaXSnzjvYkfqCXfG8Y61bWw5UwbbE3q,True,22711522,5677880,34344,17172,17172,4BnQKPLuE3DMTtxp8MjUBytgnhvxqq3ZTqZHTVZo4JJh,1373769,8576863,-7203094,604
2022-01-05 22:24:27.673446,2022-01-05 17:19:41-05:00,1491,CRW3nidAs2C3irLsEMsnffCvcjZH3wMBoKXG8PRp1Ss8,GD2un4iqMrnZ1kKnGLbzaSQy5iKjGSHHDN58tKibtHN3,True,614710588,153677647,776205,388102,388103,DddJ7EWCmYEEZETCBNgAUSg81Ls6fZtiAaY5ekJ5sXx1,31048212,166361803,-135313591,505
2022-01-05 22:24:27.673446,2022-01-05 17:19:41-05:00,1492,DGbj8tnqECzM9FG8j225Ap7A4Fdm3J1Ksm32JBFG7igv,Cd3D2UVwoSZLygM2e3UQppQANsokpmx5CNBs1C5zueay,True,7273381,1818344,10038,5019,5019,4BnQKPLuE3DMTtxp8MjUBytgnhvxqq3ZTqZHTVZo4JJh,401545,2143136,-1741591,552
2022-01-05 22:24:27.673446,2022-01-05 17:19:41-05:00,1493,CUhCSd7jHvycC89L6EqMoDWcWVTXXHhAeXVyB4362qZg,J7B9JBV1xR8a7DKKrw3JwGusY4H2bSQuyHtod2Fzf4jq,False,13472314,13472314,158443,7922,150521,4BnQKPLuE3DMTtxp8MjUBytgnhvxqq3ZTqZHTVZo4JJh,158443,3932410,-3773967,117
2022-01-05 22:24:27.673446,2022-01-05 17:19:41-05:00,1494,4gzW9gBbEMnNm1epY6MMJ1XfxGMtvn2mKFyKPQ2Gyb79,G6x862hmMJ2PLpyyPDwVPGapXjvEeNkqFRTAS3jWVozB,True,34578525,8644631,51345,25672,25673,DddJ7EWCmYEEZETCBNgAUSg81Ls6fZtiAaY5ekJ5sXx1,2053801,13137465,-11083664,593
2022-01-05 22:24:27.673446,2022-01-05 17:19:41-05:00,1495,gMjmD7WioyUdQdwNqE5fobLcxPwoJv5rAvLmJaf8Jjw,5n77euFjVJiwKrnbYq1KpcENW1mzBZj2BuDGyzazrkJ8,True,7224364,1806090,10956,5478,5478,4BnQKPLuE3DMTtxp8MjUBytgnhvxqq3ZTqZHTVZo4JJh,438272,2201327,-1763055,606
2022-01-05 22:24:27.673446,2022-01-05 17:19:41-05:00,1496,HAk9c831TRUhvpoK4d7PTqfJuJhSjnJUXWpnYsH85bDJ,DVSa3CJrVLTHAeFYjEF89ZjWRm86QwruUk2Y8RvGpjsr,True,346469,86616,455,227,228,4BnQKPLuE3DMTtxp8MjUBytgnhvxqq3ZTqZHTVZo4JJh,18234,99862,-81628,526
2022-01-05 22:24:27.673446,2022-01-05 17:19:41-05:00,1497,GRve31SsUSCKaBMxgnLDfjWkp3cg6vB7NAZddTxgwmPS,7QjpYFUFhh1njvaevNzwr58ULBrvepXNGZ4LY9YzbKKn,False,617664461,617664461,6472001,323600,6148401,4BnQKPLuE3DMTtxp8MjUBytgnhvxqq3ZTqZHTVZo4JJh,6472001,164415557,-157943556,104
2022-01-05 22:24:27.673446,2022-01-05 17:19:41-05:00,1498,Br1j5Ftafei7ysu5SmqVZSoRe4uS4qCPeKSPHg55pyiE,G8fc7QvXjfkgBFvAVUgJFQS3VaF1biL9rktBExGa87Ks,True,21888498515,5472124628,27685442,13842721,13842721,4BnQKPLuE3DMTtxp8MjUBytgnhvxqq3ZTqZHTVZo4JJh,1107417705,5723546585,-4616128880,505
2022-01-05 22:24:27.673446,2022-01-05 17:19:41-05:00,1499,DQpBbEYdqr6p17dbdej27TyK1feB7QRS79zBpWqDQmUC,Dk2kdrACai34GffFLvRPJkXDTovoHJ4BPpSbS3ghKU4g,False,34012267,34012267,1029129,51456,977673,4BnQKPLuE3DMTtxp8MjUBytgnhvxqq3ZTqZHTVZo4JJh,1029129,9908262,-8879133,302
2022-01-05 22:24:27.673446,2022-01-05 17:19:41-05:00,1500,Fcr4Y1XTnNv1xuGnAdssPRAxxu3gcdone44fBqvup7sB,JDjFXehdM1oz63wXop6pYpWoB4ptr7Dma8ZhTGH1HzTq,False,127935759767,127935759767,6265263500,313263175,5952000325,HfEnetJ7uBSmZWCjBNxdvv9HEC5nsW4wDV7wu6WnhWan,6265263500,47343553743,-41078290243,489
2022-01-05 22:24:27.673446,2022-01-05 17:19:41-05:00,1501,7aKxZg1aoLuB51JUw7fruF77ts7SWoB7pcLBZKHZMynr,AAnbLY82UGULqaDNdyJHrYu7X3hGaBuiTkGWmh8qKTc,False,95882732961,95882732961,3605277491,180263874,3425013617,4BnQKPLuE3DMTtxp8MjUBytgnhvxqq3ZTqZHTVZo4JJh,3605277491,4667640578,-1062363087,376
2022-01-05 22:24:27.673446,2022-01-05 17:19:48-05:00,1502,FMdKLXhQEnNJtvM17ZX8jhaeMaSD9UgDuN3Kw7kMrd7K,5pURHYWB5LUGwJmWVBGH8p6oyR9NJvXnZk7uDVoiassv,False,50344042,50344042,2407917,120395,2287522,4BnQKPLuE3DMTtxp8MjUBytgnhvxqq3ZTqZHTVZo4JJh,2407917,16546154,-14138237,478
2022-01-05 22:24:27.673446,2022-01-05 17:19:48-05:00,1503,EBUcTqh9AYyRokZRzLbPKL9ZmTUx6KcDEbBeuCLGwqYC,B5WSXfHzYQhUFE2T97GaiqSkeejTWKKGVjMkcFrxEvyJ,False,326053547,326053547,16265313,813265,15452048,HfEnetJ7uBSmZWCjBNxdvv9HEC5nsW4wDV7wu6WnhWan,16265313,96280270,-80014957,498
2022-01-05 22:24:27.673446,2022-01-05 17:19:50-05:00,1504,ANQkPUoMjLHyRtypeKzxsKW1DFauQsh9SnB3rRgRXM1Y,7RHAExWpG8Q3PXwKhJs2yXmYK9WogGydvFYpx28p6pgr,True,1049698154,262424538,1613518,806759,806759,4BnQKPLuE3DMTtxp8MjUBytgnhvxqq3ZTqZHTVZo4JJh,64540726,379444388,-314903662,614
2022-01-05 22:24:27.673446,2022-01-05 17:19:50-05:00,1505,G25vsB3sDqRhHoSK4KwR1TywfrJDtpejVbbevEG9sQ9a,5xFC3Hm13magnAA9GD1EnwC9PrPoEfQ7omEa9p9zCrB1,True,9805469,2451367,14811,7405,7406,72FwbpFGoLEazJEdpqNtPNefsadUrimUqma9wSoy4qiS,592449,2803688,-2211239,604
2022-01-05 22:24:27.673446,2022-01-05 17:19:50-05:00,1506,6yw4GPvkqUbakcEWtqSCfjVLukty11xqjDpGxtEN9Km2,5ppEx7wkpqbG5nApCWMdRja3oRSheFmAAsNHUX7h2w2Y,True,23877924,5969481,36677,18338,18339,HfEnetJ7uBSmZWCjBNxdvv9HEC5nsW4wDV7wu6WnhWan,1467091,14874495,-13407404,614
2022-01-05 22:24:27.673446,2022-01-05 17:19:50-05:00,1507,EanSXRkJu91FKUhPCzYxWkmM3PQUWcovEnoZXcd6vQ9E,Fg4EzAzHStoLRDPmoBUczdWnWrhAb7jKEujqAujLFT8,True,2908842872,727210718,3694538,1847269,1847269,4BnQKPLuE3DMTtxp8MjUBytgnhvxqq3ZTqZHTVZo4JJh,147781552,696078680,-548297128,508
2022-01-05 22:24:27.673446,2022-01-05 17:19:50-05:00,1508,2VyFcgZDH1HTEvD1XaWhwqBCMmZ1k6TmZ3fEpPcBZR9E,G1wFJETTpdoc7CfypGCzkq1jssXPfUkiuLjK2cwVZ9dJ,True,1165576,291393,1809,904,905,DddJ7EWCmYEEZETCBNgAUSg81Ls6fZtiAaY5ekJ5sXx1,72378,351386,-279008,620
2022-01-05 22:24:27.673446,2022-01-05 17:19:51-05:00,1509,gHv15388BYFZ6PS2p7XTvT9QViJ1rjevHdykD6Pmvzh,9YZPTB6d7St4TPpMY2vP4rZ56B2ZvzViB1DLWbPLK1hn,False,333917622,333917622,16077161,803858,15273303,DddJ7EWCmYEEZETCBNgAUSg81Ls6fZtiAaY5ekJ5sXx1,16077161,129968924,-113891763,481
2022-01-05 22:24:27.673446,2022-01-05 17:19:58-05:00,1510,EmGW2aAG69ssWqCtbfDocRaM2u3TJsczn2HHP9jdmRvD,aypkDKsp9uqAB4F6mwvm5LofpsrFBuZT2MMWtE2eHdB,True,9335504,2333876,14321,7160,7161,DddJ7EWCmYEEZETCBNgAUSg81Ls6fZtiAaY5ekJ5sXx1,572866,2486230,-1913364,613
2022-01-05 22:24:27.673446,2022-01-05 17:19:58-05:00,1511,BWtXpiXn1bomr28mGfQFTx1Kd58CQipEnKmeweYowDEC,9jws1qkXvWAdEtBvURVEeGcGJzt4zG2gh8AJESvjKKrx,True,1148168821,287042205,1789787,894893,894894,4BnQKPLuE3DMTtxp8MjUBytgnhvxqq3ZTqZHTVZo4JJh,71591481,423627844,-352036363,623
2022-01-05 22:24:27.673446,2022-01-05 17:20:00-05:00,1512,64nf6XvL2L7Tx4vZJkAsATE66fiDvgueHryriiesW3JF,2mXMvWYphTBSo1TJY7HJ5UM62r5q6t8bVmh6TMybCh2A,False,410292929,410292929,3860217,193010,3667207,4BnQKPLuE3DMTtxp8MjUBytgnhvxqq3ZTqZHTVZo4JJh,3860217,102578447,-98718230,94
2022-01-05 22:24:27.673446,2022-01-05 17:20:00-05:00,1513,GjQQ2fQ7mrGjWZwjVYFUKp9NM1LmfkhEo675ovU5SPa8,ECgVUMRY5nB4MALs5drDyipF7YohCPuJpj2UegCs7HMn,True,240230133,60057533,325473,162736,162737,4BnQKPLuE3DMTtxp8MjUBytgnhvxqq3ZTqZHTVZo4JJh,13018954,57677700,-44658746,541
2022-01-05 22:24:27.673446,2022-01-05 17:20:00-05:00,1514,864zY9zuCktUurPTtdGeLvUATnDqHZpT1GeWUApsXh2m,CzatBrNJUi7MeyfbNhszRaPMidgt8Xkcmy5ZwFMP9RCs,True,219916266,54979066,334881,167440,167441,4BnQKPLuE3DMTtxp8MjUBytgnhvxqq3ZTqZHTVZo4JJh,13395244,64668716,-51273472,609
2022-01-05 22:24:27.673446,2022-01-05 17:20:00-05:00,1515,A7eQLoPeQjr2e5KThoPuXEps8n1vrGxtwT72ynXY1NDn,EBSWSXy8cqYwTB6hW44C4SLUzeFE2xPSRMLfgk3pseey,False,27402788,27402788,0,0,0,4BnQKPLuE3DMTtxp8MjUBytgnhvxqq3ZTqZHTVZo4JJh,0,8822417,-8901012,0
2022-01-05 22:24:27.673446,2022-01-05 17:20:00-05:00,1516,FtNFtrFpUxLGDP3KTusCxgWMiDqXErcBLzPHVXDwTvNH,FnJfrBQYt9arf1sY3MJn9r8ZWGgjG8mVt5X8pcond5p,False,314753,314753,14519,725,13794,4BnQKPLuE3DMTtxp8MjUBytgnhvxqq3ZTqZHTVZo4JJh,14519,93127,-78608,461
2022-01-05 22:24:27.673446,2022-01-05 17:20:00-05:00,1517,CRW3nidAs2C3irLsEMsnffCvcjZH3wMBoKXG8PRp1Ss8,GD2un4iqMrnZ1kKnGLbzaSQy5iKjGSHHDN58tKibtHN3,False,439491354,439491354,8730420,436521,8293899,4BnQKPLuE3DMTtxp8MjUBytgnhvxqq3ZTqZHTVZo4JJh,8730420,131770588,-123040168,198
2022-01-05 22:24:27.673446,2022-01-05 17:20:03-05:00,1518,6uRrd6hWqGFtttnEnTPqxLCbnr77hjXVSx91RLWLJXiu,By4VK3CoUmszYoUhLHctHSvh7NYJ2hmuwT81pqzzbgr3,False,1184583158,1184583158,0,0,0,DddJ7EWCmYEEZETCBNgAUSg81Ls6fZtiAaY5ekJ5sXx1,0,328240275,-341155349,0
2022-01-05 22:24:27.673446,2022-01-05 17:20:05-05:00,1519,8RmB8o4zux2sD48dEsKpsX475KRxTwdk8QULUDU9xx8R,AKSiZnb4YKVB6B86aPPqvyXquhvN9xqt45bexBCZ7nx,True,915924295,228981073,1402238,701119,701119,4BnQKPLuE3DMTtxp8MjUBytgnhvxqq3ZTqZHTVZo4JJh,56089538,324937562,-268848024,612
2022-01-05 22:24:27.673446,2022-01-05 17:20:05-05:00,1520,8BTja7VnFPe6M9BHTqg5LTpX6vd4ugTeWLzpq3oFP8WM,pscjH4sPnNL6zQBmvHjEEbix6BTstnsrSwGysNWyPkd,True,230712,57676,294,147,147,72FwbpFGoLEazJEdpqNtPNefsadUrimUqma9wSoy4qiS,11797,72673,-60876,511
2022-01-05 22:24:27.673446,2022-01-05 17:20:05-05:00,1521,DvuRmJkfn6FQczUKgYeaSCqwy2NTMunuAKNrnmxMvnzS,7LpWTX9dgBtW75kfEoB5WuNsDwEdw5s8CYSHh3J4qagM,True,1282049328,320512332,1615446,807723,807723,HfEnetJ7uBSmZWCjBNxdvv9HEC5nsW4wDV7wu6WnhWan,64617866,372516607,-307898741,504
2022-01-05 22:24:27.673446,2022-01-05 17:20:05-05:00,1522,C9JiT1sQhakzmJuCPfGDq2RV2HjMtCW8CBXVp9shKSuG,4ko8VYv8RafkXbe9FqZrBDbBdF73EgUphzctWr8RrhQQ,False,2974517992,2974517992,0,0,0,HfEnetJ7uBSmZWCjBNxdvv9HEC5nsW4wDV7wu6WnhWan,0,998755073,-1025085374,0
2022-01-05 22:24:27.673446,2022-01-05 17:20:06-05:00,1523,8NdcaYUC1X5CP7FMDip78uqtqmCt8GcZdCzLRTYTihmb,9Ei1K9bXWXSXcBfeX5exPSXGCAu62WSKzvnnd4wHvyVh,True,1899367,474841,2900,1450,1450,HfEnetJ7uBSmZWCjBNxdvv9HEC5nsW4wDV7wu6WnhWan,116037,466248,-350211,610
2022-01-05 22:24:27.673446,2022-01-05 17:20:06-05:00,1524,2FrqGFZjbiNykJyo9BZ5S9FguQJPJiTi681rJJsQ5dta,3QUncYP92NKrfpaTvuF9iQg11PXKgZAgEngwh6BbnCCj,True,11940751,2985187,18234,9117,9117,4BnQKPLuE3DMTtxp8MjUBytgnhvxqq3ZTqZHTVZo4JJh,729382,2674518,-1945136,610
2022-01-05 22:24:27.673446,2022-01-05 17:20:06-05:00,1525,DLfNhCzgrUtFAFLWYyRNUBTmai8gDrfASodiRQ8cZcen,8LGumRJeVJrhfnRdNCVw46ZpPASDopYcLCCHd5Fncspb,False,538496004,538496004,420806,21040,399766,DddJ7EWCmYEEZETCBNgAUSg81Ls6fZtiAaY5ekJ5sXx1,420806,196898877,-196478071,7
2022-01-05 22:24:27.673446,2022-01-05 17:20:06-05:00,1526,HJ7BVAfDebv4BdidspqFq6xZrHHfGkjXFBXorjFHxc83,Btpv3KPy1quhFZGconD7sLA8pR9z9wTKivq154bcw9AQ,False,29467996,29467996,643863,32193,611670,DddJ7EWCmYEEZETCBNgAUSg81Ls6fZtiAaY5ekJ5sXx1,643863,4705361,-4061498,218
2022-01-05 22:24:27.673446,2022-01-05 17:20:06-05:00,1527,BAzH5niE2GX9CHGn3jK6Wv8Dd59PT95dX4dgfZXWoLPT,YNRnuEoNBPFsr7W91gc85TXAdA4ZnXfF2x951zbeRKF,True,240551,60136,368,184,184,HfEnetJ7uBSmZWCjBNxdvv9HEC5nsW4wDV7wu6WnhWan,14750,74783,-60033,613
2022-01-05 22:24:27.673446,2022-01-05 17:20:06-05:00,1528,7bnCuBLXnPS3wDBunrzoV5qm1GwfnPfRBwV2f9Xzo3Aj,9Xd7GNcFrx7z66DRW8kK3d1jN4tzuiwv9jyDFbHUx9vW,True,234885,58719,296,148,148,HfEnetJ7uBSmZWCjBNxdvv9HEC5nsW4wDV7wu6WnhWan,11844,74832,-62988,504
2022-01-05 22:24:27.673446,2022-01-05 17:20:06-05:00,1529,82UCLECeKk9tWXQgt5cyQGNT3FQc841dCmQeLUv8wp58,47aXWsk5kkVwmcQh9cc8vhxYin3BuGWtr8eQ1H8Tehcj,False,598407,598407,24410,1220,23190,DddJ7EWCmYEEZETCBNgAUSg81Ls6fZtiAaY5ekJ5sXx1,24410,145267,-120857,407
2022-01-05 22:24:27.673446,2022-01-05 17:20:06-05:00,1530,FuoFPNTdYVDkSHaBac6UC1aNJXafSNTvFJuBCdrgQQrH,ApBS1Fx83tcECMzDV6wEzEzEdg4e2hgj3djtjRUoSKK5,True,4145932199,1036483049,5912043,2956021,2956022,4BnQKPLuE3DMTtxp8MjUBytgnhvxqq3ZTqZHTVZo4JJh,236481735,956484902,-720003167,570
2022-01-05 22:24:27.673446,2022-01-05 17:20:09-05:00,1531,D3o7CSh2zCAQ93BDomDCitZ4vuxC83wGPMwJEEyBJK4C,A4nDfpUZkdtuWRRWZkoNXc5Ux7JU1UJA2JTHgkHAfYyP,False,511304531765,511304531765,21964333211,1098216660,20866116551,HfEnetJ7uBSmZWCjBNxdvv9HEC5nsW4wDV7wu6WnhWan,21964333211,85565707593,-63601374382,429
2022-01-05 22:24:27.673446,2022-01-05 17:20:16-05:00,1532,J1sBDjpdBZcsSBS5eg95SSRjRqmQUR9cXJCsLJu8yCUt,F5wRpD2senMkGbL8Uquqo8W9x5NQDDa268dHuVFAZCww,True,11221588,2805397,15509,7754,7755,DddJ7EWCmYEEZETCBNgAUSg81Ls6fZtiAaY5ekJ5sXx1,620377,4610993,-3990616,552
2022-01-05 22:24:27.673446,2022-01-05 17:20:16-05:00,1533,G25vsB3sDqRhHoSK4KwR1TywfrJDtpejVbbevEG9sQ9a,5xFC3Hm13magnAA9GD1EnwC9PrPoEfQ7omEa9p9zCrB1,True,7162655,1790663,9654,4827,4827,4BnQKPLuE3DMTtxp8MjUBytgnhvxqq3ZTqZHTVZo4JJh,386191,2236070,-1849879,539
2022-01-05 22:24:27.673446,2022-01-05 17:20:16-05:00,1534,BhiAaiZu7fF8ndggJrLyiFVCRq526cNBw7VaeascEmNL,4en8MipPi7vq15NGhpPMQfptNdEyhp2j7fpgxBBtjyfz,True,5042346,1260585,6432,3216,3216,DddJ7EWCmYEEZETCBNgAUSg81Ls6fZtiAaY5ekJ5sXx1,257296,1602874,-1345578,510
2022-01-05 22:24:27.673446,2022-01-05 17:20:17-05:00,1535,GWEfWJimTKDJuxSTAb7SxkT3L3FhPPu8wJzYYF8H4SgD,BdeMcj3cMyKVPeF7Mt9Jdpxgzq9P6c79qJR6ctiiDauL,True,386446317,96611579,490207,245103,245104,HfEnetJ7uBSmZWCjBNxdvv9HEC5nsW4wDV7wu6WnhWan,19608288,106249677,-86641389,507
2022-01-05 22:24:27.673446,2022-01-05 17:20:19-05:00,1536,DH2tcZVt4nHQbph6znZRrwcyhjwiNYtgeamu72vcC6nR,ACsbP5BDFQEHQHTsdrWTBShhEUh9HeAKsE7iwyK72v2p,False,3928294,3928294,165746,8287,157459,4BnQKPLuE3DMTtxp8MjUBytgnhvxqq3ZTqZHTVZo4JJh,165746,1578243,-1412497,421
2022-01-05 22:24:27.673446,2022-01-05 17:20:22-05:00,1537,D58t4uTjFumsUeYFaKnpV8BRTEQEqKXBreFTdwGrott7,67p6kHDfVqQijfcwugvZK59c3aRRH9x3eHxruqH8WEqF,True,5836170,1459042,7723,3861,3862,4BnQKPLuE3DMTtxp8MjUBytgnhvxqq3ZTqZHTVZo4JJh,308958,1926065,-1617107,529
2022-01-05 22:24:27.673446,2022-01-05 17:20:22-05:00,1538,5qsUv9aZs6vFuGvbEg9Q5aDSjC1oETnRCxZ86bj5RgAu,6fRReXL5giyRHB5NaZ3Br53wDtsmwMXAUQ8ysFdpGtWi,False,41869018619,41869018619,1590364652,79518232,1510846420,4BnQKPLuE3DMTtxp8MjUBytgnhvxqq3ZTqZHTVZo4JJh,1590364652,8492801675,-6902437023,379
2022-01-05 22:24:27.673446,2022-01-05 17:20:22-05:00,1539,3WN8GWa5LN3THWxvTpNB7r6gZmzGJ6kqbiGqdywjoRzz,8ZffpPH3CQsB8vPSW4nVzWL3GcZuLT6ZWgkBYJT5yaYi,False,2029518440,2029518440,74126999,3706349,70420650,4BnQKPLuE3DMTtxp8MjUBytgnhvxqq3ZTqZHTVZo4JJh,74126999,438683228,-364556229,365
2022-01-05 22:24:27.673446,2022-01-05 17:20:23-05:00,1540,AHm7zF4rpaxaayBLn5QDHgJSp8KAr647s4cNvQ9wLgd7,FDM33WngED24pukBvSDpPAzinW6afVAeGReum5nyLRiC,True,11973058,2993264,18389,9194,9195,4BnQKPLuE3DMTtxp8MjUBytgnhvxqq3ZTqZHTVZo4JJh,735578,3632225,-2896647,614
2022-01-05 22:24:27.673446,2022-01-05 17:20:24-05:00,1541,Dng7By2saPu5TVxcvXidBe71ggBo8tiHkAXPi4kKL1tk,75ufEJmHbLHffphL7tvAXhGyftKLr1z2PXXoB2GGY5fG,False,5440356,5440356,265797,13289,252508,HfEnetJ7uBSmZWCjBNxdvv9HEC5nsW4wDV7wu6WnhWan,265797,1780105,-1514308,488
2022-01-05 22:24:27.673446,2022-01-05 17:20:25-05:00,1542,BhiAaiZu7fF8ndggJrLyiFVCRq526cNBw7VaeascEmNL,4en8MipPi7vq15NGhpPMQfptNdEyhp2j7fpgxBBtjyfz,True,3764168,941041,5831,2915,2916,72FwbpFGoLEazJEdpqNtPNefsadUrimUqma9wSoy4qiS,233271,1260049,-1026778,619
2022-01-05 22:24:27.673446,2022-01-05 17:20:25-05:00,1543,Hy3kzXneDN6FUkiZctU1vWe97BYvj6yZ7QvQzehfWmNr,EhXgQg8BTniANV525RpY76z7Hrh6DuqrMChjqEoXfVJe,True,10120500,2530124,15640,7820,7820,4BnQKPLuE3DMTtxp8MjUBytgnhvxqq3ZTqZHTVZo4JJh,625612,3616868,-2991256,618
2022-01-05 22:24:27.673446,2022-01-05 17:20:25-05:00,1544,Fd2HrzBAr4JobRPARZwpQHHVoSCEoog32A6tKMWAC1sK,BYappsar5sQf8VLem4wrLuTtrDFH9y8pEx1aMxfuU4Pq,True,435326913,108831728,664325,332162,332163,4BnQKPLuE3DMTtxp8MjUBytgnhvxqq3ZTqZHTVZo4JJh,26573012,125464156,-98891144,610
2022-01-05 22:24:27.673446,2022-01-05 17:20:26-05:00,1545,BgoKAyBNaJ1geeQ2FcGSHEQDWATVD3w3wmcNHtj8Awu3,8Haz7duE2ycueaJsGdrGNnK79KGHwnzKBpoafC8RZGg2,False,115818872,115818872,3686563,184328,3502235,4BnQKPLuE3DMTtxp8MjUBytgnhvxqq3ZTqZHTVZo4JJh,3686563,46284642,-42598079,318
2022-01-05 22:24:27.673446,2022-01-05 17:20:27-05:00,1546,AoPQqPjLPi8fZiLkhMGLRj6oD5k2asrvJtCkpW19DvGr,H5Sgmf1VuY13iHjPuLJ2q9wtSdkXG1AQsEv2eq6zzm8Y,False,5668357,5668357,248364,12418,235946,4BnQKPLuE3DMTtxp8MjUBytgnhvxqq3ZTqZHTVZo4JJh,248364,1837997,-1589633,438
2022-01-05 22:24:27.673446,2022-01-05 17:20:27-05:00,1547,FoYrQCyDQ75YMNvkgTULbVHYmdrsoFJHohBLPfeF5rEH,DUyVhESZMDUS6Rqsz92CnW2KbWzAs6soEzZqD59XAKzY,False,138891690,138891690,5388745,269437,5119308,4BnQKPLuE3DMTtxp8MjUBytgnhvxqq3ZTqZHTVZo4JJh,5388745,50417289,-45028544,387
2022-01-05 22:24:27.673446,2022-01-05 17:20:27-05:00,1548,4KMzwWHPeW51cxu4nMpbqCaqo96dMqaHWyRCGQktfQfd,F7q4GNYcbnZa8dJ4qovQwjmxpKpdEmdxQMXRPb9nQupa,False,5814584,5814584,289274,14463,274811,72FwbpFGoLEazJEdpqNtPNefsadUrimUqma9wSoy4qiS,289274,1926082,-1636808,497
2022-01-05 22:24:27.673446,2022-01-05 17:20:28-05:00,1549,Gs3WP18hbzNpbBgiU39e6tfkggfCKRyNqPqJQcthuHFD,4XAY25YUma6gUdG2GdbXeivum3t21g93ZagfWGTZYkWZ,True,57621222,14405305,86839,43419,43420,4BnQKPLuE3DMTtxp8MjUBytgnhvxqq3ZTqZHTVZo4JJh,3473594,21734349,-18260755,602
2022-01-05 22:24:27.673446,2022-01-05 17:20:28-05:00,1550,AaMCg49sJwNtdB5wHACg15TYAzzJXy8xtG4zuVXhKiVE,HbDYqDa9bewGPvsiaHRM9HmEvh1scPaUaGvqog66gYir,False,5728897,5728897,261158,13057,248101,72FwbpFGoLEazJEdpqNtPNefsadUrimUqma9wSoy4qiS,261158,1857960,-1596802,455
2022-01-05 22:24:27.673446,2022-01-05 17:20:28-05:00,1551,4gzW9gBbEMnNm1epY6MMJ1XfxGMtvn2mKFyKPQ2Gyb79,G6x862hmMJ2PLpyyPDwVPGapXjvEeNkqFRTAS3jWVozB,False,25086075,25086075,1154637,57731,1096906,DddJ7EWCmYEEZETCBNgAUSg81Ls6fZtiAaY5ekJ5sXx1,1154637,10315223,-9160586,460
2022-01-05 22:24:27.673446,2022-01-05 17:20:28-05:00,1552,Cv5oVktxmqbU1SxraxH67NEWMKnjgA18R832Fhe9h74a,Cs7xBD4BDiohyopnaYDDChUtR9vmx7uwot6Qp9beQLzt,False,5092098,5092098,244075,12203,231872,4BnQKPLuE3DMTtxp8MjUBytgnhvxqq3ZTqZHTVZo4JJh,244075,1671680,-1427605,479
2022-01-05 22:24:27.673446,2022-01-05 17:20:29-05:00,1553,H3x9b27yHVdCxvtDf7mmJxkNeubcmQMwfAkLTYADPWNv,HGVCCz23rWx78vrTB2wvm2aesbLZuYFhhNuznGiSSAyA,True,7916479916,1979119979,12360145,6180072,6180073,DddJ7EWCmYEEZETCBNgAUSg81Ls6fZtiAaY5ekJ5sXx1,494405802,1467027996,-972622194,624
2022-01-05 22:24:27.673446,2022-01-05 17:20:29-05:00,1554,7mYQ2DJZ1YYMpNbpA93hCDtzQDhEHjAGxLJt2g4KeYTW,8nTKeruC3wiPjT7VytdM2gX7msjwbHxTkyhsR88GJgpc,False,112294016,112294016,4245781,212289,4033492,HfEnetJ7uBSmZWCjBNxdvv9HEC5nsW4wDV7wu6WnhWan,4245781,29765058,-25519277,378
2022-01-05 22:24:27.673446,2022-01-05 17:20:29-05:00,1555,6woJkgUd2cpQQQBEp1C2G9NsYAvPwYmZXXTd6AxhieMy,E6xCdLJbDq5qFsvHEffD1Qfqrsj19H81mbj7XMUXUPnr,False,80568658,80568658,2899704,144985,2754719,4BnQKPLuE3DMTtxp8MjUBytgnhvxqq3ZTqZHTVZo4JJh,2899704,32148855,-29249151,359
2022-01-05 22:24:27.673446,2022-01-05 17:20:29-05:00,1556,gMjmD7WioyUdQdwNqE5fobLcxPwoJv5rAvLmJaf8Jjw,5n77euFjVJiwKrnbYq1KpcENW1mzBZj2BuDGyzazrkJ8,True,5284593,1321148,7340,3670,3670,HfEnetJ7uBSmZWCjBNxdvv9HEC5nsW4wDV7wu6WnhWan,293635,1749610,-1455975,555
2022-01-05 22:24:27.673446,2022-01-05 17:20:29-05:00,1557,63a7SaSJr3AKiHEWJjfqZMQjshZpa2AKeSLN6JAnNRnq,2KkuFUWtLo53MPiVBKyPETAaZuf1xvxzy1ZwbEYdnf2a,False,4257939423,4257939423,142435419,7121770,135313649,4BnQKPLuE3DMTtxp8MjUBytgnhvxqq3ZTqZHTVZo4JJh,142435419,920903338,-778467919,334
2022-01-05 22:24:27.673446,2022-01-05 17:20:32-05:00,1558,7jvKp6onXyWgwsFrFWj4hYTXJsYYD6ot5mn6rPFuJriy,J7N6HiozevJVTiY9hDEUs2ud5BwT5QSE7wnMBS1w5ie2,True,343373284,85843321,468053,234026,234027,4BnQKPLuE3DMTtxp8MjUBytgnhvxqq3ZTqZHTVZo4JJh,18722140,125930341,-107208201,545
2022-01-05 22:24:27.673446,2022-01-05 17:20:32-05:00,1559,7iUx7JBwqUvPVPeCqMEXQdLccZJmaFYm1DUQiu3ouHa3,3EVZzhRmJnX9ZiBZZo9tenDtMogAyuA1yf2cKzvUWiuu,True,6633274,1658318,8897,4448,4449,4BnQKPLuE3DMTtxp8MjUBytgnhvxqq3ZTqZHTVZo4JJh,355883,2238080,-1882197,536
2022-01-05 22:24:27.673446,2022-01-05 17:20:32-05:00,1560,8gBsfVCJe6xDQSdTZY9ZVjpjc4JsEmfNBdWyu78PofEK,7kpHB2hhHKGEEJFamZ3CcJjMRnvZKyZLXm1dP8xqrnGu,False,4644385426,4644385426,140285558,7014277,133271281,4BnQKPLuE3DMTtxp8MjUBytgnhvxqq3ZTqZHTVZo4JJh,140285558,1009662736,-869377178,302
2022-01-05 22:24:27.673446,2022-01-05 17:20:32-05:00,1561,72L76qDRMK3M7X52zuuB9GVyvFFLDBZwFMpVjWjghXzA,4m2ZVuemUctu1edv4YJVAcjXzKwpbCmBujzoUmLDeA7h,False,5933105,5933105,286447,14322,272125,72FwbpFGoLEazJEdpqNtPNefsadUrimUqma9wSoy4qiS,286447,1928047,-1641600,482
2022-01-05 22:24:27.673446,2022-01-05 17:20:32-05:00,1562,Dn916KSmX3HqxT53hrxrbCrV3tdRMCPdaoiRLqetMrth,ATCXRiXgnjRRUbSTPBvtBXMENCqsViexSZbZ6aDaXXWA,True,10090662,2522664,13633,6816,6817,4BnQKPLuE3DMTtxp8MjUBytgnhvxqq3ZTqZHTVZo4JJh,545332,3103492,-2558160,540
2022-01-05 22:24:27.673446,2022-01-05 17:20:32-05:00,1563,7LBZi7Ec4VKhtNJbFQYYY8CvFbsLPCvqmn8Rd5EVhn9n,CBgkKDhmsEa8Ug8nE9Yu95gLDbDQa9FNGpdjVRfEDXcq,False,463083319,463083319,21307693,1065384,20242309,72FwbpFGoLEazJEdpqNtPNefsadUrimUqma9wSoy4qiS,21307693,142334857,-121027164,460
2022-01-05 22:24:27.673446,2022-01-05 17:20:32-05:00,1564,5gN3624v6n1zQ1BKtZi1e9ZLpbCa4MEfhgHySFB81Qfm,UXT3oB5ud18rBsygsfxwA93kQYdSNbbzTCjt4gtU2jP,False,6703964,6703964,312638,15631,297007,HfEnetJ7uBSmZWCjBNxdvv9HEC5nsW4wDV7wu6WnhWan,312638,2183597,-1870959,466
2022-01-05 22:24:27.673446,2022-01-05 17:20:32-05:00,1565,2YcB3QQGWho5oogDd1nK3cpLQzwwwXGxybrhe2xDkDxq,5DjAUp6CxKStYTaXSnzjvYkfqCXfG8Y61bWw5UwbbE3q,False,16452223,16452223,758006,37900,720106,72FwbpFGoLEazJEdpqNtPNefsadUrimUqma9wSoy4qiS,758006,6741754,-5983748,460
2022-01-05 22:24:27.673446,2022-01-05 17:20:33-05:00,1566,2mfcg17QocKKvDcqDH88TwxHRiS8dAQiJAGoAh1brns9,8aQLELBgaA9eXsxSciMjxWv8B1hpbUPfLwqVjEnasZbe,True,386358501,96589625,578377,289188,289189,4BnQKPLuE3DMTtxp8MjUBytgnhvxqq3ZTqZHTVZo4JJh,23135104,86731153,-63596049,598
2022-01-05 22:24:27.673446,2022-01-05 17:20:33-05:00,1567,Gbxc51WERLLeCtiHv7rDvE52aqF541RoQWG5n5aqErq6,4ngBoHbfXijLMqGKxFMNht9sbmxy2g5eqBmn8QsBmbx1,True,5830319,1457579,7303,3651,3652,4BnQKPLuE3DMTtxp8MjUBytgnhvxqq3ZTqZHTVZo4JJh,292121,1941347,-1649226,501
2022-01-05 22:24:27.673446,2022-01-05 17:20:33-05:00,1568,8eTH6eJyyVeMno3UQkffeBg32xofKsQfkhLhXdtaf87s,BCFC7CPXrQPsUfJb2eYSht8GhaApWHpc49AeCXqaYq13,False,5821722,5821722,269450,13472,255978,72FwbpFGoLEazJEdpqNtPNefsadUrimUqma9wSoy4qiS,269450,1880330,-1610880,462
2022-01-05 22:24:27.673446,2022-01-05 17:20:35-05:00,1569,8xQ3tsWVUe75EG1HmocULJ3kh52utveoFMEPotTGrKno,i3SKW3ywrwYucX9ySEx1C4zaUKGnzLerP3V38437NyV,True,893323221,223330804,1389282,694641,694641,4BnQKPLuE3DMTtxp8MjUBytgnhvxqq3ZTqZHTVZo4JJh,55571289,234975997,-179404708,622
2022-01-05 22:24:27.673446,2022-01-05 17:20:36-05:00,1570,BZxJ6CtrVoiU86DMMieMeDFLNWtMpHGTvZfM7nyay6o4,6CRxRR8bisRLHFJBFWjyumYuy7j4C4PkjYH1K8gXhdWD,True,22167053,5541762,29492,14746,14746,4BnQKPLuE3DMTtxp8MjUBytgnhvxqq3ZTqZHTVZo4JJh,1179689,4512645,-3332956,532
2022-01-05 22:24:27.673446,2022-01-05 17:20:36-05:00,1571,DGbj8tnqECzM9FG8j225Ap7A4Fdm3J1Ksm32JBFG7igv,Cd3D2UVwoSZLygM2e3UQppQANsokpmx5CNBs1C5zueay,False,5307550,5307550,244020,12201,231819,72FwbpFGoLEazJEdpqNtPNefsadUrimUqma9wSoy4qiS,244020,1697702,-1453682,459
2022-01-05 22:24:27.673446,2022-01-05 17:20:36-05:00,1572,GKNBtZbwK4w9hyXD1r38NTGcTJhpjt8R9WFCzdXup9Tk,7RLaL2XoFuqrcCcPEB6FzPJzLnAhjQpwcRmDfdpRXFgB,False,104989361,104989361,4217151,210857,4006294,72FwbpFGoLEazJEdpqNtPNefsadUrimUqma9wSoy4qiS,4217151,41802571,-37585420,401
2022-01-05 22:24:27.673446,2022-01-05 17:20:51-05:00,1573,GWEfWJimTKDJuxSTAb7SxkT3L3FhPPu8wJzYYF8H4SgD,BdeMcj3cMyKVPeF7Mt9Jdpxgzq9P6c79qJR6ctiiDauL,True,287831934,71957983,427881,213940,213941,HfEnetJ7uBSmZWCjBNxdvv9HEC5nsW4wDV7wu6WnhWan,17115277,84101316,-66986039,594
2022-01-05 22:24:27.673446,2022-01-05 17:21:50-05:00,1574,pgzvXpnUYiY7hLrfjmwScqLd8oj9vYcXpFvpm4y4JvG,GdqdQgoyBAFuXdbvoZyDhB3jyqJzVo4nkGh7EPFxkBF2,True,30631928,7657982,47482,23741,23741,HfEnetJ7uBSmZWCjBNxdvv9HEC5nsW4wDV7wu6WnhWan,1899300,19215469,-17316169,620
2022-01-05 22:24:27.673446,2022-01-05 17:21:50-05:00,1575,67Z7ZGhNu5xxEh9BYKWcXp9m1T4tFiE1o1M16hCzUWQA,CT7YKWixz7BhTbvg5F6M5HCyPGnHoFLNFuDV9GhoLTo3,True,47209427,11802356,72916,36458,36458,HfEnetJ7uBSmZWCjBNxdvv9HEC5nsW4wDV7wu6WnhWan,2916641,17104196,-14187555,617
2022-01-05 22:37:31.651958,2022-01-05 17:25:16-05:00,1576,CRaKcudjkQiSw5YPVjTLVdXvJskeGiHSYtq5ZcMPJhgQ,AgqTg3b3bAcaBmRidhNC4Uf9ZwNbeH52RQEqumWyuUs7,True,12583913,3145978,19679,9839,9840,4BnQKPLuE3DMTtxp8MjUBytgnhvxqq3ZTqZHTVZo4JJh,787161,4887164,-4100003,625
2022-01-05 22:37:31.651958,2022-01-05 17:25:56-05:00,1577,4QWcUDQ8Yf9nuftGoUdfWzBg6RkmuKW6yMGpakkiEWtG,5zgmZGdfmtjFZhtz7m352ycreWVmQijHKbmTCZj2zEYk,False,580799322,580799322,4966539,248326,4718213,HfEnetJ7uBSmZWCjBNxdvv9HEC5nsW4wDV7wu6WnhWan,4966539,146142065,-141175526,85
2022-01-05 22:37:31.651958,2022-01-05 17:26:13-05:00,1578,Br1j5Ftafei7ysu5SmqVZSoRe4uS4qCPeKSPHg55pyiE,G8fc7QvXjfkgBFvAVUgJFQS3VaF1biL9rktBExGa87Ks,True,16197448032,4049362007,21520160,10760080,10760080,72FwbpFGoLEazJEdpqNtPNefsadUrimUqma9wSoy4qiS,860806408,4544588186,-3683781778,531
2022-01-05 22:37:31.651958,2022-01-05 17:26:13-05:00,1579,CGk6y4qfTtENsgu7mNNYBFJqzDi3swKRwbwVJSZ4N8ZL,J6wKVACEZa6n3QFoh16BHi42ZJLunYywJi9qhY72rrwF,False,2034751417,2034751417,100576402,5028820,95547582,72FwbpFGoLEazJEdpqNtPNefsadUrimUqma9wSoy4qiS,100576402,566389958,-465813556,494
2022-01-05 22:37:31.651958,2022-01-05 17:26:14-05:00,1580,HAk9c831TRUhvpoK4d7PTqfJuJhSjnJUXWpnYsH85bDJ,DVSa3CJrVLTHAeFYjEF89ZjWRm86QwruUk2Y8RvGpjsr,True,256811,64201,368,184,184,72FwbpFGoLEazJEdpqNtPNefsadUrimUqma9wSoy4qiS,14737,79004,-64267,573
2022-01-05 22:37:31.651958,2022-01-05 17:26:14-05:00,1581,5zSoXxVZYYQAtq3urfcUQmJkjFDBXkUJYSNFdq759Tof,3C459gJnmj4EYTG3tDFJEEf1aAT915sxRLs2THEdQqha,False,797295752,797295752,8711954,435597,8276357,4BnQKPLuE3DMTtxp8MjUBytgnhvxqq3ZTqZHTVZo4JJh,8711954,197780589,-189068635,109
2022-01-05 22:37:31.651958,2022-01-05 17:26:17-05:00,1582,GLB9MTe5PHfs3vK1XVXxSbH9xAnTdnU9kL5jUZcVsmd3,GYg2mE56e4b26YQwZzk39nxiuvpMdR6BkvAsPwFnvZvu,False,195717691,195717691,0,0,0,72FwbpFGoLEazJEdpqNtPNefsadUrimUqma9wSoy4qiS,0,48796069,-49252309,0
2022-01-05 22:37:31.651958,2022-01-05 17:26:17-05:00,1583,2q6ZezY218nwaTpZhrUVqP31ffW3oxcgLd6LnV83tSkc,8UrAQzMbqt5zZhdU2srZFEWEtwZyU3DNqbbYcLrs3eni,False,6731371603,6731371603,17569965,878498,16691467,72FwbpFGoLEazJEdpqNtPNefsadUrimUqma9wSoy4qiS,17569965,1665626331,-1648056366,26
2022-01-05 22:37:31.651958,2022-01-05 17:26:17-05:00,1584,36ByQojnxEckWdQTjqHfxKqCx9yjqWQsPsZyqaN72UWR,AZoirtS1fjX61agRM64tqThVinnJTh3BWgiHyNHPTgZP,True,12154810,3038702,19005,9502,9503,HfEnetJ7uBSmZWCjBNxdvv9HEC5nsW4wDV7wu6WnhWan,760228,4077843,-3317615,625
2022-01-05 22:37:31.651958,2022-01-05 17:26:22-05:00,1585,BtnTjb4mghmBK9KnLp2JzyGqfKB8tHskrGL4MzjAdF6V,BLStL7zka6qakHMhY4V6jKJT5agS1LtWMdWBZ1eP1Vi7,False,355670,355670,17076,853,16223,72FwbpFGoLEazJEdpqNtPNefsadUrimUqma9wSoy4qiS,17076,106174,-89098,480
2022-01-05 22:37:31.651958,2022-01-05 17:26:22-05:00,1586,8sneA6wAg6geVDJ1g7YWg4R1PfjuRVzeHp1nUBJinhZa,14i1uWtmcTjrdbg3DSr9vzd5NBnxqsn1A4QdgFBZqeYM,True,1289151,322287,1940,970,970,72FwbpFGoLEazJEdpqNtPNefsadUrimUqma9wSoy4qiS,77622,347375,-269753,602
2022-01-05 22:37:31.651958,2022-01-05 17:26:23-05:00,1587,HyzMNjVJqyfyMKnuwvRTQvT4NeTBX9HjXgfCbDcDXGF,BrCNFRRi9Cx2hJEKp47CtN9TUa7VzLWkyLrs5TSX7w1i,False,24962435,24962435,722259,36112,686147,72FwbpFGoLEazJEdpqNtPNefsadUrimUqma9wSoy4qiS,722259,8689824,-7967565,289
2022-01-05 22:37:31.651958,2022-01-05 17:26:23-05:00,1588,4ytoBUwuhAL4YYSCa6AgwrpeVF4eeU8H9NfDxMPZKxPo,Pby2szzsxDrXt4gnbmmaMccXxctZALr8miRtKhGKjsD,True,23442624,5860656,33412,16706,16706,72FwbpFGoLEazJEdpqNtPNefsadUrimUqma9wSoy4qiS,1336515,8824091,-7487576,570
2022-01-05 22:37:31.651958,2022-01-05 17:26:25-05:00,1589,46TNhGwBVzedW8xSb9UY94HNeSom9iGiZzAjrKHiRM2G,7JVTiqNYeKHbyzRkKtvSEpqLPKykZso8cGUr3sX1j7QF,True,345831009,86457751,480558,240279,240279,HfEnetJ7uBSmZWCjBNxdvv9HEC5nsW4wDV7wu6WnhWan,19222321,84391312,-65168991,555
2022-01-05 22:37:31.651958,2022-01-05 17:26:25-05:00,1590,2uZeVkLSEXWbfJNf4VaMTnrWC77sGjMR665ssfYiuDUt,RXk9ohbGCP5kx6WxCZHbSGAdbqg46DsmoPJw83x6NUD,False,323887826,323887826,12903126,645156,12257970,72FwbpFGoLEazJEdpqNtPNefsadUrimUqma9wSoy4qiS,12903126,101015300,-88112174,398
2022-01-05 22:37:31.651958,2022-01-05 17:26:33-05:00,1591,ASrkgcVQ9iMDvTbji6xdpzXU4G4hRNhZ4BzseVxGjDnp,3N8MqUxgfh6T7MQu3JQqYUHDiUYSy5AnXY1SmSMmpdBo,False,4699305241,4699305241,80849347,4042467,76806880,72FwbpFGoLEazJEdpqNtPNefsadUrimUqma9wSoy4qiS,80849347,1313800078,-1232950731,172
2022-01-05 22:37:31.651958,2022-01-05 17:26:36-05:00,1592,56488NdcUy6Hi6X5SLs2GFtW5pG4u5wJpH7vHdxTCx4z,tGgXjJeVr3W2m3T2NXPCqpBEd6HJKE2cRsgCyiDZQy4,True,125810459,31452614,191207,95603,95604,HfEnetJ7uBSmZWCjBNxdvv9HEC5nsW4wDV7wu6WnhWan,7648307,50589200,-42940893,607
2022-01-05 22:37:31.651958,2022-01-05 17:26:46-05:00,1593,2PHDkmat5jQ65XkJYhDSw6ZwHcKpSw85o8MaPFhfLBry,8NtkXoUPt4wkcqQJuPJYt5oq9hG4BdeY26dQrsybDWWX,False,129199967,129199967,6253725,312686,5941039,HfEnetJ7uBSmZWCjBNxdvv9HEC5nsW4wDV7wu6WnhWan,6253725,33995178,-27741453,484
2022-01-05 22:37:31.651958,2022-01-05 17:30:00-05:00,1594,9vcKW1GfrDZ3KLPh2pEVFF8ZyKqD1pJW1hiE8H98Av7S,C6Ki27mo4sCHu6u8UnR1p7WSgsTjFQxGGR9Lk9n5Rhjq,True,40359754,10089938,63066,31533,31533,HfEnetJ7uBSmZWCjBNxdvv9HEC5nsW4wDV7wu6WnhWan,2522675,11410198,-8887523,625
2022-01-05 22:37:31.651958,2022-01-05 17:30:18-05:00,1595,Ckqos6cdncPKj13DnCmDVZsZTqp6eS7277CRrT9WhcEr,AtUV8m7VQJvZq7GLCAHMf3jV7iamKEPnWVZHWuuVZQp1,True,18036606,4509151,28139,14069,14070,72FwbpFGoLEazJEdpqNtPNefsadUrimUqma9wSoy4qiS,1125594,7004576,-5878982,624
2022-01-05 22:37:31.651958,2022-01-05 17:30:24-05:00,1596,6cnA7PeqQgpZdA7jBg4yMzTusm8JJHRWBMup84ywJfYo,FLqcukY7RehqY6ACrwVJnGH3eRgRDe93K1jLYCQN2F3U,True,858896526,214724131,1327160,663580,663580,HfEnetJ7uBSmZWCjBNxdvv9HEC5nsW4wDV7wu6WnhWan,53086420,321872530,-268786110,618
2022-01-05 22:37:31.651958,2022-01-05 17:30:31-05:00,1597,DmEVzPyCKnm89v481V2ic57vyikwwMja75uVZ2rjvjfp,38fPZzP4NwTtx7Qu6DLSqx9Sv8e5CQbSrr2BMvVmSy4J,True,252793908,63198477,393818,196909,196909,HfEnetJ7uBSmZWCjBNxdvv9HEC5nsW4wDV7wu6WnhWan,15752749,96597632,-80844883,623
2022-01-05 22:37:31.651958,2022-01-05 17:30:41-05:00,1598,BQBQicboM5o25LihnffqxcJmoPoA3mgBKNeG4H8UTHVh,E8rJFAs7dbDmQA1o5aTeNqdmADxWMd5cDzvwAGMFFCix,True,21959718,5489929,34336,17168,17168,HfEnetJ7uBSmZWCjBNxdvv9HEC5nsW4wDV7wu6WnhWan,1373448,12192813,-10819365,625
2022-01-05 22:37:31.651958,2022-01-05 17:30:45-05:00,1599,HVZkXeDR3mc8oB9qFFwCK4RXpPojdcHk9tRGep6xtKGK,Bh3py7awPejWqeTMxtAgF7mPotL2Asxf8YrYJykq9nBt,True,95775207,23943801,149541,74770,74771,HfEnetJ7uBSmZWCjBNxdvv9HEC5nsW4wDV7wu6WnhWan,5981658,22714612,-16732954,624
2022-01-05 22:37:31.651958,2022-01-05 17:31:11-05:00,1600,DvuRmJkfn6FQczUKgYeaSCqwy2NTMunuAKNrnmxMvnzS,7LpWTX9dgBtW75kfEoB5WuNsDwEdw5s8CYSHh3J4qagM,True,958046764,239511691,1487804,743902,743902,72FwbpFGoLEazJEdpqNtPNefsadUrimUqma9wSoy4qiS,59512188,293986673,-234474485,621
2022-01-05 22:37:31.651958,2022-01-05 17:31:32-05:00,1601,9KD2AifD5wFD4QkHYuawXbJgLWHrfj2QPF3fT8jhGVA5,Ga9gAqmkuHbqrr31sUFPqa1xa5WNxLWJWGPUaMxQqLdj,True,19741395,4935348,28191,14095,14096,4BnQKPLuE3DMTtxp8MjUBytgnhvxqq3ZTqZHTVZo4JJh,1127665,6976058,-5848393,571
2022-01-05 22:37:31.651958,2022-01-05 17:31:44-05:00,1602,JDeYjCLpfnzcfxDFgHf4aBcHsajwdR14GUaKAA9euzVf,EJbvKoyMZcoCx4vWa61uMbW2vr6mUhrgEuECdteVBuZZ,True,117796587,29449146,184073,92036,92037,72FwbpFGoLEazJEdpqNtPNefsadUrimUqma9wSoy4qiS,7362927,43007999,-35645072,625
2022-01-05 22:37:31.651958,2022-01-05 17:31:52-05:00,1603,8xvLGVeDmhVYQhN2ZpWkVG9jCrukRsNQ4926a4TMiZqa,9ciBySSjvADwp47WkETiFWZKVTFL8Hf1XvK7aSxhcgQS,True,376594857,94148714,552752,276376,276376,HfEnetJ7uBSmZWCjBNxdvv9HEC5nsW4wDV7wu6WnhWan,22110080,81935395,-59825315,587
2022-01-05 22:37:31.651958,2022-01-05 17:31:54-05:00,1604,5Rxuqgs4CaSKbfDXqBMFXkLTQ9dxrUjThXzoy3ouYVtK,BgvbKru66ebrGUcFFymGTmsaQv6GgcGMybiWaXqzBtwX,True,3139632,784908,4525,2262,2263,HfEnetJ7uBSmZWCjBNxdvv9HEC5nsW4wDV7wu6WnhWan,181026,1172201,-991175,576
2022-01-05 22:37:31.651958,2022-01-05 17:32:04-05:00,1605,3qnPsgqW11AcDEmyjmJquPcPLyE3EdJQuVLJ5kinDrd3,86rZadBB7emKio76aFTahpbrFtxd9tqZ4Mxgzaavq2xU,True,2292706,573176,3553,1776,1777,HfEnetJ7uBSmZWCjBNxdvv9HEC5nsW4wDV7wu6WnhWan,142121,549416,-407295,619
2022-01-05 22:37:31.651958,2022-01-05 17:32:06-05:00,1606,HGJoZvLakWfSDFwuvShNBc4kCf7nP7VqzyM3mELpbFEf,12Qn5jin7QvsBngXqYAv4UstyG3b6nRf1jsLp9Dp8G7k,True,235369984,58842496,367735,183867,183868,HfEnetJ7uBSmZWCjBNxdvv9HEC5nsW4wDV7wu6WnhWan,14709429,60562755,-45853326,624
2022-01-05 22:37:31.651958,2022-01-05 17:32:07-05:00,1607,7PzGZgzieFyyFs1dbajkNQgVxooFUNZrj1bUsQvrSwbp,A2gDREmSmJTBPPw3sbKVY3smC9wbHMDdv87gr4Tr2ES7,True,41269640,10317410,64148,32074,32074,HfEnetJ7uBSmZWCjBNxdvv9HEC5nsW4wDV7wu6WnhWan,2565957,9901293,-7335336,621
2022-01-05 22:37:31.651958,2022-01-05 17:32:19-05:00,1608,3VdSA9CED9f5swRwHX2U15U7J6Muaq8VPnCNy9CaGDHe,2YYstfnfdYic5NWmEbcUEHpccNUVd1EhuCkExvMsoMk8,True,101587460,25396865,143370,71685,71685,HfEnetJ7uBSmZWCjBNxdvv9HEC5nsW4wDV7wu6WnhWan,5734823,35310654,-29575831,564
2022-01-05 22:37:31.651958,2022-01-05 17:33:10-05:00,1609,GqAS41YJssg9aaEp3hs3sG98APCsXhiQBQszXaSjZ2bN,2wodJ3AhrXdE1T4oVL95KvoBND7PubG5Wd5GWiLCMZJU,True,2755883405,688970851,4306852,2153426,2153426,HfEnetJ7uBSmZWCjBNxdvv9HEC5nsW4wDV7wu6WnhWan,172274114,1562333152,-1390059038,625
2022-01-05 22:37:31.651958,2022-01-05 17:33:26-05:00,1610,BrHRMouGRz3LBNzd9anfdYMhWfg8yUPHL4PqJ8WdEDFS,4uzoLa3mC2VYHAPBoHLX4gTjPTC28rPf2fvEGtJWPYc,True,882092747,220523186,1358957,679478,679479,HfEnetJ7uBSmZWCjBNxdvv9HEC5nsW4wDV7wu6WnhWan,54358306,496666170,-442307864,616
2022-01-05 22:37:31.651958,2022-01-05 17:33:29-05:00,1611,B4Uc39nKzz9wBRQsCkMR4A7RwTJ8rSuwpR6EQn2AesRb,H49bGZgatRZVpj6QufZRVgYrQtH7LpdbiqKBs23151m,True,375161525,93790381,577170,288585,288585,72FwbpFGoLEazJEdpqNtPNefsadUrimUqma9wSoy4qiS,23086803,238574745,-215487942,615
2022-01-05 22:37:31.651958,2022-01-05 17:33:33-05:00,1612,BYvjENe16Ta77PqGV7JKEWrsqCTfkMGYwTSG5gXneDvd,EvxAXgvhPC6QkNurbK7vWyTApGo8J2R4EgMAknkHVU3d,True,44819277,11204819,69696,34848,34848,HfEnetJ7uBSmZWCjBNxdvv9HEC5nsW4wDV7wu6WnhWan,2787870,17962533,-15174663,622
2022-01-05 22:37:31.651958,2022-01-05 17:33:42-05:00,1613,BPsM1um9ZJf7eNoVMsQCRSwgARMuLCGGSDxf9tZeNeEy,BpzDdXfxVygiSYSmsHV6uPxQMeTFtrURMCCqhswQjd5X,True,17478507,4369626,27121,13560,13561,4BnQKPLuE3DMTtxp8MjUBytgnhvxqq3ZTqZHTVZo4JJh,1084864,3604337,-2519473,620
2022-01-05 22:37:31.651958,2022-01-05 17:33:53-05:00,1614,3WcJUt8jQ1ngL3ZCGo6dFrc3GmTMTYtzeDva7mri2Tqx,HeG1Pz2oMjqtkfsRMsbqP3VpatnVEQzcWmKDVoFp4Htr,True,235362683,58840670,367180,183590,183590,72FwbpFGoLEazJEdpqNtPNefsadUrimUqma9wSoy4qiS,14687238,60547865,-45860627,624
2022-01-05 22:37:31.651958,2022-01-05 17:33:54-05:00,1615,DR7XL3qweFyTKDatQYS2LacqGLv2368cnGuWpEpk4hSL,Fd3BYCiiQfThDJsxBUNwYTMP8eNCrnXMVzE1wpejJqXa,True,69168,17292,108,54,54,72FwbpFGoLEazJEdpqNtPNefsadUrimUqma9wSoy4qiS,4324,21880,-17556,625
2022-01-05 22:37:31.651958,2022-01-05 17:33:59-05:00,1616,6NJFN855M3Q3RLTDNo57gTgAmwPD6G2E3WvMb1m5eNCN,3YpqNnonsvXaRT4nCC3G5FZx1jjVtbDPc36LiR6WK5jR,True,1147145045,286786261,1785795,892897,892898,4BnQKPLuE3DMTtxp8MjUBytgnhvxqq3ZTqZHTVZo4JJh,71431809,409671591,-338239782,622
2022-01-05 22:37:31.651958,2022-01-05 17:34:47-05:00,1617,7vKmhLV45Q5etXhJL5ng8rxWhYSiUCDmAbGnwBPr7zcx,cP6xPeuHLnjr858QK1F9qYn7rJpEbPy7wEJHoju6oV7,True,505779496,126444874,786021,393010,393011,GmqQKnMfFxkv6ChqGaZ2wmSFDow7R1x7WeRfU58GVvfw,31440851,122732205,-91291354,621
2022-01-05 22:37:31.651958,2022-01-05 17:34:52-05:00,1618,2PzBAkdXkrwH9VuoMALumQz86qkW7sSBQtCrHw14JUp3,D5vwWAMHVooobG2sCWv9EwtJrAFZG6cwKH4dfmA98tbt,True,30394627,7598656,47374,23687,23687,HfEnetJ7uBSmZWCjBNxdvv9HEC5nsW4wDV7wu6WnhWan,1894975,7496712,-5601737,623
2022-01-05 22:37:31.651958,2022-01-05 17:34:58-05:00,1619,i7TcF4weYcqgrRdH3GpndbEYxCxfcSfr9JWYrAUg1CF,BkDfknUir7PnSEW8auoB87PytycEFwyX5kT2GY4SGJJL,True,61787052,15446763,96530,48265,48265,72FwbpFGoLEazJEdpqNtPNefsadUrimUqma9wSoy4qiS,3861233,35815059,-31953826,624
2022-01-05 22:37:31.651958,2022-01-05 17:35:13-05:00,1620,8swGZMrPrLAxZd7MxTbkCL13k3DmAJUw41jCp6Xo6awW,3fKnX7yTNXAT4uMmXVdTy47ALJT8h8YSD3WiBb4BGuzH,True,3481013294,870253323,5081928,2540964,2540964,4BnQKPLuE3DMTtxp8MjUBytgnhvxqq3ZTqZHTVZo4JJh,203277138,848992678,-645715540,583
2022-01-05 22:37:31.651958,2022-01-05 17:35:16-05:00,1621,HdfQweV1KuYSpWdycZbpGrUc8yMcY3ZczLn1agKXMJaf,G1Ae1PZHkANkwFnhUKS1tvdFEv8dAFeojBkezh6rUNMh,True,80575385,20143845,124174,62087,62087,72FwbpFGoLEazJEdpqNtPNefsadUrimUqma9wSoy4qiS,4966994,22927185,-17960191,616
2022-01-05 22:37:31.651958,2022-01-05 17:35:24-05:00,1622,EanSXRkJu91FKUhPCzYxWkmM3PQUWcovEnoZXcd6vQ9E,Fg4EzAzHStoLRDPmoBUczdWnWrhAb7jKEujqAujLFT8,True,2172745384,543186346,3380006,1690003,1690003,4BnQKPLuE3DMTtxp8MjUBytgnhvxqq3ZTqZHTVZo4JJh,135200244,555607057,-420406813,622
2022-01-05 22:37:31.651958,2022-01-05 17:35:24-05:00,1623,9WJBnVi84E926j7xEd566WzrZJkPJWRgmEnYj9vyjuad,4dLaFS5F7TGyLdwuJLMGkz3bSL53aHzd9ZfpNmhHxXeF,True,231032690,57758172,353903,176951,176952,72FwbpFGoLEazJEdpqNtPNefsadUrimUqma9wSoy4qiS,14156133,70698428,-56542295,612
2022-01-05 22:37:31.651958,2022-01-05 17:35:32-05:00,1624,DMgPzJnMQfvpk6LWscs9V9CwnYDj4CEUgKB9S65WsTaY,BZRSLH1Vw1BQwXTZtBcgUYqmFF7TuzYxAaZ8TXUKwLUQ,True,68649,17161,106,53,53,72FwbpFGoLEazJEdpqNtPNefsadUrimUqma9wSoy4qiS,4249,25243,-20994,618
2022-01-05 22:37:31.651958,2022-01-05 17:35:33-05:00,1625,399591e8XgY52yCMorCQ2WL6dQZTC485ZooHtmGuirhZ,JCiXAooFmKmEPQ2S7C8iSk6CLcTyrPEe1SsPSLyUGySe,True,16118228,4029557,25150,12575,12575,72FwbpFGoLEazJEdpqNtPNefsadUrimUqma9wSoy4qiS,1006022,5885673,-4879651,624
2022-01-05 22:37:31.651958,2022-01-05 17:35:33-05:00,1626,DrzTARa7RK8RXoxHZPKCBqYtMC8TAUHRw8SznXRKTa5M,FYANet92VhyXkKZqqBJR4sFxuCftWb68sgQU9VHCdTJk,True,385793,96448,601,300,301,72FwbpFGoLEazJEdpqNtPNefsadUrimUqma9wSoy4qiS,24078,88338,-64260,624
2022-01-05 22:37:31.651958,2022-01-05 17:35:53-05:00,1627,A7SMcwnq3DewryUj1jScnAboKGnuDVcW15F3ubNcG66Y,5qLCE37FdeWLCQnkfNJViFMGNcDeiELgE3VgPbBUuDGF,True,268524973,67131243,415907,207953,207954,4BnQKPLuE3DMTtxp8MjUBytgnhvxqq3ZTqZHTVZo4JJh,16636295,83823833,-67187538,619
2022-01-05 22:37:31.651958,2022-01-05 17:36:03-05:00,1628,5Z3ZFCA65WoWhm3okRuuziEMi7ajGAEHWUFchzBNba5S,FcomdrWidygkxMKzcsY5xELbmwC652uMci648LMTv7AB,True,145130,36282,223,111,112,72FwbpFGoLEazJEdpqNtPNefsadUrimUqma9wSoy4qiS,8928,34097,-25169,615
2022-01-05 22:37:31.651958,2022-01-05 17:36:06-05:00,1629,89CkXnSZnr52Zsoh48efv9MQacrkB6GMtrbEpNJSyA2H,HcvRBS4Z22CpYgDNgm4TVF4AVXFDuYzBUAFcdHAwdpg4,True,35006888,8751722,54748,27374,27374,72FwbpFGoLEazJEdpqNtPNefsadUrimUqma9wSoy4qiS,2189950,8384221,-6194271,625
2022-01-05 22:37:31.651958,2022-01-05 17:36:07-05:00,1630,E1wp3bmkcY3eiEYyGYwhTCsr7BZ7RfPa5DJTZFupcFwj,452hVdYkD5SDDrA6hv6DLPFvyS8PvR2P6DPNScGxWTsW,True,9410855,2352713,14579,7289,7290,HfEnetJ7uBSmZWCjBNxdvv9HEC5nsW4wDV7wu6WnhWan,583178,2421192,-1838014,619
2022-01-05 22:37:31.651958,2022-01-05 17:36:08-05:00,1631,AKxRtcdpi7gWhAuL8ENj7zhgeQezzEXe9TSANE6bQoRA,2YH4vrU9deP8Cu6E8Hzf8GqKG1yVjv5pdz4FE7r5YKir,True,79928637,19982159,124817,62408,62409,72FwbpFGoLEazJEdpqNtPNefsadUrimUqma9wSoy4qiS,4992684,19105540,-14112856,624
2022-01-05 22:37:31.651958,2022-01-05 17:37:21-05:00,1632,GaEpNGa8jnwSRvjzzEMYkZe1pKcr2eiZtePrqFxpABjB,5CFZHuyWbJv14zPdX5dSQDREgHrCb4vsFvB6hLiEe3Ji,True,1778391,444597,2773,1386,1387,HfEnetJ7uBSmZWCjBNxdvv9HEC5nsW4wDV7wu6WnhWan,110926,432536,-321610,623
2022-01-05 22:37:31.651958,2022-01-05 17:37:32-05:00,1633,HqtTbC1LFreGvgfpZe7nCqkNnh8GHPQKosfmc19zb1yi,E39UNiHNkwQEd5GXkCtTPqSorQSB1kLx8kjzK4jdFoi3,True,3629514519,907378629,5664012,2832006,2832006,HfEnetJ7uBSmZWCjBNxdvv9HEC5nsW4wDV7wu6WnhWan,226560484,1066453388,-839892904,624
2022-01-05 22:45:42.156844,2022-01-05 17:37:51-05:00,1634,D3mXrJzhHf8qRaoCKLschUxAFoijFCFuT6bmNZH4W7Cj,9E3Xtqw7TncXWnbhAbFJMtuNmP6WS3ooGuptzyzw7UpA,True,675201,168800,1050,525,525,HfEnetJ7uBSmZWCjBNxdvv9HEC5nsW4wDV7wu6WnhWan,42020,247733,-205713,622
2022-01-05 22:45:42.156844,2022-01-05 17:37:58-05:00,1635,Ar5QB4VBcUyzSCG23z2QNAbrWY55NbHCr1MNN6P2GAmh,BusFGTiDrJmxzwGUxWz9b3SFF3eseqtgh2DRHqyAwyVe,True,5397883,1349470,8435,4217,4218,HfEnetJ7uBSmZWCjBNxdvv9HEC5nsW4wDV7wu6WnhWan,337405,1402533,-1065128,625
2022-01-05 22:45:42.156844,2022-01-05 17:38:39-05:00,1636,2NdwSLxsGok8PczpCZj9CVX2BymNU5MvHt7hWfGetg2M,8AQbDXeA6mD9QoZBFJcYbnHvZwKNxzA9CCHLAgdSfTA3,True,124370,31092,193,96,97,72FwbpFGoLEazJEdpqNtPNefsadUrimUqma9wSoy4qiS,7745,41542,-33797,622
2022-01-05 22:45:42.156844,2022-01-05 17:38:58-05:00,1637,4MmpDGUTyMcYEqJ1RoZ46AN2BhrBUseHaHqF8AmiTPyD,7HW2YZpYM349HMfW7u4h9ESZ1AXkwN8JcVDTNFzp9aTz,True,1401253111,350313277,2189639,1094819,1094820,72FwbpFGoLEazJEdpqNtPNefsadUrimUqma9wSoy4qiS,87585570,466963499,-379377929,625
2022-01-05 22:45:42.156844,2022-01-05 17:39:00-05:00,1638,9YEzjb49Awvedv9yNc6LG54SkGBug2RYiJwiUV13mGsS,3H8w5WCD187NWWoZMNUCzUDdxTgqrRJLga8gDzUVXBgZ,True,12801233,3200308,20010,10005,10005,HfEnetJ7uBSmZWCjBNxdvv9HEC5nsW4wDV7wu6WnhWan,800416,5153052,-4352636,625
2022-01-05 22:45:42.156844,2022-01-05 17:39:31-05:00,1639,EQUZQWk4WLT6LFeWZs3P9AQufFcoZouFETfhyxvuS2JM,Byc2mLXArmkjQPWaxCJksHZD2XpZyCQ2FRtDJyztU81V,True,1109312401,277328100,1734048,867024,867024,HfEnetJ7uBSmZWCjBNxdvv9HEC5nsW4wDV7wu6WnhWan,69361933,408314028,-338952095,625
2022-01-05 22:45:42.156844,2022-01-05 17:39:53-05:00,1640,4mB2DVbQVqVk535v98Cj8SPNg1tTc3DFyY2Q7VBbY645,HXo255k3RgsTGsc4hiP6ZTXUspBTqJ37duQa5eK7tqp3,True,3168546128,792136531,4827962,2413981,2413981,72FwbpFGoLEazJEdpqNtPNefsadUrimUqma9wSoy4qiS,193118480,760291764,-567173284,609
2022-01-05 22:45:42.156844,2022-01-05 17:40:13-05:00,1641,AtKuDfcFXqWUMnRqQpjedUMTb5CQKLc2zoqEAcQpysKQ,9bPFLYp5TDZruLLDXDYYCiPYcD982iF8xt5rfTkqwNsL,True,129875,32468,202,101,101,72FwbpFGoLEazJEdpqNtPNefsadUrimUqma9wSoy4qiS,8118,29744,-21626,625
2022-01-06 02:32:10.977083,2022-01-05 21:29:33-05:00,1642,9jdfc9GFTecsdRuTjWFGX13niKKmeBxRgtv5j86uhSnU,HLWMShobjSkaLyXrNjgwVaUGVtbtdUSnr1XjqpXn1bLR,True,3419675,854918,5346,2673,2673,72FwbpFGoLEazJEdpqNtPNefsadUrimUqma9wSoy4qiS,213861,959898,-746037,625
2022-01-06 02:32:10.977083,2022-01-05 21:29:43-05:00,1643,GJ3PbEfPK8jjrPgMmZtvN5fMSSy2dtiiAtZ8wcfgxVuc,FCUDVFb2TjDvehHE8fVBofqSykpb9W6Afc9QeHtj7te7,True,895916223,223979055,1400845,700422,700423,3zqXX6kzhkbW3d4TwD2CNjMRwxTbREXySekvq37kfCNk,56033817,325712130,-269678313,625
2022-01-06 02:32:10.977083,2022-01-05 21:29:49-05:00,1644,JCBhqqPQxP1Xc41sSY6e1sQKRstHhe7D1v6rLz4hp3Qp,DWMUq2bMD1jqpxHtyXDFjcAwjA27yyMRe68hGcsK143m,True,81319,20329,127,63,64,DddJ7EWCmYEEZETCBNgAUSg81Ls6fZtiAaY5ekJ5sXx1,5086,19243,-14157,625
2022-01-06 03:17:03.004413,2022-01-05 21:59:34-05:00,1645,243SAnGxchCVB1LQAUF4SsozR86yDwEdg2QQpbWGsMYe,5u8sNkb2oEQjUXJAB3yGStmv3Uwz16gBgExBo5myVK4b,True,85886044,21471511,134255,67127,67128,DddJ7EWCmYEEZETCBNgAUSg81Ls6fZtiAaY5ekJ5sXx1,5370232,19511634,-14141402,625
2022-01-06 03:17:03.004413,2022-01-05 22:00:36-05:00,1646,EV21gv8jEvXtmGDoGRNm5LJEvTBccLMZyVDCLsp54jP3,DGxxoU52aQNoUQcxdvQtv2H5q2PhK6TGkLgNSaFgnZrb,True,52054262,13013565,81432,40716,40716,3zqXX6kzhkbW3d4TwD2CNjMRwxTbREXySekvq37kfCNk,3257309,13436575,-10179266,625
2022-01-06 03:17:03.004413,2022-01-05 22:02:08-05:00,1647,Mcbzp1LhZwpfmXTv1pqe9D1jCKHw443j9QKp6tUpzgM,8uforSMAKEih5jHfHp3gCqCvaugtCmhzVfVHA63Akz7F,True,23277773,5819443,36421,18210,18211,3zqXX6kzhkbW3d4TwD2CNjMRwxTbREXySekvq37kfCNk,1456842,7839238,-6382396,625
2022-01-06 03:17:03.004413,2022-01-05 22:02:39-05:00,1648,8VT2nxz5ZYDJFd9uL2XZwEXxChd9pjuMJNMAcutZubL1,EhAkiRbouzUAWtqQFsN8HEEfi46UVN8H8tyBP7CbgeLe,True,107015,26753,167,83,84,3zqXX6kzhkbW3d4TwD2CNjMRwxTbREXySekvq37kfCNk,6697,31109,-24412,625
2022-01-06 03:17:03.004413,2022-01-05 22:07:26-05:00,1649,7LRBswSEDBjJzQ4YurfTxLydh7tFS2jVn5V95Z6wL7ci,fD41VYGmk66MW46KKb23vAqQvUSDScgXnVdsHhJBZzu,True,1373955,343488,2143,1071,1072,4BnQKPLuE3DMTtxp8MjUBytgnhvxqq3ZTqZHTVZo4JJh,85740,420384,-334644,624
2022-01-06 03:17:03.004413,2022-01-05 22:08:02-05:00,1650,CFFpbRxYEP18rqEGxxyG3bzSV13Lv7nfSmZvtUK17kCP,824UwqH2JcFsqYBk9MZ8tTnpka9udTL6WGX35YFtAJQk,True,41327207,10331801,64621,32310,32311,DddJ7EWCmYEEZETCBNgAUSg81Ls6fZtiAaY5ekJ5sXx1,2584849,9823221,-7238372,625
2022-01-06 03:17:03.004413,2022-01-05 22:08:02-05:00,1651,5hUZ9uQFcYnjAQVVaGLJWdKyg7y1XMpoo8osQ9DeY7Xd,BdYiKWsjuzJLcHh3814mJ4xQ9JxoQKKcr7AHZ7Vxoavq,True,472698,118174,738,369,369,3zqXX6kzhkbW3d4TwD2CNjMRwxTbREXySekvq37kfCNk,29543,119260,-89717,624
2022-01-06 03:17:03.004413,2022-01-05 22:09:22-05:00,1652,Buioe5v3DyFwD9nquW5XdYeVYbSABCyg79eUHEvtvfaW,7T9gi7prCcZJkYJMSB5Ef6Bu4pAuBw4XLvumSFnqKDSi,True,7598180,1899545,11888,5944,5944,4BnQKPLuE3DMTtxp8MjUBytgnhvxqq3ZTqZHTVZo4JJh,475529,2741765,-2266236,625
2022-01-06 03:17:03.004413,2022-01-05 22:10:07-05:00,1653,CEbGTNX6WpaoKp4RBGSn9LzYM6yAYyeiMrgVYgJxA4zb,AiXUcGAFFm4tc7vKBscSNjZawV5YJqbv7D1KpxD3Zufg,True,212834867,53208716,333063,166531,166532,DddJ7EWCmYEEZETCBNgAUSg81Ls6fZtiAaY5ekJ5sXx1,13322551,76595068,-63272517,625
2022-01-06 03:17:03.004413,2022-01-05 22:10:13-05:00,1654,3zH1b58jqbNU37y9kDTZZrotSeT8XzS1tuyAHPKWrbah,4trxDWV16x6sVcz7bxHehYHkjjyKebh3S9fyJf8txzK5,True,81250,20312,127,63,64,4BnQKPLuE3DMTtxp8MjUBytgnhvxqq3ZTqZHTVZo4JJh,5083,18811,-13728,625
2022-01-06 03:17:03.004413,2022-01-05 22:10:14-05:00,1655,FjDp4bWCtqehFD7FunCrjrcdxMezTJj5aqh2VnBvHDQU,HRYeZqcqhP1RPiAGXziR1qCWwk4sF6c5ZYbvSDhX7foN,True,86095910,21523977,134679,67339,67340,DddJ7EWCmYEEZETCBNgAUSg81Ls6fZtiAaY5ekJ5sXx1,5387177,19281267,-13894090,625
2022-01-06 03:17:03.004413,2022-01-05 22:10:23-05:00,1656,EgU9hX6VK7YXeCgCHVaJAMekCcyZa2MVWdKra5pN7Gwv,7y8Ad9XY34bqREvheXHT2tr8Jy11D6X3pu7yLVtjU4QV,True,106267161,26566790,165537,82768,82769,3zqXX6kzhkbW3d4TwD2CNjMRwxTbREXySekvq37kfCNk,6621488,32950599,-26329111,623
2022-01-06 03:17:03.004413,2022-01-05 22:10:28-05:00,1657,3g1debT8Z2efQPuMNSDPUNZzDqarBG2acErsZ4HP7QGA,42wDHagxr5Nno3mUx6kyYGDjwR98aedRbh3ByB468agB,True,202892,50723,316,158,158,4BnQKPLuE3DMTtxp8MjUBytgnhvxqq3ZTqZHTVZo4JJh,12652,48778,-36126,623
2022-01-06 03:17:03.004413,2022-01-05 22:10:29-05:00,1658,EEcTbsFTUEifcdbPyjBLkS943daEx1RpR8F3uZxKRZbT,8V3JzDQ1VWYQLas8fxUsWJZZHe4gEmn74RehtUwLw3k5,True,57412278,14353069,89763,44881,44882,DddJ7EWCmYEEZETCBNgAUSg81Ls6fZtiAaY5ekJ5sXx1,3590559,17641358,-14050799,625
2022-01-06 03:17:03.004413,2022-01-05 22:10:46-05:00,1659,H6tDNj9cHac223ckAnNfnC4bAJuNLBnf2pFk2iQdMzMP,28UL9dqgayCqCAexScXjdpobYGVDN44SGBVNAfBByk8C,True,717562909,179390727,1122206,561103,561103,3zqXX6kzhkbW3d4TwD2CNjMRwxTbREXySekvq37kfCNk,44888248,264166114,-219277866,625
2022-01-06 03:17:03.004413,2022-01-05 22:10:51-05:00,1660,4FazDUgfQ3AKoFcnWHr8E9Ht8jLA3tkxf75yrGZVHdmF,HzRMH6mbgEKydRCnnMvSsKgTEVNQi6nuzoR1xutYFdzg,True,657305,164326,1027,513,514,3zqXX6kzhkbW3d4TwD2CNjMRwxTbREXySekvq37kfCNk,41089,332290,-291201,625
2022-01-06 03:17:03.004413,2022-01-05 22:11:17-05:00,1661,2ce2v2TCbjNH635NgbwTG3sqiRWYrRRaBpxPxBZJ929q,9cnoebT43FkWDFhidndGCVNiFD4NErv8DuL1Va4Jv9S8,True,64507704,16126926,100900,50450,50450,4BnQKPLuE3DMTtxp8MjUBytgnhvxqq3ZTqZHTVZo4JJh,4036036,35401213,-31365177,625
2022-01-06 03:17:03.004413,2022-01-05 22:11:49-05:00,1662,9gYrMXAGmGSV4VFjXzYP5WwH2aFpB1TxA6CqpYsosKLv,Dh8aH6RK48wu4fkT9xKw5XL7itxnPDuw3SDwPwvL5sva,True,283787,70946,443,221,222,4BnQKPLuE3DMTtxp8MjUBytgnhvxqq3ZTqZHTVZo4JJh,17747,68042,-50295,625
2022-01-06 03:35:22.933046,2022-01-05 22:21:11-05:00,1663,ECuu1L4QGdemZ7FjAjVAAxYN6piinweY7Fuk5csVovfT,Amd8WGcpdtB8yoA83R1BUT5uryuqoKbcBexYacbrbGVX,True,32704123,8176030,51150,25575,25575,4BnQKPLuE3DMTtxp8MjUBytgnhvxqq3ZTqZHTVZo4JJh,2046036,6699452,-4653416,625
2022-01-06 03:35:22.933046,2022-01-05 22:30:11-05:00,1664,BxXXWywnC3dSyLPJHt7owfBhgSiBWzkuD3T8hGYLqCH6,4vuwEBXXbXFMPmbJJJRop4FCWGyKR1sXhBc3EWF6MiB8,True,1018504539,254626134,1581317,790658,790659,DddJ7EWCmYEEZETCBNgAUSg81Ls6fZtiAaY5ekJ5sXx1,63252700,379019362,-315766662,621
2022-01-06 03:35:22.933046,2022-01-05 22:30:11-05:00,1665,7W6ih2ZGXaE6tvuQFUPCvc7NvEJHy7UffgoVX3ZPdLXt,6uQCkeMjEXHBQxE2HD33RM1zyTsSko1fYZA1mWUggJ5B,True,275075,68768,426,213,213,3zqXX6kzhkbW3d4TwD2CNjMRwxTbREXySekvq37kfCNk,17062,69744,-52682,620
2022-01-06 03:35:22.933046,2022-01-05 22:30:13-05:00,1666,HhwiZPKZBGa16oVi739s4qtMDMTwzWXc7iwNfX63t2UP,5AnbMbAFKy85yHt5y2M5S38nNkA1vT4ejY5NjGbRNUqn,True,14804825,3701206,23048,11524,11524,DddJ7EWCmYEEZETCBNgAUSg81Ls6fZtiAaY5ekJ5sXx1,921929,6137828,-5215899,622
2022-01-06 03:35:22.933046,2022-01-05 22:30:15-05:00,1667,AGhvB6x3gmvAJSnr9UVtvhKqVg3Qgh1k4roHzrNHhAaa,HhhjXT6WJnz1HQfHcwKdBppuAhc8ncUcq1mkJ4EHqgpe,True,67540,16885,105,52,53,DddJ7EWCmYEEZETCBNgAUSg81Ls6fZtiAaY5ekJ5sXx1,4215,17249,-13034,624
2022-01-06 03:35:22.933046,2022-01-05 22:32:21-05:00,1668,GH6Q9E1jZPTTp46aDd57UNZPNS2D6PBSwyLL3EHSjGn2,2XvwZXNsrPWx4EfPvhTP933bzCC3SJHDQ8xARfrXdVY9,True,211007840,52751960,329487,164743,164744,DddJ7EWCmYEEZETCBNgAUSg81Ls6fZtiAaY5ekJ5sXx1,13179488,131422420,-118242932,624
2022-01-06 03:35:22.933046,2022-01-05 22:33:07-05:00,1669,5jin5wXjQQ25nGM2ECrCXcg1a95vquh6kM7rMRru6Ke7,EKM657EQ8HWWgf4cssByoYHoXGjFfTspTKXAGmygAPQG,True,401793804,100448451,627640,313820,313820,4BnQKPLuE3DMTtxp8MjUBytgnhvxqq3ZTqZHTVZo4JJh,25105608,124779814,-99674206,624
2022-01-06 03:54:21.445365,2022-01-05 22:48:37-05:00,1670,6u6bPgAmK8ufACrQV99A1Y5nhGkue3KEUHmQQkcNkxwP,7636yXT5w4DcVpc7LJdN46aiggzSq6U2GXHXL5kyy9F3,True,1266844280,316711070,1981664,990832,990832,GAUsoe8ZTCiGPm2hYxRPGxcPe5ShNzHK9eE3G2zgRjxd,79266587,392125341,-312858754,625
2022-01-06 03:54:21.445365,2022-01-05 22:48:49-05:00,1671,3njiRuSRMXRzKmamyiR72Hc38PU8UDDmWdfPhgxmGxEW,5WoF3gkgygyNNbwxWgVfqGWkExcDixuzgJQQjXEZQ6J5,True,2723973823,680993455,4260826,2130413,2130413,GAUsoe8ZTCiGPm2hYxRPGxcPe5ShNzHK9eE3G2zgRjxd,170433049,1317215060,-1146782011,625
2022-01-06 03:54:21.445365,2022-01-05 22:49:00-05:00,1672,GGGyesjbt7h2XHHp9u8vpiWGugFwEbrtYaKrNQSDhQd7,8tydo1ZjGHmPBSqU33tywB3f9szdsHk1ckGFe4Ay5pgs,True,538945192,134736298,843447,421723,421724,GAUsoe8ZTCiGPm2hYxRPGxcPe5ShNzHK9eE3G2zgRjxd,33737885,291776423,-258038538,625
2022-01-06 03:54:21.445365,2022-01-05 22:49:00-05:00,1673,5PbrpM9kjzF4R2eW2UTcRVXnhqWdRQWHZJXKLN43N8WC,6ip4ocbyHusy8CsVvcrpiRCUp2nq9cY8bHpTcUU3Wztq,True,84550574,21137643,132214,66107,66107,3zqXX6kzhkbW3d4TwD2CNjMRwxTbREXySekvq37kfCNk,5288572,21977997,-16689425,625
2022-01-06 03:54:21.445365,2022-01-05 22:49:06-05:00,1674,6dr65yANjSMmfBeKAuSxG3i16S9vMgF1CQ3zDyzh55Pn,EhrE5QpnshD41S4zPEBy2A5q2Gs2mwUrbHGo6WnT9zDP,True,3570974,892743,5572,2786,2786,3zqXX6kzhkbW3d4TwD2CNjMRwxTbREXySekvq37kfCNk,222914,1151942,-929028,624
2022-01-06 03:54:21.445365,2022-01-05 22:49:24-05:00,1675,8MKNsuGVaoYpdQy6NNyxDvRzh2DAquBUtri4nDsixUxs,D7M1SDmpZAs8vdPCCCa96UbDF15YQDxHmoGWB57tHiir,True,44171455,11042863,69077,34538,34539,3zqXX6kzhkbW3d4TwD2CNjMRwxTbREXySekvq37kfCNk,2763087,14818965,-12055878,625
2022-01-06 03:54:21.445365,2022-01-05 22:49:27-05:00,1676,3Lv2XpiD4KBUHq7Zx6u3zNhpXoySodXHH8o8f5yaaPxG,H6TN4rhpBXkEH3mZnymYNcKfmnxRH2uzfwzeLH2q6ahP,True,1990543,497635,3062,1531,1531,DddJ7EWCmYEEZETCBNgAUSg81Ls6fZtiAaY5ekJ5sXx1,122500,520444,-397944,615
2022-01-06 03:54:21.445365,2022-01-05 22:49:27-05:00,1677,671STD1iqWBnLjDV3Up5qqccx6rFnGDq8ZVkgQQsVuFG,AyLK5BYK36wrwdAsUZQNcvFvf4JY2iToWP8j7rny6jgs,False,109976,109976,5392,269,5123,GAUsoe8ZTCiGPm2hYxRPGxcPe5ShNzHK9eE3G2zgRjxd,5392,27838,-22446,490
2022-01-06 03:54:21.445365,2022-01-05 22:49:27-05:00,1678,FpqCxvTkSiwDwD5qEt6hXJxzFDLFLAQ8VevK8zwRqYun,A3p6YQisCJKpNkF7vkjZRbEfbnUt7vTZdR2zPBUSdTkk,True,4373919606,1093479901,6733056,3366528,3366528,3zqXX6kzhkbW3d4TwD2CNjMRwxTbREXySekvq37kfCNk,269322276,895402670,-626080394,615
2022-01-06 03:54:21.445365,2022-01-05 22:49:29-05:00,1679,2FrqGFZjbiNykJyo9BZ5S9FguQJPJiTi681rJJsQ5dta,3QUncYP92NKrfpaTvuF9iQg11PXKgZAgEngwh6BbnCCj,True,8804315,2201078,13756,6878,6878,GAUsoe8ZTCiGPm2hYxRPGxcPe5ShNzHK9eE3G2zgRjxd,550256,2160359,-1610103,624
2022-01-06 03:54:21.445365,2022-01-05 22:49:29-05:00,1680,Fd2HrzBAr4JobRPARZwpQHHVoSCEoog32A6tKMWAC1sK,BYappsar5sQf8VLem4wrLuTtrDFH9y8pEx1aMxfuU4Pq,True,320990703,80247675,501315,250657,250658,4BnQKPLuE3DMTtxp8MjUBytgnhvxqq3ZTqZHTVZo4JJh,20052632,99726900,-79674268,624
2022-01-06 03:54:21.445365,2022-01-05 22:49:30-05:00,1681,DAku12iueL13vRoTpKLyqdGaLQ2rWF6REe8Dr8soFvNs,H2vVH3LxkhGe6x6Mdwy67BYwTKNQM6XayKx7mhrwyfJM,True,4753137,1188284,7362,3681,3681,GAUsoe8ZTCiGPm2hYxRPGxcPe5ShNzHK9eE3G2zgRjxd,294498,1541363,-1246865,619
2022-01-06 03:54:21.445365,2022-01-05 22:49:30-05:00,1682,8NdcaYUC1X5CP7FMDip78uqtqmCt8GcZdCzLRTYTihmb,9Ei1K9bXWXSXcBfeX5exPSXGCAu62WSKzvnnd4wHvyVh,True,1400459,350114,2188,1094,1094,4BnQKPLuE3DMTtxp8MjUBytgnhvxqq3ZTqZHTVZo4JJh,87537,374263,-286726,625
2022-01-06 03:54:21.445365,2022-01-05 22:49:30-05:00,1683,6eBSLXDMVoW2nG3n7s42RXDH8byY3C6n1RsUuegBLSrG,37dYrKnTXYer7Bu9xFfpArA4ZNo2B9bycFw9HywDtTRx,True,105704669,26426167,164307,82153,82154,GAUsoe8ZTCiGPm2hYxRPGxcPe5ShNzHK9eE3G2zgRjxd,6572307,31408485,-24836178,621
2022-01-06 03:54:21.445365,2022-01-05 22:50:11-05:00,1684,F2v1YwVAwXLiUgsJ5uwn4qAAkTXitn1E75fJcPnGuAcy,5rdJ4H5GxPg4Juu77mGc7uya5LwEqLzDSRyG8mQ2mDbK,True,205472519,51368129,319461,159730,159731,DddJ7EWCmYEEZETCBNgAUSg81Ls6fZtiAaY5ekJ5sXx1,12778447,63938356,-51159909,621
2022-01-06 03:54:21.445365,2022-01-05 22:50:13-05:00,1685,8RmB8o4zux2sD48dEsKpsX475KRxTwdk8QULUDU9xx8R,AKSiZnb4YKVB6B86aPPqvyXquhvN9xqt45bexBCZ7nx,True,675035488,168758872,1050996,525498,525498,4BnQKPLuE3DMTtxp8MjUBytgnhvxqq3ZTqZHTVZo4JJh,42039873,255590285,-213550412,622
2022-01-06 03:54:21.445365,2022-01-05 22:50:14-05:00,1686,6yw4GPvkqUbakcEWtqSCfjVLukty11xqjDpGxtEN9Km2,5ppEx7wkpqbG5nApCWMdRja3oRSheFmAAsNHUX7h2w2Y,True,17597545,4399386,27505,13752,13753,4BnQKPLuE3DMTtxp8MjUBytgnhvxqq3ZTqZHTVZo4JJh,1100234,11466691,-10366457,625
2022-01-06 03:54:21.445365,2022-01-05 22:50:14-05:00,1687,EmGW2aAG69ssWqCtbfDocRaM2u3TJsczn2HHP9jdmRvD,aypkDKsp9uqAB4F6mwvm5LofpsrFBuZT2MMWtE2eHdB,True,6880076,1720019,10736,5368,5368,4BnQKPLuE3DMTtxp8MjUBytgnhvxqq3ZTqZHTVZo4JJh,429454,1986030,-1556576,624
2022-01-06 03:54:21.445365,2022-01-05 22:50:14-05:00,1688,AHm7zF4rpaxaayBLn5QDHgJSp8KAr647s4cNvQ9wLgd7,FDM33WngED24pukBvSDpPAzinW6afVAeGReum5nyLRiC,True,8824235,2206058,13799,6899,6900,4BnQKPLuE3DMTtxp8MjUBytgnhvxqq3ZTqZHTVZo4JJh,551961,2880007,-2328046,625
2022-01-06 03:54:21.445365,2022-01-05 22:50:15-05:00,1689,ANQkPUoMjLHyRtypeKzxsKW1DFauQsh9SnB3rRgRXM1Y,7RHAExWpG8Q3PXwKhJs2yXmYK9WogGydvFYpx28p6pgr,True,773580103,193395025,1209649,604824,604825,GAUsoe8ZTCiGPm2hYxRPGxcPe5ShNzHK9eE3G2zgRjxd,48385978,298266029,-249880051,625
2022-01-06 04:00:49.634173,2022-01-05 22:56:11-05:00,1690,67Z7ZGhNu5xxEh9BYKWcXp9m1T4tFiE1o1M16hCzUWQA,CT7YKWixz7BhTbvg5F6M5HCyPGnHoFLNFuDV9GhoLTo3,True,34776123,8694030,54365,27182,27183,GmqQKnMfFxkv6ChqGaZ2wmSFDow7R1x7WeRfU58GVvfw,2174609,13446242,-11271633,625
2022-01-06 04:00:49.634173,2022-01-05 22:56:11-05:00,1691,E8ifvhmyJGBGVQomo3AnZw2UcaLHcpGsTtuoCid8voU3,FMQUWTbTAfSLfrc6GTrz4DM2ZSgoxF3KtqGn8AyjVtsf,True,75736192,18934048,117578,58789,58789,DddJ7EWCmYEEZETCBNgAUSg81Ls6fZtiAaY5ekJ5sXx1,4703126,15145279,-10442153,620
2022-01-06 04:00:49.634173,2022-01-05 22:56:11-05:00,1692,2VyFcgZDH1HTEvD1XaWhwqBCMmZ1k6TmZ3fEpPcBZR9E,G1wFJETTpdoc7CfypGCzkq1jssXPfUkiuLjK2cwVZ9dJ,True,857938,214483,1335,667,668,DddJ7EWCmYEEZETCBNgAUSg81Ls6fZtiAaY5ekJ5sXx1,53439,278941,-225502,622
2022-01-06 04:00:49.634173,2022-01-05 22:56:14-05:00,1693,CvZssqscu2dm35mwcE3zg9zedavbRjVJjWD59Py5ExUK,7pXaoR6aHKYofCmg1eHipygNYDteEaf8rbbS8BDYGQK6,True,7490600,1872650,11716,5858,5858,4BnQKPLuE3DMTtxp8MjUBytgnhvxqq3ZTqZHTVZo4JJh,468670,1529873,-1061203,625
2022-01-06 04:00:49.634173,2022-01-05 22:56:21-05:00,1694,pgzvXpnUYiY7hLrfjmwScqLd8oj9vYcXpFvpm4y4JvG,GdqdQgoyBAFuXdbvoZyDhB3jyqJzVo4nkGh7EPFxkBF2,True,22553925,5638481,35175,17587,17588,4BnQKPLuE3DMTtxp8MjUBytgnhvxqq3ZTqZHTVZo4JJh,1407032,14814189,-13407157,623
2022-01-06 04:00:49.634173,2022-01-05 22:58:23-05:00,1695,Ckqos6cdncPKj13DnCmDVZsZTqp6eS7277CRrT9WhcEr,AtUV8m7VQJvZq7GLCAHMf3jV7iamKEPnWVZHWuuVZQp1,True,13275283,3318820,20767,10383,10384,4BnQKPLuE3DMTtxp8MjUBytgnhvxqq3ZTqZHTVZo4JJh,830691,5492103,-4661412,625
2022-01-06 04:00:49.634173,2022-01-05 22:58:23-05:00,1696,CRaKcudjkQiSw5YPVjTLVdXvJskeGiHSYtq5ZcMPJhgQ,AgqTg3b3bAcaBmRidhNC4Uf9ZwNbeH52RQEqumWyuUs7,True,9257383,2314345,14418,7209,7209,GAUsoe8ZTCiGPm2hYxRPGxcPe5ShNzHK9eE3G2zgRjxd,576754,3832310,-3255556,623
2022-01-06 04:00:49.634173,2022-01-05 22:58:29-05:00,1697,9vcKW1GfrDZ3KLPh2pEVFF8ZyKqD1pJW1hiE8H98Av7S,C6Ki27mo4sCHu6u8UnR1p7WSgsTjFQxGGR9Lk9n5Rhjq,True,29702072,7425518,46480,23240,23240,DddJ7EWCmYEEZETCBNgAUSg81Ls6fZtiAaY5ekJ5sXx1,1859214,9092613,-7233399,625
2022-01-06 04:00:49.634173,2022-01-05 22:58:55-05:00,1698,HVZkXeDR3mc8oB9qFFwCK4RXpPojdcHk9tRGep6xtKGK,Bh3py7awPejWqeTMxtAgF7mPotL2Asxf8YrYJykq9nBt,True,70487970,17621992,110279,55139,55140,GAUsoe8ZTCiGPm2hYxRPGxcPe5ShNzHK9eE3G2zgRjxd,4411172,18304390,-13893218,625
2022-01-06 04:00:49.634173,2022-01-05 22:59:21-05:00,1699,BQBQicboM5o25LihnffqxcJmoPoA3mgBKNeG4H8UTHVh,E8rJFAs7dbDmQA1o5aTeNqdmADxWMd5cDzvwAGMFFCix,True,16159043,4039760,25264,12632,12632,GAUsoe8ZTCiGPm2hYxRPGxcPe5ShNzHK9eE3G2zgRjxd,1010595,9435870,-8425275,625
2022-01-06 04:00:49.634173,2022-01-05 22:59:43-05:00,1700,3qnPsgqW11AcDEmyjmJquPcPLyE3EdJQuVLJ5kinDrd3,86rZadBB7emKio76aFTahpbrFtxd9tqZ4Mxgzaavq2xU,True,1688448,422112,2640,1320,1320,GAUsoe8ZTCiGPm2hYxRPGxcPe5ShNzHK9eE3G2zgRjxd,105629,442183,-336554,625
2022-01-06 04:00:49.634173,2022-01-05 23:00:01-05:00,1701,7PzGZgzieFyyFs1dbajkNQgVxooFUNZrj1bUsQvrSwbp,A2gDREmSmJTBPPw3sbKVY3smC9wbHMDdv87gr4Tr2ES7,True,30381846,7595461,47449,23724,23725,4BnQKPLuE3DMTtxp8MjUBytgnhvxqq3ZTqZHTVZo4JJh,1897995,7969894,-6071899,624
2022-01-06 04:00:49.634173,2022-01-05 23:00:05-05:00,1702,BrHRMouGRz3LBNzd9anfdYMhWfg8yUPHL4PqJ8WdEDFS,4uzoLa3mC2VYHAPBoHLX4gTjPTC28rPf2fvEGtJWPYc,True,650066663,162516665,1016297,508148,508149,3zqXX6kzhkbW3d4TwD2CNjMRwxTbREXySekvq37kfCNk,40651899,383892881,-343240982,625
2022-01-06 04:00:49.634173,2022-01-05 23:00:05-05:00,1703,B4Uc39nKzz9wBRQsCkMR4A7RwTJ8rSuwpR6EQn2AesRb,H49bGZgatRZVpj6QufZRVgYrQtH7LpdbiqKBs23151m,True,276477561,69119390,431421,215710,215711,3zqXX6kzhkbW3d4TwD2CNjMRwxTbREXySekvq37kfCNk,17256857,183767760,-166510903,624
2022-01-06 04:00:49.634173,2022-01-05 23:00:08-05:00,1704,HGJoZvLakWfSDFwuvShNBc4kCf7nP7VqzyM3mELpbFEf,12Qn5jin7QvsBngXqYAv4UstyG3b6nRf1jsLp9Dp8G7k,True,173254405,43313601,271088,135544,135544,DddJ7EWCmYEEZETCBNgAUSg81Ls6fZtiAaY5ekJ5sXx1,10843523,48507008,-37663485,625
2022-01-06 04:00:49.634173,2022-01-05 23:00:23-05:00,1705,CagSUfZLwXuCdypC4KzU6FSNdmCj9dKDroPcNeaRtsyt,yxw5d1ztZuEUY2QjL7eLpr72QJAj5rJd6ERvg91cy1m,True,17262486,4315621,26666,13333,13333,DddJ7EWCmYEEZETCBNgAUSg81Ls6fZtiAaY5ekJ5sXx1,1066662,3794076,-2727414,617
2022-01-06 04:00:49.634173,2022-01-05 23:00:23-05:00,1706,2FEbsetZMkRqLjSC8GBbgecKgX5T1T1fci2sLQux29p8,H722Fcd6DkTFRZxqQWbPDufBfXEgmFfhiEpQZWhxwYv1,True,51561411,12890352,79816,39908,39908,3zqXX6kzhkbW3d4TwD2CNjMRwxTbREXySekvq37kfCNk,3192667,11621256,-8428589,619
2022-01-06 04:00:49.634173,2022-01-05 23:00:25-05:00,1707,8xQ3tsWVUe75EG1HmocULJ3kh52utveoFMEPotTGrKno,i3SKW3ywrwYucX9ySEx1C4zaUKGnzLerP3V38437NyV,True,657490847,164372711,1027140,513570,513570,GAUsoe8ZTCiGPm2hYxRPGxcPe5ShNzHK9eE3G2zgRjxd,41085622,188152261,-147066639,624
2022-01-06 04:00:49.634173,2022-01-05 23:00:25-05:00,1708,BPsM1um9ZJf7eNoVMsQCRSwgARMuLCGGSDxf9tZeNeEy,BpzDdXfxVygiSYSmsHV6uPxQMeTFtrURMCCqhswQjd5X,True,12868253,3217063,20009,10004,10005,GAUsoe8ZTCiGPm2hYxRPGxcPe5ShNzHK9eE3G2zgRjxd,800381,2930617,-2130236,621
2022-01-06 04:00:49.634173,2022-01-05 23:00:25-05:00,1709,ymyzGH4Qc7HH5PbKpVphCbsQgLLXyGkPcXamQJuNj5C,8oTLHaV2XzbKXNWRuUjCfHjUn61Pw93LYK14m9q2VDpZ,True,146788071,36697017,226425,113212,113213,3zqXX6kzhkbW3d4TwD2CNjMRwxTbREXySekvq37kfCNk,9057012,32248941,-23191929,617
2022-01-06 04:00:49.634173,2022-01-05 23:00:25-05:00,1710,FV9CBGGTbppLnBKh79f2LzD1diTiS5g6u89FcpZHZmnK,Fe7mtmCUziFqbbYTvrhAcAq1Ub7YLfTJRtQ1hG7GzJD1,True,58075179,14518794,90849,45424,45425,4BnQKPLuE3DMTtxp8MjUBytgnhvxqq3ZTqZHTVZo4JJh,3633981,13078802,-9444821,625
2022-01-06 04:00:49.634173,2022-01-05 23:00:26-05:00,1711,BYvjENe16Ta77PqGV7JKEWrsqCTfkMGYwTSG5gXneDvd,EvxAXgvhPC6QkNurbK7vWyTApGo8J2R4EgMAknkHVU3d,True,32997300,8249325,51452,25726,25726,GAUsoe8ZTCiGPm2hYxRPGxcPe5ShNzHK9eE3G2zgRjxd,2058105,14056278,-11998173,623
2022-01-06 04:00:49.634173,2022-01-05 23:00:26-05:00,1712,GqAS41YJssg9aaEp3hs3sG98APCsXhiQBQszXaSjZ2bN,2wodJ3AhrXdE1T4oVL95KvoBND7PubG5Wd5GWiLCMZJU,True,2026894098,506723524,3132819,1566409,1566410,GAUsoe8ZTCiGPm2hYxRPGxcPe5ShNzHK9eE3G2zgRjxd,125312761,1207945728,-1082632967,618
2022-01-06 04:25:36.065763,2022-01-05 23:01:02-05:00,1713,3WcJUt8jQ1ngL3ZCGo6dFrc3GmTMTYtzeDva7mri2Tqx,HeG1Pz2oMjqtkfsRMsbqP3VpatnVEQzcWmKDVoFp4Htr,True,173271548,43317887,271105,135552,135553,4BnQKPLuE3DMTtxp8MjUBytgnhvxqq3ZTqZHTVZo4JJh,10844239,48490582,-37646343,625
2022-01-06 04:25:36.065763,2022-01-05 23:01:06-05:00,1714,36ByQojnxEckWdQTjqHfxKqCx9yjqWQsPsZyqaN72UWR,AZoirtS1fjX61agRM64tqThVinnJTh3BWgiHyNHPTgZP,True,8941245,2235311,13938,6969,6969,GAUsoe8ZTCiGPm2hYxRPGxcPe5ShNzHK9eE3G2zgRjxd,557554,3220634,-2663080,623
2022-01-06 04:25:36.065763,2022-01-05 23:04:16-05:00,1715,6Bq55LtGCEeGqh4JrFLCmmGc2iJfTTBJixivqH78aGSE,DSNrCgWJeNe2P9tAQu5FvCueTzNKDKds7wzuwTQSMRG,True,73230757,18307689,113404,56702,56702,GAUsoe8ZTCiGPm2hYxRPGxcPe5ShNzHK9eE3G2zgRjxd,4536160,16125403,-11589243,619
2022-01-06 04:25:36.065763,2022-01-05 23:04:20-05:00,1716,DR7XL3qweFyTKDatQYS2LacqGLv2368cnGuWpEpk4hSL,Fd3BYCiiQfThDJsxBUNwYTMP8eNCrnXMVzE1wpejJqXa,True,50862,12715,78,39,39,GAUsoe8ZTCiGPm2hYxRPGxcPe5ShNzHK9eE3G2zgRjxd,3136,17318,-14182,616
2022-01-06 04:25:36.065763,2022-01-05 23:04:27-05:00,1717,7vKmhLV45Q5etXhJL5ng8rxWhYSiUCDmAbGnwBPr7zcx,cP6xPeuHLnjr858QK1F9qYn7rJpEbPy7wEJHoju6oV7,True,372456571,93114142,582293,291146,291147,GAUsoe8ZTCiGPm2hYxRPGxcPe5ShNzHK9eE3G2zgRjxd,23291721,98640147,-75348426,625
2022-01-06 04:25:36.065763,2022-01-05 23:04:27-05:00,1718,7D4rFmGMPKNAF75VRPxHAhSn2wTjiW8jmth1UD22Xqq9,GQ7BrT6vsXu8tHCMm75YdxFR2r9QTCrCUbdPEZBSAg9w,True,412486837,103121709,644793,322396,322397,3zqXX6kzhkbW3d4TwD2CNjMRwxTbREXySekvq37kfCNk,25791741,85304575,-59512834,625
2022-01-06 04:25:36.065763,2022-01-05 23:05:04-05:00,1719,2PzBAkdXkrwH9VuoMALumQz86qkW7sSBQtCrHw14JUp3,D5vwWAMHVooobG2sCWv9EwtJrAFZG6cwKH4dfmA98tbt,True,22370514,5592628,34824,17412,17412,GAUsoe8ZTCiGPm2hYxRPGxcPe5ShNzHK9eE3G2zgRjxd,1392995,6019762,-4626767,622
2022-01-06 04:25:36.065763,2022-01-05 23:05:05-05:00,1720,3VdSA9CED9f5swRwHX2U15U7J6Muaq8VPnCNy9CaGDHe,2YYstfnfdYic5NWmEbcUEHpccNUVd1EhuCkExvMsoMk8,True,75365555,18841388,117417,58708,58709,3zqXX6kzhkbW3d4TwD2CNjMRwxTbREXySekvq37kfCNk,4696697,27704046,-23007349,623
2022-01-06 04:25:36.065763,2022-01-05 23:05:05-05:00,1721,5Z3ZFCA65WoWhm3okRuuziEMi7ajGAEHWUFchzBNba5S,FcomdrWidygkxMKzcsY5xELbmwC652uMci648LMTv7AB,True,106952,26738,166,83,83,GAUsoe8ZTCiGPm2hYxRPGxcPe5ShNzHK9eE3G2zgRjxd,6670,27443,-20773,623
2022-01-06 04:25:36.065763,2022-01-05 23:05:05-05:00,1722,i7TcF4weYcqgrRdH3GpndbEYxCxfcSfr9JWYrAUg1CF,BkDfknUir7PnSEW8auoB87PytycEFwyX5kT2GY4SGJJL,True,45475437,11368859,71014,35507,35507,3zqXX6kzhkbW3d4TwD2CNjMRwxTbREXySekvq37kfCNk,2840596,27670854,-24830258,624
2022-01-06 04:25:36.065763,2022-01-05 23:05:09-05:00,1723,9KD2AifD5wFD4QkHYuawXbJgLWHrfj2QPF3fT8jhGVA5,Ga9gAqmkuHbqrr31sUFPqa1xa5WNxLWJWGPUaMxQqLdj,True,14629025,3657256,22723,11361,11362,4BnQKPLuE3DMTtxp8MjUBytgnhvxqq3ZTqZHTVZo4JJh,908920,5472254,-4563334,621
2022-01-06 04:25:36.065763,2022-01-05 23:05:10-05:00,1724,DrzTARa7RK8RXoxHZPKCBqYtMC8TAUHRw8SznXRKTa5M,FYANet92VhyXkKZqqBJR4sFxuCftWb68sgQU9VHCdTJk,True,284010,71002,444,222,222,4BnQKPLuE3DMTtxp8MjUBytgnhvxqq3ZTqZHTVZo4JJh,17772,71303,-53531,625
2022-01-06 04:25:36.065763,2022-01-05 23:06:01-05:00,1725,A7SMcwnq3DewryUj1jScnAboKGnuDVcW15F3ubNcG66Y,5qLCE37FdeWLCQnkfNJViFMGNcDeiELgE3VgPbBUuDGF,True,197805457,49451364,309356,154678,154678,4BnQKPLuE3DMTtxp8MjUBytgnhvxqq3ZTqZHTVZo4JJh,12374267,66353749,-53979482,625
2022-01-06 04:25:36.065763,2022-01-05 23:06:11-05:00,1726,CK3ocyWzXQkJJZQmM6bBK4Nv6Rh3UEufjY6DvNU6gJZy,C924o4GY3p2BHLeAbFbe9SEysXqCUyD8sFu2d4NzkAV7,True,56021882,14005470,87546,43773,43773,4BnQKPLuE3DMTtxp8MjUBytgnhvxqq3ZTqZHTVZo4JJh,3501868,12469985,-8968117,625
2022-01-06 04:25:36.065763,2022-01-05 23:06:11-05:00,1727,E1wp3bmkcY3eiEYyGYwhTCsr7BZ7RfPa5DJTZFupcFwj,452hVdYkD5SDDrA6hv6DLPFvyS8PvR2P6DPNScGxWTsW,True,6931902,1732975,10833,5416,5417,4BnQKPLuE3DMTtxp8MjUBytgnhvxqq3ZTqZHTVZo4JJh,433323,1938075,-1504752,625
2022-01-06 04:25:36.065763,2022-01-05 23:06:43-05:00,1728,Cb4zhnvig11U4GcC4kqKrnDicGgPhUpfDQB1U7hP3nPa,DiRAMrKqaevGXeXg38KnhaYBERj8tNKU7oWFJvhS32kw,True,1733266,433316,2705,1352,1353,3zqXX6kzhkbW3d4TwD2CNjMRwxTbREXySekvq37kfCNk,108207,374941,-266734,624
2022-01-06 04:25:36.065763,2022-01-05 23:06:52-05:00,1729,2NHv3c4ufYGo3xNr6KXymAZJdpfURrNiCKbXZ7s82Vwo,E4NYpYgHTvSG6LqH2bBV9Q1XJ6pAzCp9FLSKMzJmYRrQ,True,222349581,55587395,347870,173935,173935,DddJ7EWCmYEEZETCBNgAUSg81Ls6fZtiAaY5ekJ5sXx1,13914823,82032862,-68118039,625
2022-01-06 04:25:36.065763,2022-01-05 23:07:15-05:00,1730,AKxRtcdpi7gWhAuL8ENj7zhgeQezzEXe9TSANE6bQoRA,2YH4vrU9deP8Cu6E8Hzf8GqKG1yVjv5pdz4FE7r5YKir,True,58837070,14709267,92042,46021,46021,DddJ7EWCmYEEZETCBNgAUSg81Ls6fZtiAaY5ekJ5sXx1,3681709,15375806,-11694097,625
2022-01-06 04:25:36.065763,2022-01-05 23:07:29-05:00,1731,89CkXnSZnr52Zsoh48efv9MQacrkB6GMtrbEpNJSyA2H,HcvRBS4Z22CpYgDNgm4TVF4AVXFDuYzBUAFcdHAwdpg4,True,25765791,6441447,40305,20152,20153,3zqXX6kzhkbW3d4TwD2CNjMRwxTbREXySekvq37kfCNk,1612213,6747301,-5135088,625
2022-01-06 04:25:36.065763,2022-01-05 23:07:38-05:00,1732,GaEpNGa8jnwSRvjzzEMYkZe1pKcr2eiZtePrqFxpABjB,5CFZHuyWbJv14zPdX5dSQDREgHrCb4vsFvB6hLiEe3Ji,True,1309283,327320,2048,1024,1024,DddJ7EWCmYEEZETCBNgAUSg81Ls6fZtiAaY5ekJ5sXx1,81934,347653,-265719,625
2022-01-06 04:25:36.065763,2022-01-05 23:07:41-05:00,1733,2rCRdyfi65rpxRRmg7knaSb8t55FuPt3h8wF4Fzhy8MM,CLVY5nSG3jTdRo7tRSKgK9DJgW6aswfWKe4tLxzsENmb,True,5414122,1353530,8452,4226,4226,4BnQKPLuE3DMTtxp8MjUBytgnhvxqq3ZTqZHTVZo4JJh,338091,1203969,-865878,624
2022-01-06 04:25:36.065763,2022-01-05 23:07:41-05:00,1734,HqtTbC1LFreGvgfpZe7nCqkNnh8GHPQKosfmc19zb1yi,E39UNiHNkwQEd5GXkCtTPqSorQSB1kLx8kjzK4jdFoi3,True,2671567197,667891799,4171025,2085512,2085513,4BnQKPLuE3DMTtxp8MjUBytgnhvxqq3ZTqZHTVZo4JJh,166841024,847429322,-680588298,624
2022-01-06 04:25:36.065763,2022-01-05 23:07:49-05:00,1735,D3mXrJzhHf8qRaoCKLschUxAFoijFCFuT6bmNZH4W7Cj,9E3Xtqw7TncXWnbhAbFJMtuNmP6WS3ooGuptzyzw7UpA,True,497027,124256,773,386,387,4BnQKPLuE3DMTtxp8MjUBytgnhvxqq3ZTqZHTVZo4JJh,30948,194607,-163659,622
2022-01-06 04:25:36.065763,2022-01-05 23:07:51-05:00,1736,2NdwSLxsGok8PczpCZj9CVX2BymNU5MvHt7hWfGetg2M,8AQbDXeA6mD9QoZBFJcYbnHvZwKNxzA9CCHLAgdSfTA3,True,91560,22890,142,71,71,DddJ7EWCmYEEZETCBNgAUSg81Ls6fZtiAaY5ekJ5sXx1,5715,32782,-27067,624
2022-01-06 04:25:36.065763,2022-01-05 23:07:58-05:00,1737,Ar5QB4VBcUyzSCG23z2QNAbrWY55NbHCr1MNN6P2GAmh,BusFGTiDrJmxzwGUxWz9b3SFF3eseqtgh2DRHqyAwyVe,True,3973342,993335,6217,3108,3109,4BnQKPLuE3DMTtxp8MjUBytgnhvxqq3ZTqZHTVZo4JJh,248712,1122630,-873918,625
2022-01-06 04:25:36.065763,2022-01-05 23:08:06-05:00,1738,4MmpDGUTyMcYEqJ1RoZ46AN2BhrBUseHaHqF8AmiTPyD,7HW2YZpYM349HMfW7u4h9ESZ1AXkwN8JcVDTNFzp9aTz,True,1031410271,257852567,1612986,806493,806493,4BnQKPLuE3DMTtxp8MjUBytgnhvxqq3ZTqZHTVZo4JJh,64519449,368597834,-304078385,625
2022-01-06 04:25:36.065763,2022-01-05 23:08:06-05:00,1739,9YEzjb49Awvedv9yNc6LG54SkGBug2RYiJwiUV13mGsS,3H8w5WCD187NWWoZMNUCzUDdxTgqrRJLga8gDzUVXBgZ,True,9422349,2355587,14738,7369,7369,4BnQKPLuE3DMTtxp8MjUBytgnhvxqq3ZTqZHTVZo4JJh,589526,4032581,-3443055,625
2022-01-06 04:25:36.065763,2022-01-05 23:08:14-05:00,1740,EQUZQWk4WLT6LFeWZs3P9AQufFcoZouFETfhyxvuS2JM,Byc2mLXArmkjQPWaxCJksHZD2XpZyCQ2FRtDJyztU81V,True,816496652,204124163,1276845,638422,638423,4BnQKPLuE3DMTtxp8MjUBytgnhvxqq3ZTqZHTVZo4JJh,51073821,320785442,-269711621,625
2022-01-06 04:25:36.065763,2022-01-05 23:08:18-05:00,1741,AtKuDfcFXqWUMnRqQpjedUMTb5CQKLc2zoqEAcQpysKQ,9bPFLYp5TDZruLLDXDYYCiPYcD982iF8xt5rfTkqwNsL,True,95568,23892,148,74,74,4BnQKPLuE3DMTtxp8MjUBytgnhvxqq3ZTqZHTVZo4JJh,5953,24012,-18059,622
2022-01-06 04:25:36.065763,2022-01-05 23:08:19-05:00,1742,J2gTwrYpzezkRupgBtgudQn5D33x6WjeBhTHnrA1qgqa,FBzoHRwqGRjnMvPEpiZVjtGZYJmAbneE4dpToXPzy8bv,True,271271943480,67817985870,421989633,210994816,210994817,4BnQKPLuE3DMTtxp8MjUBytgnhvxqq3ZTqZHTVZo4JJh,16879585350,62015671870,-45136086520,622
2022-01-06 04:25:36.065763,2022-01-05 23:08:27-05:00,1743,7LRBswSEDBjJzQ4YurfTxLydh7tFS2jVn5V95Z6wL7ci,fD41VYGmk66MW46KKb23vAqQvUSDScgXnVdsHhJBZzu,True,1007387,251846,1507,753,754,DddJ7EWCmYEEZETCBNgAUSg81Ls6fZtiAaY5ekJ5sXx1,60315,334379,-274064,598
2022-01-06 04:25:36.065763,2022-01-05 23:08:27-05:00,1744,2ce2v2TCbjNH635NgbwTG3sqiRWYrRRaBpxPxBZJ929q,9cnoebT43FkWDFhidndGCVNiFD4NErv8DuL1Va4Jv9S8,True,47419429,11854857,74106,37053,37053,GAUsoe8ZTCiGPm2hYxRPGxcPe5ShNzHK9eE3G2zgRjxd,2964267,27449538,-24485271,625
2022-01-06 04:25:36.065763,2022-01-05 23:08:27-05:00,1745,4FazDUgfQ3AKoFcnWHr8E9Ht8jLA3tkxf75yrGZVHdmF,HzRMH6mbgEKydRCnnMvSsKgTEVNQi6nuzoR1xutYFdzg,True,483102,120775,752,376,376,GAUsoe8ZTCiGPm2hYxRPGxcPe5ShNzHK9eE3G2zgRjxd,30089,258367,-228278,622
2022-01-06 04:25:36.065763,2022-01-05 23:08:27-05:00,1746,5hUZ9uQFcYnjAQVVaGLJWdKyg7y1XMpoo8osQ9DeY7Xd,BdYiKWsjuzJLcHh3814mJ4xQ9JxoQKKcr7AHZ7Vxoavq,True,346814,86703,525,262,263,DddJ7EWCmYEEZETCBNgAUSg81Ls6fZtiAaY5ekJ5sXx1,21026,96024,-74998,606
2022-01-06 04:25:36.065763,2022-01-05 23:08:27-05:00,1747,CAkknoa9UFPMEZ1KWSfqtmnL7ArVNV3HRETLwecuuXP,4cHJYv3dxA6qjcuxUkGRuL7STWobGPKtoHFD4ACUbiWq,True,89522362,22380590,134984,67492,67492,DddJ7EWCmYEEZETCBNgAUSg81Ls6fZtiAaY5ekJ5sXx1,5399380,23366160,-17966780,603
2022-01-06 04:25:36.065763,2022-01-05 23:08:27-05:00,1748,8VT2nxz5ZYDJFd9uL2XZwEXxChd9pjuMJNMAcutZubL1,EhAkiRbouzUAWtqQFsN8HEEfi46UVN8H8tyBP7CbgeLe,True,78435,19608,117,58,59,3zqXX6kzhkbW3d4TwD2CNjMRwxTbREXySekvq37kfCNk,4688,24825,-20137,597
2022-01-06 04:25:36.065763,2022-01-05 23:08:27-05:00,1749,H6tDNj9cHac223ckAnNfnC4bAJuNLBnf2pFk2iQdMzMP,28UL9dqgayCqCAexScXjdpobYGVDN44SGBVNAfBByk8C,True,527270333,131817583,818958,409479,409479,3zqXX6kzhkbW3d4TwD2CNjMRwxTbREXySekvq37kfCNk,32758328,208122727,-175364399,621
2022-01-06 04:25:36.065763,2022-01-05 23:08:27-05:00,1750,EgU9hX6VK7YXeCgCHVaJAMekCcyZa2MVWdKra5pN7Gwv,7y8Ad9XY34bqREvheXHT2tr8Jy11D6X3pu7yLVtjU4QV,True,78064490,19516122,120109,60054,60055,DddJ7EWCmYEEZETCBNgAUSg81Ls6fZtiAaY5ekJ5sXx1,4804397,26187199,-21382802,615
2022-01-06 04:25:36.065763,2022-01-05 23:08:27-05:00,1751,EV21gv8jEvXtmGDoGRNm5LJEvTBccLMZyVDCLsp54jP3,DGxxoU52aQNoUQcxdvQtv2H5q2PhK6TGkLgNSaFgnZrb,True,38131365,9532841,56472,28236,28236,3zqXX6kzhkbW3d4TwD2CNjMRwxTbREXySekvq37kfCNk,2258890,10802692,-8543802,592
2022-01-06 04:25:36.065763,2022-01-05 23:08:27-05:00,1752,9jdfc9GFTecsdRuTjWFGX13niKKmeBxRgtv5j86uhSnU,HLWMShobjSkaLyXrNjgwVaUGVtbtdUSnr1XjqpXn1bLR,True,2503528,625882,3658,1829,1829,GAUsoe8ZTCiGPm2hYxRPGxcPe5ShNzHK9eE3G2zgRjxd,146353,767111,-620758,584
2022-01-06 04:25:36.065763,2022-01-05 23:08:27-05:00,1753,3g1debT8Z2efQPuMNSDPUNZzDqarBG2acErsZ4HP7QGA,42wDHagxr5Nno3mUx6kyYGDjwR98aedRbh3ByB468agB,True,149068,37267,230,115,115,DddJ7EWCmYEEZETCBNgAUSg81Ls6fZtiAaY5ekJ5sXx1,9206,39402,-30196,617
2022-01-06 04:25:36.065763,2022-01-05 23:08:28-05:00,1754,3zH1b58jqbNU37y9kDTZZrotSeT8XzS1tuyAHPKWrbah,4trxDWV16x6sVcz7bxHehYHkjjyKebh3S9fyJf8txzK5,True,59646,14911,91,45,46,3zqXX6kzhkbW3d4TwD2CNjMRwxTbREXySekvq37kfCNk,3653,15242,-11589,612
2022-01-06 04:25:36.065763,2022-01-05 23:08:28-05:00,1755,JCBhqqPQxP1Xc41sSY6e1sQKRstHhe7D1v6rLz4hp3Qp,DWMUq2bMD1jqpxHtyXDFjcAwjA27yyMRe68hGcsK143m,True,59549,14887,87,43,44,3zqXX6kzhkbW3d4TwD2CNjMRwxTbREXySekvq37kfCNk,3496,15555,-12059,587
2022-01-06 04:25:36.065763,2022-01-05 23:08:28-05:00,1756,EEcTbsFTUEifcdbPyjBLkS943daEx1RpR8F3uZxKRZbT,8V3JzDQ1VWYQLas8fxUsWJZZHe4gEmn74RehtUwLw3k5,True,42181787,10545446,65372,32686,32686,3zqXX6kzhkbW3d4TwD2CNjMRwxTbREXySekvq37kfCNk,2614905,14030452,-11415547,619
2022-01-06 04:25:36.065763,2022-01-05 23:08:28-05:00,1757,CFFpbRxYEP18rqEGxxyG3bzSV13Lv7nfSmZvtUK17kCP,824UwqH2JcFsqYBk9MZ8tTnpka9udTL6WGX35YFtAJQk,True,30320940,7580235,45991,22995,22996,3zqXX6kzhkbW3d4TwD2CNjMRwxTbREXySekvq37kfCNk,1839675,7942933,-6103258,606
2022-01-06 04:25:36.065763,2022-01-05 23:08:32-05:00,1758,FjDp4bWCtqehFD7FunCrjrcdxMezTJj5aqh2VnBvHDQU,HRYeZqcqhP1RPiAGXziR1qCWwk4sF6c5ZYbvSDhX7foN,True,63205067,15801266,96823,48411,48412,3zqXX6kzhkbW3d4TwD2CNjMRwxTbREXySekvq37kfCNk,3872942,15660429,-11787487,612
2022-01-06 04:25:36.065763,2022-01-05 23:08:32-05:00,1759,Buioe5v3DyFwD9nquW5XdYeVYbSABCyg79eUHEvtvfaW,7T9gi7prCcZJkYJMSB5Ef6Bu4pAuBw4XLvumSFnqKDSi,True,5575166,1393791,8476,4238,4238,3zqXX6kzhkbW3d4TwD2CNjMRwxTbREXySekvq37kfCNk,339053,2162200,-1823147,608
2022-01-06 04:25:36.065763,2022-01-05 23:08:32-05:00,1760,4mB2DVbQVqVk535v98Cj8SPNg1tTc3DFyY2Q7VBbY645,HXo255k3RgsTGsc4hiP6ZTXUspBTqJ37duQa5eK7tqp3,True,2330084524,582521130,3454301,1727150,1727151,3zqXX6kzhkbW3d4TwD2CNjMRwxTbREXySekvq37kfCNk,138172077,610590144,-472418067,592
2022-01-06 04:25:36.065763,2022-01-05 23:08:32-05:00,1761,CEbGTNX6WpaoKp4RBGSn9LzYM6yAYyeiMrgVYgJxA4zb,AiXUcGAFFm4tc7vKBscSNjZawV5YJqbv7D1KpxD3Zufg,True,156194718,39048679,238167,119083,119084,3zqXX6kzhkbW3d4TwD2CNjMRwxTbREXySekvq37kfCNk,9526694,60412878,-50886184,609
2022-01-06 04:25:36.065763,2022-01-05 23:08:32-05:00,1762,GJ3PbEfPK8jjrPgMmZtvN5fMSSy2dtiiAtZ8wcfgxVuc,FCUDVFb2TjDvehHE8fVBofqSykpb9W6Afc9QeHtj7te7,True,656091689,164022922,963569,481784,481785,3zqXX6kzhkbW3d4TwD2CNjMRwxTbREXySekvq37kfCNk,38542767,256653416,-218110649,587
2022-01-06 04:25:36.065763,2022-01-05 23:08:37-05:00,1763,Mcbzp1LhZwpfmXTv1pqe9D1jCKHw443j9QKp6tUpzgM,8uforSMAKEih5jHfHp3gCqCvaugtCmhzVfVHA63Akz7F,True,17055421,4263855,25352,12676,12676,4BnQKPLuE3DMTtxp8MjUBytgnhvxqq3ZTqZHTVZo4JJh,1014088,6203799,-5189711,594
2022-01-06 04:25:36.065763,2022-01-05 23:09:29-05:00,1764,5Rxuqgs4CaSKbfDXqBMFXkLTQ9dxrUjThXzoy3ouYVtK,BgvbKru66ebrGUcFFymGTmsaQv6GgcGMybiWaXqzBtwX,True,2324819,581204,3611,1805,1806,3zqXX6kzhkbW3d4TwD2CNjMRwxTbREXySekvq37kfCNk,144442,917729,-773287,621
2022-01-06 04:49:23.870179,2022-01-05 23:30:05-05:00,1765,8xvLGVeDmhVYQhN2ZpWkVG9jCrukRsNQ4926a4TMiZqa,9ciBySSjvADwp47WkETiFWZKVTFL8Hf1XvK7aSxhcgQS,True,278499000,69624750,433793,216896,216897,GmqQKnMfFxkv6ChqGaZ2wmSFDow7R1x7WeRfU58GVvfw,17351732,66173222,-48821490,623
2022-01-06 04:49:23.870179,2022-01-05 23:30:43-05:00,1766,G5NLYTLxDZfJFKsJdMeWS8Ez95ZFwR5AX4hKhnfVJvoE,AwrC3pKhTeEDr1HCTWoKWjadteZccvqcisbC7vxTjn7w,True,142004050,35501012,219369,109684,109685,3zqXX6kzhkbW3d4TwD2CNjMRwxTbREXySekvq37kfCNk,8774794,51705868,-42931074,617
2022-01-06 04:49:23.870179,2022-01-05 23:37:10-05:00,1767,JDeYjCLpfnzcfxDFgHf4aBcHsajwdR14GUaKAA9euzVf,EJbvKoyMZcoCx4vWa61uMbW2vr6mUhrgEuECdteVBuZZ,True,86648677,21662169,134983,67491,67492,GmqQKnMfFxkv6ChqGaZ2wmSFDow7R1x7WeRfU58GVvfw,5399341,33832499,-28433158,623
2022-01-06 04:49:23.870179,2022-01-05 23:39:55-05:00,1768,7CSCMFa9W52tBDVUbXbc3woAy3GByeA1wPJdp3MgznPa,3447ptuVFu6G8B6N63RmS8mRv4n9PfHneypHLvbeaGLn,True,1181094298,295273574,1847608,923804,923804,72FwbpFGoLEazJEdpqNtPNefsadUrimUqma9wSoy4qiS,73904325,337241895,-263337570,625
2022-01-06 04:49:23.870179,2022-01-05 23:40:36-05:00,1769,8trkirSQNdMmAcJdeswxs5cPjH8dD6U4eJtWiAdMsrDB,HaSzpQ45x2MipfN17U6jGBxX8tXboomVDhXNSrnEfLDr,True,36697024,9174256,57299,28649,28650,4BnQKPLuE3DMTtxp8MjUBytgnhvxqq3ZTqZHTVZo4JJh,2291969,9250037,-6958068,624
2022-01-06 04:49:23.870179,2022-01-05 23:41:07-05:00,1770,Bsr6kx1B6BSEd5UnJ7Z61M49iUb3bFrDVhiEtMVtPDF2,3CFd1pUJAJPA9fobwn4Jj2mRju1CWmoop4Mh4znypNWT,True,325356667,81339166,507261,253630,253631,4BnQKPLuE3DMTtxp8MjUBytgnhvxqq3ZTqZHTVZo4JJh,20290477,66696653,-46406176,623
2022-01-06 08:39:09.889570,2022-01-06 03:32:21-05:00,1771,6NJFN855M3Q3RLTDNo57gTgAmwPD6G2E3WvMb1m5eNCN,3YpqNnonsvXaRT4nCC3G5FZx1jjVtbDPc36LiR6WK5jR,True,843798412,210949603,1297012,648506,648506,GAUsoe8ZTCiGPm2hYxRPGxcPe5ShNzHK9eE3G2zgRjxd,51880518,322176358,-270295840,614
2022-01-06 08:39:09.889570,2022-01-06 03:32:21-05:00,1772,8swGZMrPrLAxZd7MxTbkCL13k3DmAJUw41jCp6Xo6awW,3fKnX7yTNXAT4uMmXVdTy47ALJT8h8YSD3WiBb4BGuzH,True,2576741001,644185250,4012367,2006183,2006184,4BnQKPLuE3DMTtxp8MjUBytgnhvxqq3ZTqZHTVZo4JJh,160494707,679270829,-518776122,622
2022-01-06 08:39:09.889570,2022-01-06 03:38:52-05:00,1773,9WJBnVi84E926j7xEd566WzrZJkPJWRgmEnYj9vyjuad,4dLaFS5F7TGyLdwuJLMGkz3bSL53aHzd9ZfpNmhHxXeF,True,170376243,42594060,266493,133246,133247,GAUsoe8ZTCiGPm2hYxRPGxcPe5ShNzHK9eE3G2zgRjxd,10659743,55966916,-45307173,625
2022-01-06 08:39:09.889570,2022-01-06 03:38:56-05:00,1774,HdfQweV1KuYSpWdycZbpGrUc8yMcY3ZczLn1agKXMJaf,G1Ae1PZHkANkwFnhUKS1tvdFEv8dAFeojBkezh6rUNMh,True,59398410,14849602,92938,46469,46469,4BnQKPLuE3DMTtxp8MjUBytgnhvxqq3ZTqZHTVZo4JJh,3717538,18220911,-14503373,625
2022-01-06 08:51:51.399882,2022-01-06 03:39:42-05:00,1775,8kJu5aqVSmW8FSZR9h6F75ftn9V2U9uMLBEKeqRaC855,FhVHByujkvwwtjTVpZ4mqSUqoMoBgeLUc5H7rbz3FgAt,True,979915274,244978818,1533363,766681,766682,4BnQKPLuE3DMTtxp8MjUBytgnhvxqq3ZTqZHTVZo4JJh,61334521,381419247,-320084726,625
2022-01-06 09:13:11.983924,2022-01-06 04:05:53-05:00,1776,399591e8XgY52yCMorCQ2WL6dQZTC485ZooHtmGuirhZ,JCiXAooFmKmEPQ2S7C8iSk6CLcTyrPEe1SsPSLyUGySe,True,11861401,2965350,18376,9188,9188,4BnQKPLuE3DMTtxp8MjUBytgnhvxqq3ZTqZHTVZo4JJh,735052,4622072,-3887020,619
2022-01-06 09:13:11.983924,2022-01-06 04:06:05-05:00,1777,D9VKhnfLLCrntDGFYSfoxFaY76VnHmYZ1ZbyFXdKdibz,2hRCRH2pMDyQGYcXHa8Y6BZo6FbcGZf5VJC1v8Bp6tGa,True,1018235061,254558765,1591882,795941,795941,4BnQKPLuE3DMTtxp8MjUBytgnhvxqq3ZTqZHTVZo4JJh,63675301,221994741,-158319440,625
2022-01-06 09:31:32.582181,2022-01-06 04:26:14-05:00,1778,3VdSA9CED9f5swRwHX2U15U7J6Muaq8VPnCNy9CaGDHe,2YYstfnfdYic5NWmEbcUEHpccNUVd1EhuCkExvMsoMk8,True,55433852,13858463,86357,43178,43179,GAUsoe8ZTCiGPm2hYxRPGxcPe5ShNzHK9eE3G2zgRjxd,3454308,21800379,-18346071,623
2022-01-06 09:31:32.582181,2022-01-06 04:26:14-05:00,1779,9KD2AifD5wFD4QkHYuawXbJgLWHrfj2QPF3fT8jhGVA5,Ga9gAqmkuHbqrr31sUFPqa1xa5WNxLWJWGPUaMxQqLdj,True,10760091,2690022,16694,8347,8347,GmqQKnMfFxkv6ChqGaZ2wmSFDow7R1x7WeRfU58GVvfw,667792,4301980,-3634188,620
2022-01-06 09:31:32.582181,2022-01-06 04:26:37-05:00,1780,DYCYiQFH9QHzCo3eAw1pFoDu7pzwFMo1E2WDZjVFRz5w,CPh4FWsGak1kd1WFEH9qBjNhnun3R2tHtZA57zW8ugn5,True,407720283,101930069,637762,318881,318881,GAUsoe8ZTCiGPm2hYxRPGxcPe5ShNzHK9eE3G2zgRjxd,25510495,147078611,-121568116,625
2022-01-06 09:31:32.582181,2022-01-06 04:27:03-05:00,1781,5Rxuqgs4CaSKbfDXqBMFXkLTQ9dxrUjThXzoy3ouYVtK,BgvbKru66ebrGUcFFymGTmsaQv6GgcGMybiWaXqzBtwX,True,1710588,427647,2668,1334,1334,GAUsoe8ZTCiGPm2hYxRPGxcPe5ShNzHK9eE3G2zgRjxd,106733,719726,-612993,623
2022-01-06 09:31:32.582181,2022-01-06 04:27:43-05:00,1782,36ByQojnxEckWdQTjqHfxKqCx9yjqWQsPsZyqaN72UWR,AZoirtS1fjX61agRM64tqThVinnJTh3BWgiHyNHPTgZP,True,6576906,1644225,10265,5132,5133,3zqXX6kzhkbW3d4TwD2CNjMRwxTbREXySekvq37kfCNk,410616,2536957,-2126341,624
2022-01-06 09:31:32.582181,2022-01-06 04:27:48-05:00,1783,8xvLGVeDmhVYQhN2ZpWkVG9jCrukRsNQ4926a4TMiZqa,9ciBySSjvADwp47WkETiFWZKVTFL8Hf1XvK7aSxhcgQS,True,204854947,51213736,319253,159626,159627,GAUsoe8ZTCiGPm2hYxRPGxcPe5ShNzHK9eE3G2zgRjxd,12770152,53408567,-40638415,623
2022-01-06 09:31:32.582181,2022-01-06 04:27:49-05:00,1784,3ogBPSRcKfmwzgumVDHBkXLi1eCsEFG2xzSJgD4LQDNy,7TXyqWgJqfe71MSWFA2n7ufZbUdzf7JJoWej8FNNtMXo,True,173200579,43300144,267283,133641,133642,72FwbpFGoLEazJEdpqNtPNefsadUrimUqma9wSoy4qiS,10691344,39680610,-28989266,617
2022-01-06 09:31:32.582181,2022-01-06 04:28:34-05:00,1785,G5NLYTLxDZfJFKsJdMeWS8Ez95ZFwR5AX4hKhnfVJvoE,AwrC3pKhTeEDr1HCTWoKWjadteZccvqcisbC7vxTjn7w,True,104551890,26137972,163467,81733,81734,GAUsoe8ZTCiGPm2hYxRPGxcPe5ShNzHK9eE3G2zgRjxd,6538682,40688999,-34150317,625
2022-01-06 09:31:32.582181,2022-01-06 04:30:03-05:00,1786,JDeYjCLpfnzcfxDFgHf4aBcHsajwdR14GUaKAA9euzVf,EJbvKoyMZcoCx4vWa61uMbW2vr6mUhrgEuECdteVBuZZ,True,63752230,15938057,99748,49874,49874,4BnQKPLuE3DMTtxp8MjUBytgnhvxqq3ZTqZHTVZo4JJh,3989938,26549413,-22559475,625
2022-01-06 09:44:02.079318,2022-01-06 04:35:22-05:00,1787,8xQ3tsWVUe75EG1HmocULJ3kh52utveoFMEPotTGrKno,i3SKW3ywrwYucX9ySEx1C4zaUKGnzLerP3V38437NyV,True,483514857,120878713,754935,377467,377468,GmqQKnMfFxkv6ChqGaZ2wmSFDow7R1x7WeRfU58GVvfw,30197401,150107074,-119909673,624
2022-01-06 09:44:02.079318,2022-01-06 04:35:25-05:00,1788,Bsr6kx1B6BSEd5UnJ7Z61M49iUb3bFrDVhiEtMVtPDF2,3CFd1pUJAJPA9fobwn4Jj2mRju1CWmoop4Mh4znypNWT,True,239320114,59830028,373371,186685,186686,3zqXX6kzhkbW3d4TwD2CNjMRwxTbREXySekvq37kfCNk,14934864,54440867,-39506003,624
2022-01-06 09:44:02.079318,2022-01-06 04:37:01-05:00,1789,6NJFN855M3Q3RLTDNo57gTgAmwPD6G2E3WvMb1m5eNCN,3YpqNnonsvXaRT4nCC3G5FZx1jjVtbDPc36LiR6WK5jR,True,621001989,155250497,966409,483204,483205,3zqXX6kzhkbW3d4TwD2CNjMRwxTbREXySekvq37kfCNk,38656390,253256083,-214599693,622
2022-01-06 09:44:02.079318,2022-01-06 04:38:11-05:00,1790,Dn916KSmX3HqxT53hrxrbCrV3tdRMCPdaoiRLqetMrth,ATCXRiXgnjRRUbSTPBvtBXMENCqsViexSZbZ6aDaXXWA,True,7514581,1878644,11718,5859,5859,3zqXX6kzhkbW3d4TwD2CNjMRwxTbREXySekvq37kfCNk,468751,2440791,-1972040,623
2022-01-06 09:44:02.079318,2022-01-06 04:39:09-05:00,1791,8swGZMrPrLAxZd7MxTbkCL13k3DmAJUw41jCp6Xo6awW,3fKnX7yTNXAT4uMmXVdTy47ALJT8h8YSD3WiBb4BGuzH,True,1894547017,473636754,2955707,1477853,1477854,4BnQKPLuE3DMTtxp8MjUBytgnhvxqq3ZTqZHTVZo4JJh,118228289,545582110,-427353821,624
2022-01-06 09:44:02.079318,2022-01-06 04:39:33-05:00,1792,8E3K7vCHJ2xjdFofPRGLbMxrkm8UYEi926QmXPAFwsqe,4qHUDA1c43Dg4qi1ZPKqmpGYiEMUZ6r4UuzB5ftHCEhW,True,11565970483,2891492620,18096173,9048086,9048087,GAUsoe8ZTCiGPm2hYxRPGxcPe5ShNzHK9eE3G2zgRjxd,723846924,4129364169,-3405517245,625
2022-01-06 09:57:03.849127,2022-01-06 04:54:08-05:00,1793,9WJBnVi84E926j7xEd566WzrZJkPJWRgmEnYj9vyjuad,4dLaFS5F7TGyLdwuJLMGkz3bSL53aHzd9ZfpNmhHxXeF,True,125232503,31308125,195682,97841,97841,GmqQKnMfFxkv6ChqGaZ2wmSFDow7R1x7WeRfU58GVvfw,7827299,44358573,-36531274,625
2022-01-06 09:57:03.849127,2022-01-06 04:54:27-05:00,1794,399591e8XgY52yCMorCQ2WL6dQZTC485ZooHtmGuirhZ,JCiXAooFmKmEPQ2S7C8iSk6CLcTyrPEe1SsPSLyUGySe,True,8724328,2181082,13623,6811,6812,3zqXX6kzhkbW3d4TwD2CNjMRwxTbREXySekvq37kfCNk,544953,3631948,-3086995,624
2022-01-06 09:57:03.849127,2022-01-06 04:54:31-05:00,1795,8kJu5aqVSmW8FSZR9h6F75ftn9V2U9uMLBEKeqRaC855,FhVHByujkvwwtjTVpZ4mqSUqoMoBgeLUc5H7rbz3FgAt,True,720220305,180055076,1124782,562391,562391,GAUsoe8ZTCiGPm2hYxRPGxcPe5ShNzHK9eE3G2zgRjxd,44991286,299813086,-254821800,624
2022-01-06 09:57:03.849127,2022-01-06 04:54:53-05:00,1796,D9VKhnfLLCrntDGFYSfoxFaY76VnHmYZ1ZbyFXdKdibz,2hRCRH2pMDyQGYcXHa8Y6BZo6FbcGZf5VJC1v8Bp6tGa,True,748257370,187064342,1166612,583306,583306,GAUsoe8ZTCiGPm2hYxRPGxcPe5ShNzHK9eE3G2zgRjxd,46664493,180862623,-134198130,623
2022-01-06 09:57:03.849127,2022-01-06 04:55:15-05:00,1797,9KD2AifD5wFD4QkHYuawXbJgLWHrfj2QPF3fT8jhGVA5,Ga9gAqmkuHbqrr31sUFPqa1xa5WNxLWJWGPUaMxQqLdj,True,7910071,1977517,12277,6138,6139,72FwbpFGoLEazJEdpqNtPNefsadUrimUqma9wSoy4qiS,491100,3376745,-2885645,620
2022-01-06 09:57:03.849127,2022-01-06 04:55:20-05:00,1798,3VdSA9CED9f5swRwHX2U15U7J6Muaq8VPnCNy9CaGDHe,2YYstfnfdYic5NWmEbcUEHpccNUVd1EhuCkExvMsoMk8,True,40749261,10187315,63545,31772,31773,3zqXX6kzhkbW3d4TwD2CNjMRwxTbREXySekvq37kfCNk,2541823,17127640,-14585817,623
2022-01-06 09:57:03.849127,2022-01-06 04:56:00-05:00,1799,7jvKp6onXyWgwsFrFWj4hYTXJsYYD6ot5mn6rPFuJriy,J7N6HiozevJVTiY9hDEUs2ud5BwT5QSE7wnMBS1w5ie2,True,255411920,63852979,394501,197250,197251,GAUsoe8ZTCiGPm2hYxRPGxcPe5ShNzHK9eE3G2zgRjxd,15780065,98304894,-82524829,617
2022-01-06 09:57:03.849127,2022-01-06 04:56:00-05:00,1800,2VyFcgZDH1HTEvD1XaWhwqBCMmZ1k6TmZ3fEpPcBZR9E,G1wFJETTpdoc7CfypGCzkq1jssXPfUkiuLjK2cwVZ9dJ,True,631214,157803,985,492,493,3zqXX6kzhkbW3d4TwD2CNjMRwxTbREXySekvq37kfCNk,39413,220782,-181369,624
2022-01-06 09:57:03.849127,2022-01-06 04:56:01-05:00,1801,8trkirSQNdMmAcJdeswxs5cPjH8dD6U4eJtWiAdMsrDB,HaSzpQ45x2MipfN17U6jGBxX8tXboomVDhXNSrnEfLDr,True,26988013,6747003,42109,21054,21055,3zqXX6kzhkbW3d4TwD2CNjMRwxTbREXySekvq37kfCNk,1684372,7437699,-5753327,624
2022-01-06 09:57:03.849127,2022-01-06 04:56:11-05:00,1802,9gYrMXAGmGSV4VFjXzYP5WwH2aFpB1TxA6CqpYsosKLv,Dh8aH6RK48wu4fkT9xKw5XL7itxnPDuw3SDwPwvL5sva,True,208738,52184,326,163,163,4BnQKPLuE3DMTtxp8MjUBytgnhvxqq3ZTqZHTVZo4JJh,13057,54882,-41825,625
2022-01-06 09:57:03.849127,2022-01-06 04:56:16-05:00,1803,2jDRvE3pQNjWy1NRFa4tzB3KmU5UkbUCHw8sQRFujo66,C4zNi2szDrEEh4coTF3WRUghfP4ZwAVVSYTLWfkejQRu,True,3908220025,977055005,6108642,3054321,3054321,GAUsoe8ZTCiGPm2hYxRPGxcPe5ShNzHK9eE3G2zgRjxd,244345682,884438257,-640092575,625
2022-01-06 09:57:03.849127,2022-01-06 04:56:20-05:00,1804,5Rxuqgs4CaSKbfDXqBMFXkLTQ9dxrUjThXzoy3ouYVtK,BgvbKru66ebrGUcFFymGTmsaQv6GgcGMybiWaXqzBtwX,True,1257271,314317,1959,979,980,3zqXX6kzhkbW3d4TwD2CNjMRwxTbREXySekvq37kfCNk,78395,563811,-485416,623
2022-01-06 10:10:31.392598,2022-01-06 04:57:02-05:00,1805,ECuu1L4QGdemZ7FjAjVAAxYN6piinweY7Fuk5csVovfT,Amd8WGcpdtB8yoA83R1BUT5uryuqoKbcBexYacbrbGVX,True,24054326,6013581,37611,18805,18806,4BnQKPLuE3DMTtxp8MjUBytgnhvxqq3ZTqZHTVZo4JJh,1504463,5468300,-3963837,625
2022-01-06 10:10:31.392598,2022-01-06 04:57:42-05:00,1806,BxXXWywnC3dSyLPJHt7owfBhgSiBWzkuD3T8hGYLqCH6,4vuwEBXXbXFMPmbJJJRop4FCWGyKR1sXhBc3EWF6MiB8,True,749536677,187384169,1170260,585130,585130,GAUsoe8ZTCiGPm2hYxRPGxcPe5ShNzHK9eE3G2zgRjxd,46810417,297985539,-251175122,624
2022-01-06 10:10:31.392598,2022-01-06 04:57:47-05:00,1807,7W6ih2ZGXaE6tvuQFUPCvc7NvEJHy7UffgoVX3ZPdLXt,6uQCkeMjEXHBQxE2HD33RM1zyTsSko1fYZA1mWUggJ5B,True,202431,50607,315,157,158,4BnQKPLuE3DMTtxp8MjUBytgnhvxqq3ZTqZHTVZo4JJh,12620,56008,-43388,623
2022-01-06 10:10:31.392598,2022-01-06 04:58:34-05:00,1808,AGhvB6x3gmvAJSnr9UVtvhKqVg3Qgh1k4roHzrNHhAaa,HhhjXT6WJnz1HQfHcwKdBppuAhc8ncUcq1mkJ4EHqgpe,True,49688,12422,77,38,39,3zqXX6kzhkbW3d4TwD2CNjMRwxTbREXySekvq37kfCNk,3109,13852,-10743,625
2022-01-06 10:10:31.392598,2022-01-06 04:58:38-05:00,1809,HhwiZPKZBGa16oVi739s4qtMDMTwzWXc7iwNfX63t2UP,5AnbMbAFKy85yHt5y2M5S38nNkA1vT4ejY5NjGbRNUqn,True,10891640,2722910,16983,8491,8492,3zqXX6kzhkbW3d4TwD2CNjMRwxTbREXySekvq37kfCNk,679355,4803261,-4123906,623
2022-01-06 10:10:31.392598,2022-01-06 04:59:25-05:00,1810,GjQQ2fQ7mrGjWZwjVYFUKp9NM1LmfkhEo675ovU5SPa8,ECgVUMRY5nB4MALs5drDyipF7YohCPuJpj2UegCs7HMn,True,178665028,44666257,278672,139336,139336,3zqXX6kzhkbW3d4TwD2CNjMRwxTbREXySekvq37kfCNk,11146914,46150568,-35003654,623
2022-01-06 10:10:31.392598,2022-01-06 05:00:01-05:00,1811,3njiRuSRMXRzKmamyiR72Hc38PU8UDDmWdfPhgxmGxEW,5WoF3gkgygyNNbwxWgVfqGWkExcDixuzgJQQjXEZQ6J5,True,2003523053,500880763,3133105,1566552,1566553,GAUsoe8ZTCiGPm2hYxRPGxcPe5ShNzHK9eE3G2zgRjxd,125324228,1024933247,-899609019,625
2022-01-06 10:10:31.392598,2022-01-06 05:00:02-05:00,1812,5jin5wXjQQ25nGM2ECrCXcg1a95vquh6kM7rMRru6Ke7,EKM657EQ8HWWgf4cssByoYHoXGjFfTspTKXAGmygAPQG,True,295395075,73848768,458066,229033,229033,GAUsoe8ZTCiGPm2hYxRPGxcPe5ShNzHK9eE3G2zgRjxd,18322656,99029835,-80707179,620
2022-01-06 10:10:31.392598,2022-01-06 05:00:04-05:00,1813,GH6Q9E1jZPTTp46aDd57UNZPNS2D6PBSwyLL3EHSjGn2,2XvwZXNsrPWx4EfPvhTP933bzCC3SJHDQ8xARfrXdVY9,True,155092501,38773125,239474,119737,119737,3zqXX6kzhkbW3d4TwD2CNjMRwxTbREXySekvq37kfCNk,9578973,101424981,-91846008,617
2022-01-06 10:10:31.392598,2022-01-06 05:00:05-05:00,1814,6u6bPgAmK8ufACrQV99A1Y5nhGkue3KEUHmQQkcNkxwP,7636yXT5w4DcVpc7LJdN46aiggzSq6U2GXHXL5kyy9F3,True,931507439,232876859,1447612,723806,723806,4BnQKPLuE3DMTtxp8MjUBytgnhvxqq3ZTqZHTVZo4JJh,57904515,311186725,-253282210,621
2022-01-06 10:10:31.392598,2022-01-06 05:00:08-05:00,1815,5PbrpM9kjzF4R2eW2UTcRVXnhqWdRQWHZJXKLN43N8WC,6ip4ocbyHusy8CsVvcrpiRCUp2nq9cY8bHpTcUU3Wztq,True,62192627,15548156,97141,48570,48571,4BnQKPLuE3DMTtxp8MjUBytgnhvxqq3ZTqZHTVZo4JJh,3885671,17623097,-13737426,624
2022-01-06 10:10:31.392598,2022-01-06 05:00:08-05:00,1816,HdfQweV1KuYSpWdycZbpGrUc8yMcY3ZczLn1agKXMJaf,G1Ae1PZHkANkwFnhUKS1tvdFEv8dAFeojBkezh6rUNMh,True,43668372,10917092,68328,34164,34164,3zqXX6kzhkbW3d4TwD2CNjMRwxTbREXySekvq37kfCNk,2733121,14491143,-11758022,625
2022-01-06 10:10:31.392598,2022-01-06 05:00:14-05:00,1817,6dr65yANjSMmfBeKAuSxG3i16S9vMgF1CQ3zDyzh55Pn,EhrE5QpnshD41S4zPEBy2A5q2Gs2mwUrbHGo6WnT9zDP,True,2627470,656867,4111,2055,2056,GAUsoe8ZTCiGPm2hYxRPGxcPe5ShNzHK9eE3G2zgRjxd,164453,911986,-747533,625
2022-01-06 10:10:31.392598,2022-01-06 05:00:16-05:00,1818,GGGyesjbt7h2XHHp9u8vpiWGugFwEbrtYaKrNQSDhQd7,8tydo1ZjGHmPBSqU33tywB3f9szdsHk1ckGFe4Ay5pgs,True,396429340,99107335,619843,309921,309922,3zqXX6kzhkbW3d4TwD2CNjMRwxTbREXySekvq37kfCNk,24793727,226104841,-201311114,625
2022-01-06 10:10:31.392598,2022-01-06 05:09:11-05:00,1819,3Lv2XpiD4KBUHq7Zx6u3zNhpXoySodXHH8o8f5yaaPxG,H6TN4rhpBXkEH3mZnymYNcKfmnxRH2uzfwzeLH2q6ahP,True,1466403,366600,2293,1146,1147,3zqXX6kzhkbW3d4TwD2CNjMRwxTbREXySekvq37kfCNk,91745,416709,-324964,625
2022-01-06 10:32:02.018626,2022-01-06 05:13:54-05:00,1820,6CeKxTJvFqhyNEyzySiBBKEwYVMe7j3A6nkMes4BW6o2,DzDR9XvwY1z7ygQ8YrCXrwDGHSf67JZF8BzUnuFE2fxQ,True,34360443,8590110,53745,26872,26873,4BnQKPLuE3DMTtxp8MjUBytgnhvxqq3ZTqZHTVZo4JJh,2149806,7779363,-5629557,625
2022-01-06 10:32:02.018626,2022-01-06 05:13:54-05:00,1821,FpqCxvTkSiwDwD5qEt6hXJxzFDLFLAQ8VevK8zwRqYun,A3p6YQisCJKpNkF7vkjZRbEfbnUt7vTZdR2zPBUSdTkk,True,3221976892,805494223,5037874,2518937,2518937,4BnQKPLuE3DMTtxp8MjUBytgnhvxqq3ZTqZHTVZo4JJh,201514993,729673463,-528158470,625
2022-01-06 10:32:02.018626,2022-01-06 05:14:14-05:00,1822,8MKNsuGVaoYpdQy6NNyxDvRzh2DAquBUtri4nDsixUxs,D7M1SDmpZAs8vdPCCCa96UbDF15YQDxHmoGWB57tHiir,True,32486730,8121682,50645,25322,25323,3zqXX6kzhkbW3d4TwD2CNjMRwxTbREXySekvq37kfCNk,2025811,11709598,-9683787,623
2022-01-06 10:32:02.018626,2022-01-06 05:14:20-05:00,1823,C2Dmfw4G8KKzFq38aRH2pLCRngnGZDvUUN3fHDMjFkoG,7kzJk3BTNvY3hGFNj7nDy9L5CAYus6eNiCAxWH8dSioX,True,2912200,728050,4547,2273,2274,3zqXX6kzhkbW3d4TwD2CNjMRwxTbREXySekvq37kfCNk,181887,1277393,-1095506,624
2022-01-06 10:32:02.018626,2022-01-06 05:14:21-05:00,1824,DAku12iueL13vRoTpKLyqdGaLQ2rWF6REe8Dr8soFvNs,H2vVH3LxkhGe6x6Mdwy67BYwTKNQM6XayKx7mhrwyfJM,True,3499285,874821,5468,2734,2734,3zqXX6kzhkbW3d4TwD2CNjMRwxTbREXySekvq37kfCNk,218731,1219449,-1000718,625
2022-01-06 10:32:02.018626,2022-01-06 05:14:32-05:00,1825,6eBSLXDMVoW2nG3n7s42RXDH8byY3C6n1RsUuegBLSrG,37dYrKnTXYer7Bu9xFfpArA4ZNo2B9bycFw9HywDtTRx,True,77802888,19450722,121732,60866,60866,3zqXX6kzhkbW3d4TwD2CNjMRwxTbREXySekvq37kfCNk,4869283,24972117,-20102834,625
2022-01-06 10:32:02.018626,2022-01-06 05:15:05-05:00,1826,Fd2HrzBAr4JobRPARZwpQHHVoSCEoog32A6tKMWAC1sK,BYappsar5sQf8VLem4wrLuTtrDFH9y8pEx1aMxfuU4Pq,True,236158113,59039528,369369,184684,184685,4BnQKPLuE3DMTtxp8MjUBytgnhvxqq3ZTqZHTVZo4JJh,14774776,79116189,-64341413,625
2022-01-06 10:32:02.018626,2022-01-06 05:15:05-05:00,1827,2FrqGFZjbiNykJyo9BZ5S9FguQJPJiTi681rJJsQ5dta,3QUncYP92NKrfpaTvuF9iQg11PXKgZAgEngwh6BbnCCj,True,6477419,1619354,10135,5067,5068,3zqXX6kzhkbW3d4TwD2CNjMRwxTbREXySekvq37kfCNk,405427,1738824,-1333397,625
2022-01-06 10:32:02.018626,2022-01-06 05:15:32-05:00,1828,F2v1YwVAwXLiUgsJ5uwn4qAAkTXitn1E75fJcPnGuAcy,5rdJ4H5GxPg4Juu77mGc7uya5LwEqLzDSRyG8mQ2mDbK,True,151178277,37794569,235253,117626,117627,GAUsoe8ZTCiGPm2hYxRPGxcPe5ShNzHK9eE3G2zgRjxd,9410155,50706527,-41296372,622
2022-01-06 10:32:02.018626,2022-01-06 05:15:32-05:00,1829,8NdcaYUC1X5CP7FMDip78uqtqmCt8GcZdCzLRTYTihmb,9Ei1K9bXWXSXcBfeX5exPSXGCAu62WSKzvnnd4wHvyVh,True,1029937,257484,1602,801,801,GAUsoe8ZTCiGPm2hYxRPGxcPe5ShNzHK9eE3G2zgRjxd,64105,299558,-235453,622
2022-01-06 10:32:02.018626,2022-01-06 05:15:32-05:00,1830,8RmB8o4zux2sD48dEsKpsX475KRxTwdk8QULUDU9xx8R,AKSiZnb4YKVB6B86aPPqvyXquhvN9xqt45bexBCZ7nx,True,496667835,124166958,774423,387211,387212,GAUsoe8ZTCiGPm2hYxRPGxcPe5ShNzHK9eE3G2zgRjxd,30976922,200752226,-169775304,623
2022-01-06 10:32:02.018626,2022-01-06 05:15:33-05:00,1831,EmGW2aAG69ssWqCtbfDocRaM2u3TJsczn2HHP9jdmRvD,aypkDKsp9uqAB4F6mwvm5LofpsrFBuZT2MMWtE2eHdB,True,5062082,1265520,7915,3957,3958,4BnQKPLuE3DMTtxp8MjUBytgnhvxqq3ZTqZHTVZo4JJh,316634,1582042,-1265408,625
2022-01-06 10:32:02.018626,2022-01-06 05:20:34-05:00,1832,6tFQaTqqffino9kwMZTL2xVNBG8k9VREFhXqVi2si3A3,3w3wGxBbS4bmXeqmvd595SAWFeXekVpnH4UdbeEs8Sx5,True,34360305,8590076,53733,26866,26867,GAUsoe8ZTCiGPm2hYxRPGxcPe5ShNzHK9eE3G2zgRjxd,2149357,7779052,-5629695,625
2022-01-06 10:32:02.018626,2022-01-06 05:20:35-05:00,1833,AHm7zF4rpaxaayBLn5QDHgJSp8KAr647s4cNvQ9wLgd7,FDM33WngED24pukBvSDpPAzinW6afVAeGReum5nyLRiC,True,6490588,1622647,10132,5066,5066,4BnQKPLuE3DMTtxp8MjUBytgnhvxqq3ZTqZHTVZo4JJh,405303,2278928,-1873625,624
2022-01-06 10:32:02.018626,2022-01-06 05:20:35-05:00,1834,ANQkPUoMjLHyRtypeKzxsKW1DFauQsh9SnB3rRgRXM1Y,7RHAExWpG8Q3PXwKhJs2yXmYK9WogGydvFYpx28p6pgr,True,569026041,142256510,888880,444440,444440,4BnQKPLuE3DMTtxp8MjUBytgnhvxqq3ZTqZHTVZo4JJh,35555238,234129216,-198573978,624
2022-01-06 10:32:02.018626,2022-01-06 05:20:39-05:00,1835,6yw4GPvkqUbakcEWtqSCfjVLukty11xqjDpGxtEN9Km2,5ppEx7wkpqbG5nApCWMdRja3oRSheFmAAsNHUX7h2w2Y,True,12943590,3235897,20191,10095,10096,GAUsoe8ZTCiGPm2hYxRPGxcPe5ShNzHK9eE3G2zgRjxd,807650,8837065,-8029415,623
2022-01-06 10:32:02.018626,2022-01-06 05:20:58-05:00,1836,E8ifvhmyJGBGVQomo3AnZw2UcaLHcpGsTtuoCid8voU3,FMQUWTbTAfSLfrc6GTrz4DM2ZSgoxF3KtqGn8AyjVtsf,True,55712287,13928071,86259,43129,43130,3zqXX6kzhkbW3d4TwD2CNjMRwxTbREXySekvq37kfCNk,3450384,12371897,-8921513,619
2022-01-06 10:32:02.018626,2022-01-06 05:20:59-05:00,1837,8sneA6wAg6geVDJ1g7YWg4R1PfjuRVzeHp1nUBJinhZa,14i1uWtmcTjrdbg3DSr9vzd5NBnxqsn1A4QdgFBZqeYM,True,951487,237871,1480,740,740,4BnQKPLuE3DMTtxp8MjUBytgnhvxqq3ZTqZHTVZo4JJh,59230,276924,-217694,622
2022-01-06 10:32:02.018626,2022-01-06 05:20:59-05:00,1838,9UyQC8vc6zJJaSdnjvTAzgmcsw4fC3xFBBiCC1w9Sbjx,3ppBfboe6FPmt7f6WrivspMUoAznZKWQMeh3rCgw7vjQ,True,70159591,17539897,108852,54426,54426,4BnQKPLuE3DMTtxp8MjUBytgnhvxqq3ZTqZHTVZo4JJh,4354110,14186439,-9832329,620
2022-01-06 10:32:02.018626,2022-01-06 05:21:08-05:00,1839,HAk9c831TRUhvpoK4d7PTqfJuJhSjnJUXWpnYsH85bDJ,DVSa3CJrVLTHAeFYjEF89ZjWRm86QwruUk2Y8RvGpjsr,True,190259,47564,297,148,149,4BnQKPLuE3DMTtxp8MjUBytgnhvxqq3ZTqZHTVZo4JJh,11887,62441,-50554,624
2022-01-06 10:32:02.018626,2022-01-06 05:21:08-05:00,1840,67Z7ZGhNu5xxEh9BYKWcXp9m1T4tFiE1o1M16hCzUWQA,CT7YKWixz7BhTbvg5F6M5HCyPGnHoFLNFuDV9GhoLTo3,True,25581544,6395386,39972,19986,19986,4BnQKPLuE3DMTtxp8MjUBytgnhvxqq3ZTqZHTVZo4JJh,1598891,10553176,-8954285,625
2022-01-06 10:32:02.018626,2022-01-06 05:21:08-05:00,1841,CvZssqscu2dm35mwcE3zg9zedavbRjVJjWD59Py5ExUK,7pXaoR6aHKYofCmg1eHipygNYDteEaf8rbbS8BDYGQK6,True,5510140,1377535,8616,4308,4308,GAUsoe8ZTCiGPm2hYxRPGxcPe5ShNzHK9eE3G2zgRjxd,344663,1248376,-903713,625
2022-01-06 10:32:02.018626,2022-01-06 05:21:28-05:00,1842,pgzvXpnUYiY7hLrfjmwScqLd8oj9vYcXpFvpm4y4JvG,GdqdQgoyBAFuXdbvoZyDhB3jyqJzVo4nkGh7EPFxkBF2,True,16594861,4148715,25944,12972,12972,4BnQKPLuE3DMTtxp8MjUBytgnhvxqq3ZTqZHTVZo4JJh,1037776,11413733,-10375957,625
2022-01-06 12:30:44.299506,2022-01-06 07:29:41-05:00,1843,7CSCMFa9W52tBDVUbXbc3woAy3GByeA1wPJdp3MgznPa,3447ptuVFu6G8B6N63RmS8mRv4n9PfHneypHLvbeaGLn,True,868787977,217196993,1357618,678809,678809,3zqXX6kzhkbW3d4TwD2CNjMRwxTbREXySekvq37kfCNk,54304755,268854544,-214549789,625
2022-01-06 12:30:44.299506,2022-01-06 07:29:54-05:00,1844,CRaKcudjkQiSw5YPVjTLVdXvJskeGiHSYtq5ZcMPJhgQ,AgqTg3b3bAcaBmRidhNC4Uf9ZwNbeH52RQEqumWyuUs7,True,6811908,1702977,10613,5306,5307,3pStmNaV47N2sqUtHJHLAtCKiN9JZ6jzNY9h94ng8G1D,424528,2997327,-2572799,623
2022-01-06 12:30:44.299506,2022-01-06 07:29:55-05:00,1845,FhAt6pZW3k8StP9VLeWUfidpXfRLoKWdV7Wgxdh9cRy9,Guk93pTo3KcG8konHjJ52oi9rgexmmKhPQAkxZS1BtCG,True,1428701124,357175280,2234683,1117341,1117342,DddJ7EWCmYEEZETCBNgAUSg81Ls6fZtiAaY5ekJ5sXx1,89387342,438004226,-348616884,625
2022-01-06 12:30:44.299506,2022-01-06 07:29:59-05:00,1846,M69XSefqeum2arinvHEqmA3L2XHWNFN17p4msRhRZXf,2vK15yYUANLSbAoiBfgJ9VLyqsmtEpd2iNytQjms8GaQ,True,2131498462,532874615,3333908,1666954,1666954,HfEnetJ7uBSmZWCjBNxdvv9HEC5nsW4wDV7wu6WnhWan,133356337,992857875,-859501538,625
2022-01-06 12:30:44.299506,2022-01-06 07:30:04-05:00,1847,BAzH5niE2GX9CHGn3jK6Wv8Dd59PT95dX4dgfZXWoLPT,YNRnuEoNBPFsr7W91gc85TXAdA4ZnXfF2x951zbeRKF,True,177261,44313,277,138,139,DddJ7EWCmYEEZETCBNgAUSg81Ls6fZtiAaY5ekJ5sXx1,11084,59267,-48183,625
2022-01-06 12:30:44.299506,2022-01-06 07:30:05-05:00,1848,Ckqos6cdncPKj13DnCmDVZsZTqp6eS7277CRrT9WhcEr,AtUV8m7VQJvZq7GLCAHMf3jV7iamKEPnWVZHWuuVZQp1,True,9765599,2441399,15237,7618,7619,DddJ7EWCmYEEZETCBNgAUSg81Ls6fZtiAaY5ekJ5sXx1,609483,4296408,-3686925,624
2022-01-06 12:30:44.299506,2022-01-06 07:30:07-05:00,1849,9vcKW1GfrDZ3KLPh2pEVFF8ZyKqD1pJW1hiE8H98Av7S,C6Ki27mo4sCHu6u8UnR1p7WSgsTjFQxGGR9Lk9n5Rhjq,True,21836243,5459060,33774,16887,16887,GAUsoe8ZTCiGPm2hYxRPGxcPe5ShNzHK9eE3G2zgRjxd,1350994,7216362,-5865368,618
2022-01-06 12:30:44.299506,2022-01-06 07:30:07-05:00,1850,BQBQicboM5o25LihnffqxcJmoPoA3mgBKNeG4H8UTHVh,E8rJFAs7dbDmQA1o5aTeNqdmADxWMd5cDzvwAGMFFCix,True,11884859,2971214,18481,9240,9241,3zqXX6kzhkbW3d4TwD2CNjMRwxTbREXySekvq37kfCNk,739244,7292628,-6553384,622
2022-01-06 12:30:44.299506,2022-01-06 07:30:07-05:00,1851,CBL2NbekJrXvBiAcoj4fzQ4PfLDwTntW7Zt4nruHFYEw,59EvfgYTdKkfjUJz5LddLUAqbEdLaihcMzjcrTZsyzyS,True,73540,18385,114,57,57,4BnQKPLuE3DMTtxp8MjUBytgnhvxqq3ZTqZHTVZo4JJh,4560,20254,-15694,620
2022-01-06 12:30:44.299506,2022-01-06 07:30:07-05:00,1852,HVZkXeDR3mc8oB9qFFwCK4RXpPojdcHk9tRGep6xtKGK,Bh3py7awPejWqeTMxtAgF7mPotL2Asxf8YrYJykq9nBt,True,51834790,12958697,80470,40235,40235,4BnQKPLuE3DMTtxp8MjUBytgnhvxqq3ZTqZHTVZo4JJh,3218837,14669976,-11451139,620
2022-01-06 12:30:44.299506,2022-01-06 07:30:11-05:00,1853,6oroGB3mvzK3tDfiB9X2NJuL3x476pxhgRnt7VxqhdLo,2SoK8tKkLn2ppKURpTVazKsCEis4uahkHMsac1m85J4r,True,14081245,3520311,21844,10922,10922,4BnQKPLuE3DMTtxp8MjUBytgnhvxqq3ZTqZHTVZo4JJh,873791,9290273,-8416482,620
2022-01-06 12:30:44.299506,2022-01-06 07:30:12-05:00,1854,3qnPsgqW11AcDEmyjmJquPcPLyE3EdJQuVLJ5kinDrd3,86rZadBB7emKio76aFTahpbrFtxd9tqZ4Mxgzaavq2xU,True,1241773,310443,1930,965,965,3zqXX6kzhkbW3d4TwD2CNjMRwxTbREXySekvq37kfCNk,77208,354187,-276979,621
2022-01-06 12:30:44.299506,2022-01-06 07:30:14-05:00,1855,7PzGZgzieFyyFs1dbajkNQgVxooFUNZrj1bUsQvrSwbp,A2gDREmSmJTBPPw3sbKVY3smC9wbHMDdv87gr4Tr2ES7,True,22352522,5588130,34868,17434,17434,4BnQKPLuE3DMTtxp8MjUBytgnhvxqq3ZTqZHTVZo4JJh,1394743,6382538,-4987795,623
2022-01-07 00:51:58.641067,2022-01-06 19:49:45-05:00,1856,B4Uc39nKzz9wBRQsCkMR4A7RwTJ8rSuwpR6EQn2AesRb,H49bGZgatRZVpj6QufZRVgYrQtH7LpdbiqKBs23151m,True,203425956,50856489,315843,157921,157922,GAUsoe8ZTCiGPm2hYxRPGxcPe5ShNzHK9eE3G2zgRjxd,12633726,141449879,-128816153,621
2022-01-07 00:51:58.641067,2022-01-06 19:49:45-05:00,1857,ymyzGH4Qc7HH5PbKpVphCbsQgLLXyGkPcXamQJuNj5C,8oTLHaV2XzbKXNWRuUjCfHjUn61Pw93LYK14m9q2VDpZ,True,108108957,27027239,167764,83882,83882,GAUsoe8ZTCiGPm2hYxRPGxcPe5ShNzHK9eE3G2zgRjxd,6710584,26086783,-19376199,620
2022-01-07 00:51:58.641067,2022-01-06 19:49:46-05:00,1858,2FEbsetZMkRqLjSC8GBbgecKgX5T1T1fci2sLQux29p8,H722Fcd6DkTFRZxqQWbPDufBfXEgmFfhiEpQZWhxwYv1,True,37974536,9493634,59197,29598,29599,GAUsoe8ZTCiGPm2hYxRPGxcPe5ShNzHK9eE3G2zgRjxd,2367887,9385872,-7017985,623
2022-01-07 00:51:58.641067,2022-01-06 19:49:46-05:00,1859,GqAS41YJssg9aaEp3hs3sG98APCsXhiQBQszXaSjZ2bN,2wodJ3AhrXdE1T4oVL95KvoBND7PubG5Wd5GWiLCMZJU,True,1492850507,373212626,2323886,1161943,1161943,GAUsoe8ZTCiGPm2hYxRPGxcPe5ShNzHK9eE3G2zgRjxd,92955460,932289376,-839333916,622
2022-01-07 00:51:58.641067,2022-01-06 19:49:50-05:00,1860,HGJoZvLakWfSDFwuvShNBc4kCf7nP7VqzyM3mELpbFEf,12Qn5jin7QvsBngXqYAv4UstyG3b6nRf1jsLp9Dp8G7k,True,127473125,31868281,198553,99276,99277,GAUsoe8ZTCiGPm2hYxRPGxcPe5ShNzHK9eE3G2zgRjxd,7942144,38657664,-30715520,623
2022-01-07 00:51:58.641067,2022-01-06 19:49:50-05:00,1861,CagSUfZLwXuCdypC4KzU6FSNdmCj9dKDroPcNeaRtsyt,yxw5d1ztZuEUY2QjL7eLpr72QJAj5rJd6ERvg91cy1m,True,12713310,3178327,19755,9877,9878,DddJ7EWCmYEEZETCBNgAUSg81Ls6fZtiAaY5ekJ5sXx1,790224,3069342,-2279118,621
2022-01-07 00:51:58.641067,2022-01-06 19:49:50-05:00,1862,BrHRMouGRz3LBNzd9anfdYMhWfg8yUPHL4PqJ8WdEDFS,4uzoLa3mC2VYHAPBoHLX4gTjPTC28rPf2fvEGtJWPYc,True,478286410,119571602,744046,372023,372023,GAUsoe8ZTCiGPm2hYxRPGxcPe5ShNzHK9eE3G2zgRjxd,29761873,296460205,-266698332,622
2022-01-07 00:51:58.641067,2022-01-06 19:50:27-05:00,1863,BYvjENe16Ta77PqGV7JKEWrsqCTfkMGYwTSG5gXneDvd,EvxAXgvhPC6QkNurbK7vWyTApGo8J2R4EgMAknkHVU3d,True,24289233,6072308,37922,18961,18961,4BnQKPLuE3DMTtxp8MjUBytgnhvxqq3ZTqZHTVZo4JJh,1516911,10974293,-9457382,624
2022-01-07 00:51:58.641067,2022-01-06 19:50:29-05:00,1864,BPsM1um9ZJf7eNoVMsQCRSwgARMuLCGGSDxf9tZeNeEy,BpzDdXfxVygiSYSmsHV6uPxQMeTFtrURMCCqhswQjd5X,True,9472249,2368062,14733,7366,7367,3zqXX6kzhkbW3d4TwD2CNjMRwxTbREXySekvq37kfCNk,589342,2365962,-1776620,622
2022-01-07 02:00:32.266564,2022-01-06 19:59:00-05:00,1865,FV9CBGGTbppLnBKh79f2LzD1diTiS5g6u89FcpZHZmnK,Fe7mtmCUziFqbbYTvrhAcAq1Ub7YLfTJRtQ1hG7GzJD1,True,42723286,10680821,66386,33193,33193,3zqXX6kzhkbW3d4TwD2CNjMRwxTbREXySekvq37kfCNk,2655472,10572212,-7916740,621
2022-01-07 02:00:32.266564,2022-01-06 19:59:04-05:00,1866,CwTus4FyoXYqyTKAYDp69NLhA1joYZ3tarzY6FFTr6fn,6ivuvYWU6i25MzJSY8rG9rPDKiq38E6QtrV1jvRubLGr,True,82212,20553,128,64,64,GAUsoe8ZTCiGPm2hYxRPGxcPe5ShNzHK9eE3G2zgRjxd,5120,24006,-18886,622
2022-01-07 02:00:32.266564,2022-01-06 19:59:04-05:00,1867,6Bq55LtGCEeGqh4JrFLCmmGc2iJfTTBJixivqH78aGSE,DSNrCgWJeNe2P9tAQu5FvCueTzNKDKds7wzuwTQSMRG,True,53939024,13484756,84245,42122,42123,GAUsoe8ZTCiGPm2hYxRPGxcPe5ShNzHK9eE3G2zgRjxd,3369826,13045841,-9676015,624
2022-01-07 02:00:32.266564,2022-01-06 19:59:05-05:00,1868,3WcJUt8jQ1ngL3ZCGo6dFrc3GmTMTYtzeDva7mri2Tqx,HeG1Pz2oMjqtkfsRMsbqP3VpatnVEQzcWmKDVoFp4Htr,True,127477470,31869367,198353,99176,99177,HfEnetJ7uBSmZWCjBNxdvv9HEC5nsW4wDV7wu6WnhWan,7934138,38645314,-30711176,622
2022-01-07 02:00:32.266564,2022-01-06 19:59:05-05:00,1869,DR7XL3qweFyTKDatQYS2LacqGLv2368cnGuWpEpk4hSL,Fd3BYCiiQfThDJsxBUNwYTMP8eNCrnXMVzE1wpejJqXa,True,37463,9365,58,29,29,3zqXX6kzhkbW3d4TwD2CNjMRwxTbREXySekvq37kfCNk,2327,13648,-11321,621
2022-01-07 02:00:32.266564,2022-01-06 19:59:06-05:00,1870,6rb3fRVWJ5cSzFcmuC1YwdrNxiNctvboDF7HwsfyGoCA,H6JaYfFZkRk6iSJrA4nVeuFpMVQtVwQZHVgK1TyaupTE,True,340768,85192,530,265,265,4BnQKPLuE3DMTtxp8MjUBytgnhvxqq3ZTqZHTVZo4JJh,21213,202710,-181497,622
2022-01-07 02:00:32.266564,2022-01-06 19:59:06-05:00,1871,Cs2YxkuqBK1kjoYZbUZdUcxapPbv8oC75trwGgWoCPfG,2PgHQM1GhHykE4bQ1ggueAw2Zs1BFUW5hxvMvr8DojKM,True,446268897,111567224,694340,347170,347170,4BnQKPLuE3DMTtxp8MjUBytgnhvxqq3ZTqZHTVZo4JJh,27773628,181444131,-153670503,622
2022-01-07 02:41:13.615242,2022-01-06 21:12:01-05:00,1872,E1wp3bmkcY3eiEYyGYwhTCsr7BZ7RfPa5DJTZFupcFwj,452hVdYkD5SDDrA6hv6DLPFvyS8PvR2P6DPNScGxWTsW,True,5103793,1275948,7978,3989,3989,3zqXX6kzhkbW3d4TwD2CNjMRwxTbREXySekvq37kfCNk,319139,1542838,-1223699,625
2022-01-07 02:41:13.615242,2022-01-06 21:12:01-05:00,1873,CK3ocyWzXQkJJZQmM6bBK4Nv6Rh3UEufjY6DvNU6gJZy,C924o4GY3p2BHLeAbFbe9SEysXqCUyD8sFu2d4NzkAV7,True,41247553,10311888,64476,32238,32238,4BnQKPLuE3DMTtxp8MjUBytgnhvxqq3ZTqZHTVZo4JJh,2579053,10074023,-7494970,625
2022-01-07 02:41:13.615242,2022-01-06 21:12:01-05:00,1874,2PzBAkdXkrwH9VuoMALumQz86qkW7sSBQtCrHw14JUp3,D5vwWAMHVooobG2sCWv9EwtJrAFZG6cwKH4dfmA98tbt,True,16463050,4115762,25420,12710,12710,3zqXX6kzhkbW3d4TwD2CNjMRwxTbREXySekvq37kfCNk,1016829,4801745,-3784916,617
2022-01-07 02:41:13.615242,2022-01-06 21:12:01-05:00,1875,7vKmhLV45Q5etXhJL5ng8rxWhYSiUCDmAbGnwBPr7zcx,cP6xPeuHLnjr858QK1F9qYn7rJpEbPy7wEJHoju6oV7,True,273953561,68488390,421986,210993,210993,3zqXX6kzhkbW3d4TwD2CNjMRwxTbREXySekvq37kfCNk,16879477,78780701,-61901224,616
2022-01-07 02:41:13.615242,2022-01-06 21:12:01-05:00,1876,DrzTARa7RK8RXoxHZPKCBqYtMC8TAUHRw8SznXRKTa5M,FYANet92VhyXkKZqqBJR4sFxuCftWb68sgQU9VHCdTJk,True,209017,52254,325,162,163,3zqXX6kzhkbW3d4TwD2CNjMRwxTbREXySekvq37kfCNk,13001,57141,-44140,622
2022-01-07 02:41:13.615242,2022-01-06 21:12:01-05:00,1877,5Z3ZFCA65WoWhm3okRuuziEMi7ajGAEHWUFchzBNba5S,FcomdrWidygkxMKzcsY5xELbmwC652uMci648LMTv7AB,True,78708,19677,121,60,61,4BnQKPLuE3DMTtxp8MjUBytgnhvxqq3ZTqZHTVZo4JJh,4872,21958,-17086,618
2022-01-07 02:41:13.615242,2022-01-06 21:12:01-05:00,1878,i7TcF4weYcqgrRdH3GpndbEYxCxfcSfr9JWYrAUg1CF,BkDfknUir7PnSEW8auoB87PytycEFwyX5kT2GY4SGJJL,True,33466434,8366608,51888,25944,25944,4BnQKPLuE3DMTtxp8MjUBytgnhvxqq3ZTqZHTVZo4JJh,2075555,21338413,-19262858,620
2022-01-07 02:41:13.615242,2022-01-06 21:12:01-05:00,1879,7D4rFmGMPKNAF75VRPxHAhSn2wTjiW8jmth1UD22Xqq9,GQ7BrT6vsXu8tHCMm75YdxFR2r9QTCrCUbdPEZBSAg9w,True,303397598,75849399,467273,233636,233637,3zqXX6kzhkbW3d4TwD2CNjMRwxTbREXySekvq37kfCNk,18690925,69294290,-50603365,616
2022-01-07 02:41:13.615242,2022-01-06 21:24:00-05:00,1880,BzSJ77zKaqtBk2cEL1XqFL97zTXXMRHmxtkgtXwCc3C,2g4KXTwy2MPSRQ2khNp1o1rn7CradEr9H4ySYKDoSWN9,True,63935396,15983849,100045,50022,50023,4BnQKPLuE3DMTtxp8MjUBytgnhvxqq3ZTqZHTVZo4JJh,4001819,49025026,-45023207,625
2022-01-07 02:41:13.615242,2022-01-06 21:24:00-05:00,1881,Cb4zhnvig11U4GcC4kqKrnDicGgPhUpfDQB1U7hP3nPa,DiRAMrKqaevGXeXg38KnhaYBERj8tNKU7oWFJvhS32kw,True,1275085,318771,1964,982,982,4BnQKPLuE3DMTtxp8MjUBytgnhvxqq3ZTqZHTVZo4JJh,78582,303498,-224916,616
2022-01-07 02:41:13.615242,2022-01-06 21:24:01-05:00,1882,D3mXrJzhHf8qRaoCKLschUxAFoijFCFuT6bmNZH4W7Cj,9E3Xtqw7TncXWnbhAbFJMtuNmP6WS3ooGuptzyzw7UpA,True,366000,91500,570,285,285,GmqQKnMfFxkv6ChqGaZ2wmSFDow7R1x7WeRfU58GVvfw,22814,152330,-129516,623
2022-01-07 02:41:13.615242,2022-01-06 21:24:01-05:00,1883,9jdfc9GFTecsdRuTjWFGX13niKKmeBxRgtv5j86uhSnU,HLWMShobjSkaLyXrNjgwVaUGVtbtdUSnr1XjqpXn1bLR,True,1853825,463456,2897,1448,1449,3zqXX6kzhkbW3d4TwD2CNjMRwxTbREXySekvq37kfCNk,115886,605276,-489390,625
2022-01-07 02:41:13.615242,2022-01-06 21:24:01-05:00,1884,GaEpNGa8jnwSRvjzzEMYkZe1pKcr2eiZtePrqFxpABjB,5CFZHuyWbJv14zPdX5dSQDREgHrCb4vsFvB6hLiEe3Ji,True,963569,240892,1498,749,749,GmqQKnMfFxkv6ChqGaZ2wmSFDow7R1x7WeRfU58GVvfw,59939,277623,-217684,622
2022-01-07 02:41:13.615242,2022-01-06 21:24:01-05:00,1885,2rCRdyfi65rpxRRmg7knaSb8t55FuPt3h8wF4Fzhy8MM,CLVY5nSG3jTdRo7tRSKgK9DJgW6aswfWKe4tLxzsENmb,True,3985449,996362,6201,3100,3101,4BnQKPLuE3DMTtxp8MjUBytgnhvxqq3ZTqZHTVZo4JJh,248072,972624,-724552,622
2022-01-07 02:41:13.615242,2022-01-06 21:24:01-05:00,1886,HqtTbC1LFreGvgfpZe7nCqkNnh8GHPQKosfmc19zb1yi,E39UNiHNkwQEd5GXkCtTPqSorQSB1kLx8kjzK4jdFoi3,True,1966749847,491687461,3064343,1532171,1532172,3zqXX6kzhkbW3d4TwD2CNjMRwxTbREXySekvq37kfCNk,122573737,669996199,-547422462,623
2022-01-07 02:41:13.615242,2022-01-06 21:24:08-05:00,1887,2NHv3c4ufYGo3xNr6KXymAZJdpfURrNiCKbXZ7s82Vwo,E4NYpYgHTvSG6LqH2bBV9Q1XJ6pAzCp9FLSKMzJmYRrQ,True,163578514,40894628,252989,126494,126495,3zqXX6kzhkbW3d4TwD2CNjMRwxTbREXySekvq37kfCNk,10119574,64392178,-54272604,618
2022-01-07 02:41:13.615242,2022-01-06 21:24:08-05:00,1888,2NdwSLxsGok8PczpCZj9CVX2BymNU5MvHt7hWfGetg2M,8AQbDXeA6mD9QoZBFJcYbnHvZwKNxzA9CCHLAgdSfTA3,True,67420,16855,105,52,53,DddJ7EWCmYEEZETCBNgAUSg81Ls6fZtiAaY5ekJ5sXx1,4215,25766,-21551,625
2022-01-07 02:41:13.615242,2022-01-06 21:24:08-05:00,1889,AKxRtcdpi7gWhAuL8ENj7zhgeQezzEXe9TSANE6bQoRA,2YH4vrU9deP8Cu6E8Hzf8GqKG1yVjv5pdz4FE7r5YKir,True,43292454,10823113,67113,33556,33557,4BnQKPLuE3DMTtxp8MjUBytgnhvxqq3ZTqZHTVZo4JJh,2684526,12290474,-9605948,620
2022-01-07 02:41:13.615242,2022-01-06 21:24:08-05:00,1890,89CkXnSZnr52Zsoh48efv9MQacrkB6GMtrbEpNJSyA2H,HcvRBS4Z22CpYgDNgm4TVF4AVXFDuYzBUAFcdHAwdpg4,True,18962337,4740584,29483,14741,14742,DddJ7EWCmYEEZETCBNgAUSg81Ls6fZtiAaY5ekJ5sXx1,1179334,5392663,-4213329,621
2022-01-07 02:41:13.615242,2022-01-06 21:27:36-05:00,1891,EV21gv8jEvXtmGDoGRNm5LJEvTBccLMZyVDCLsp54jP3,DGxxoU52aQNoUQcxdvQtv2H5q2PhK6TGkLgNSaFgnZrb,True,28169180,7042295,43188,21594,21594,4BnQKPLuE3DMTtxp8MjUBytgnhvxqq3ZTqZHTVZo4JJh,1727557,8564764,-6837207,613
2022-01-07 02:41:13.615242,2022-01-06 21:27:36-05:00,1892,GJ3PbEfPK8jjrPgMmZtvN5fMSSy2dtiiAtZ8wcfgxVuc,FCUDVFb2TjDvehHE8fVBofqSykpb9W6Afc9QeHtj7te7,True,484623405,121155851,733768,366884,366884,3zqXX6kzhkbW3d4TwD2CNjMRwxTbREXySekvq37kfCNk,29350741,200382667,-171031926,605
2022-01-07 02:41:13.615242,2022-01-06 21:27:36-05:00,1893,JCBhqqPQxP1Xc41sSY6e1sQKRstHhe7D1v6rLz4hp3Qp,DWMUq2bMD1jqpxHtyXDFjcAwjA27yyMRe68hGcsK143m,True,43992,10998,66,33,33,3zqXX6kzhkbW3d4TwD2CNjMRwxTbREXySekvq37kfCNk,2668,12383,-9715,606
2022-01-07 02:41:13.615242,2022-01-06 21:27:36-05:00,1894,AtKuDfcFXqWUMnRqQpjedUMTb5CQKLc2zoqEAcQpysKQ,9bPFLYp5TDZruLLDXDYYCiPYcD982iF8xt5rfTkqwNsL,True,70278,17569,107,53,54,4BnQKPLuE3DMTtxp8MjUBytgnhvxqq3ZTqZHTVZo4JJh,4294,19237,-14943,611
2022-01-07 02:41:13.615242,2022-01-06 21:27:36-05:00,1895,8VT2nxz5ZYDJFd9uL2XZwEXxChd9pjuMJNMAcutZubL1,EhAkiRbouzUAWtqQFsN8HEEfi46UVN8H8tyBP7CbgeLe,True,57942,14485,89,44,45,3zqXX6kzhkbW3d4TwD2CNjMRwxTbREXySekvq37kfCNk,3593,19582,-15989,620
2022-01-07 02:41:13.615242,2022-01-06 21:27:36-05:00,1896,6XHt7CrURSomkQrtVXV5JuKSZY4tQRpUyQKfCDaSTYaD,GCgcmPSDDBsn2smYbpiX3PJybDkQWtufPu4YRsbEEU8X,True,2130280888,532570222,3250647,1625323,1625324,3zqXX6kzhkbW3d4TwD2CNjMRwxTbREXySekvq37kfCNk,130025899,990745011,-860719112,610
2022-01-07 02:41:13.615242,2022-01-06 21:27:36-05:00,1897,Ar5QB4VBcUyzSCG23z2QNAbrWY55NbHCr1MNN6P2GAmh,BusFGTiDrJmxzwGUxWz9b3SFF3eseqtgh2DRHqyAwyVe,True,2918951,729737,4418,2209,2209,4BnQKPLuE3DMTtxp8MjUBytgnhvxqq3ZTqZHTVZo4JJh,176723,893218,-716495,605
2022-01-07 02:41:13.615242,2022-01-06 21:27:36-05:00,1898,7LRBswSEDBjJzQ4YurfTxLydh7tFS2jVn5V95Z6wL7ci,fD41VYGmk66MW46KKb23vAqQvUSDScgXnVdsHhJBZzu,True,744156,186039,1155,577,578,4BnQKPLuE3DMTtxp8MjUBytgnhvxqq3ZTqZHTVZo4JJh,46221,263155,-216934,621
2022-01-07 02:41:13.615242,2022-01-06 21:27:36-05:00,1899,9YEzjb49Awvedv9yNc6LG54SkGBug2RYiJwiUV13mGsS,3H8w5WCD187NWWoZMNUCzUDdxTgqrRJLga8gDzUVXBgZ,True,6924126,1731031,10524,5262,5262,4BnQKPLuE3DMTtxp8MjUBytgnhvxqq3ZTqZHTVZo4JJh,420964,3145893,-2724929,607
2022-01-07 02:41:13.615242,2022-01-06 21:27:36-05:00,1900,4MmpDGUTyMcYEqJ1RoZ46AN2BhrBUseHaHqF8AmiTPyD,7HW2YZpYM349HMfW7u4h9ESZ1AXkwN8JcVDTNFzp9aTz,True,757944171,189486042,1151702,575851,575851,4BnQKPLuE3DMTtxp8MjUBytgnhvxqq3ZTqZHTVZo4JJh,46068114,289749005,-243680891,607
2022-01-07 02:41:13.615242,2022-01-06 21:27:36-05:00,1901,EQUZQWk4WLT6LFeWZs3P9AQufFcoZouFETfhyxvuS2JM,Byc2mLXArmkjQPWaxCJksHZD2XpZyCQ2FRtDJyztU81V,True,600092520,150023130,913681,456840,456841,HfEnetJ7uBSmZWCjBNxdvv9HEC5nsW4wDV7wu6WnhWan,36547268,251116470,-214569202,609
2022-01-07 02:41:13.615242,2022-01-06 21:27:36-05:00,1902,Mcbzp1LhZwpfmXTv1pqe9D1jCKHw443j9QKp6tUpzgM,8uforSMAKEih5jHfHp3gCqCvaugtCmhzVfVHA63Akz7F,True,12599663,3149915,19411,9705,9706,3zqXX6kzhkbW3d4TwD2CNjMRwxTbREXySekvq37kfCNk,776473,4860662,-4084189,616
2022-01-07 02:41:13.615242,2022-01-06 21:27:43-05:00,1903,EeUACm9TkjHKES5U7Yj1oPhYmcp7R3tvesGBiP8txEzq,3qkmm4aS6EDirEDejmbm5PDw2jpYkC7zKqrMkmgeE5BA,True,1459041,364760,2229,1114,1115,4BnQKPLuE3DMTtxp8MjUBytgnhvxqq3ZTqZHTVZo4JJh,89192,340741,-251549,611
2022-01-07 03:03:01.312232,2022-01-06 21:52:46-05:00,1904,CAkknoa9UFPMEZ1KWSfqtmnL7ArVNV3HRETLwecuuXP,4cHJYv3dxA6qjcuxUkGRuL7STWobGPKtoHFD4ACUbiWq,True,66095062,16523765,102770,51385,51385,3zqXX6kzhkbW3d4TwD2CNjMRwxTbREXySekvq37kfCNk,4110825,18632681,-14521856,621
2022-01-07 03:03:01.312232,2022-01-06 21:52:52-05:00,1905,5hUZ9uQFcYnjAQVVaGLJWdKyg7y1XMpoo8osQ9DeY7Xd,BdYiKWsjuzJLcHh3814mJ4xQ9JxoQKKcr7AHZ7Vxoavq,True,255969,63992,398,199,199,3zqXX6kzhkbW3d4TwD2CNjMRwxTbREXySekvq37kfCNk,15946,76337,-60391,622
2022-01-07 03:03:01.312232,2022-01-06 21:52:52-05:00,1906,CFFpbRxYEP18rqEGxxyG3bzSV13Lv7nfSmZvtUK17kCP,824UwqH2JcFsqYBk9MZ8tTnpka9udTL6WGX35YFtAJQk,True,22377388,5594347,34854,17427,17427,3zqXX6kzhkbW3d4TwD2CNjMRwxTbREXySekvq37kfCNk,1394173,6334941,-4940768,623
2022-01-07 03:03:01.312232,2022-01-06 21:52:52-05:00,1907,Buioe5v3DyFwD9nquW5XdYeVYbSABCyg79eUHEvtvfaW,7T9gi7prCcZJkYJMSB5Ef6Bu4pAuBw4XLvumSFnqKDSi,True,4114574,1028643,6428,3214,3214,3zqXX6kzhkbW3d4TwD2CNjMRwxTbREXySekvq37kfCNk,257121,1691283,-1434162,624
2022-01-07 03:03:01.312232,2022-01-06 21:52:56-05:00,1908,8mbMH9EKd9kQDyFrYiDJCV9VaWxWCzpZBQZLyYN2yNVx,J9gT39dF1egMeQvweXYWeRAX3kpmBABijYZhfj6M2UqU,True,141835710,35458927,220952,110476,110476,3zqXX6kzhkbW3d4TwD2CNjMRwxTbREXySekvq37kfCNk,8838113,31982403,-23144290,623
2022-01-07 03:03:01.312232,2022-01-06 21:53:01-05:00,1909,CEbGTNX6WpaoKp4RBGSn9LzYM6yAYyeiMrgVYgJxA4zb,AiXUcGAFFm4tc7vKBscSNjZawV5YJqbv7D1KpxD3Zufg,True,115170149,28792537,178154,89077,89077,3zqXX6kzhkbW3d4TwD2CNjMRwxTbREXySekvq37kfCNk,7126180,47266911,-40140731,618
2022-01-07 03:03:01.312232,2022-01-06 21:53:04-05:00,1910,FjDp4bWCtqehFD7FunCrjrcdxMezTJj5aqh2VnBvHDQU,HRYeZqcqhP1RPiAGXziR1qCWwk4sF6c5ZYbvSDhX7foN,True,46602528,11650632,72484,36242,36242,3zqXX6kzhkbW3d4TwD2CNjMRwxTbREXySekvq37kfCNk,2899398,12541316,-9641918,622
2022-01-07 03:03:01.312232,2022-01-06 21:53:04-05:00,1911,3zH1b58jqbNU37y9kDTZZrotSeT8XzS1tuyAHPKWrbah,4trxDWV16x6sVcz7bxHehYHkjjyKebh3S9fyJf8txzK5,True,43971,10992,68,34,34,3zqXX6kzhkbW3d4TwD2CNjMRwxTbREXySekvq37kfCNk,2727,12184,-9457,620
2022-01-07 03:03:01.312232,2022-01-06 21:53:06-05:00,1912,EgU9hX6VK7YXeCgCHVaJAMekCcyZa2MVWdKra5pN7Gwv,7y8Ad9XY34bqREvheXHT2tr8Jy11D6X3pu7yLVtjU4QV,True,57547812,14386953,89763,44881,44882,3zqXX6kzhkbW3d4TwD2CNjMRwxTbREXySekvq37kfCNk,3590547,20628254,-17037707,623
2022-01-07 03:03:01.312232,2022-01-06 21:53:19-05:00,1913,3g1debT8Z2efQPuMNSDPUNZzDqarBG2acErsZ4HP7QGA,42wDHagxr5Nno3mUx6kyYGDjwR98aedRbh3ByB468agB,True,109860,27465,171,85,86,3zqXX6kzhkbW3d4TwD2CNjMRwxTbREXySekvq37kfCNk,6858,31447,-24589,624
2022-01-07 03:03:01.312232,2022-01-06 21:55:48-05:00,1914,4mB2DVbQVqVk535v98Cj8SPNg1tTc3DFyY2Q7VBbY645,HXo255k3RgsTGsc4hiP6ZTXUspBTqJ37duQa5eK7tqp3,True,1719080255,429770063,2682067,1341033,1341034,3zqXX6kzhkbW3d4TwD2CNjMRwxTbREXySekvq37kfCNk,107282698,485969781,-378687083,624
2022-01-07 03:03:01.312232,2022-01-06 21:55:48-05:00,1915,H6tDNj9cHac223ckAnNfnC4bAJuNLBnf2pFk2iQdMzMP,28UL9dqgayCqCAexScXjdpobYGVDN44SGBVNAfBByk8C,True,388238371,97059592,602389,301194,301195,3zqXX6kzhkbW3d4TwD2CNjMRwxTbREXySekvq37kfCNk,24095582,162835571,-138739989,620
2022-01-07 03:03:01.312232,2022-01-06 21:55:48-05:00,1916,EEcTbsFTUEifcdbPyjBLkS943daEx1RpR8F3uZxKRZbT,8V3JzDQ1VWYQLas8fxUsWJZZHe4gEmn74RehtUwLw3k5,True,31059065,7764766,48047,24023,24024,3zqXX6kzhkbW3d4TwD2CNjMRwxTbREXySekvq37kfCNk,1921905,11060856,-9138951,618
2022-01-07 03:03:01.312232,2022-01-06 21:55:48-05:00,1917,J2gTwrYpzezkRupgBtgudQn5D33x6WjeBhTHnrA1qgqa,FBzoHRwqGRjnMvPEpiZVjtGZYJmAbneE4dpToXPzy8bv,True,199744412571,49936103142,310551057,155275528,155275529,3zqXX6kzhkbW3d4TwD2CNjMRwxTbREXySekvq37kfCNk,12422042305,50518923025,-38096880720,621
2022-01-07 03:03:01.312232,2022-01-06 21:55:48-05:00,1918,2ce2v2TCbjNH635NgbwTG3sqiRWYrRRaBpxPxBZJ929q,9cnoebT43FkWDFhidndGCVNiFD4NErv8DuL1Va4Jv9S8,True,34798191,8699547,51679,25839,25840,3zqXX6kzhkbW3d4TwD2CNjMRwxTbREXySekvq37kfCNk,2067177,21197533,-19130356,594
2022-01-07 03:03:01.312232,2022-01-06 21:55:49-05:00,1919,93ho4cgnpAJiJsG6uu2udkLVNU7rkz4QjCYfsqvpbPA5,45ouQn9gGwXqnTGfaP5CvU8fCKadBRA5kPwtfvJzykRU,True,366959257,91739814,542233,271116,271117,3zqXX6kzhkbW3d4TwD2CNjMRwxTbREXySekvq37kfCNk,21689322,86529747,-64840425,591
2022-01-07 03:03:01.312232,2022-01-06 21:55:49-05:00,1920,4FazDUgfQ3AKoFcnWHr8E9Ht8jLA3tkxf75yrGZVHdmF,HzRMH6mbgEKydRCnnMvSsKgTEVNQi6nuzoR1xutYFdzg,True,354517,88629,523,261,262,3zqXX6kzhkbW3d4TwD2CNjMRwxTbREXySekvq37kfCNk,20951,199971,-179020,590
2022-01-07 03:03:01.312232,2022-01-06 21:55:56-05:00,1921,2bikYf33ZxxDmvkMNjWDGGqEpbYJPvWv5At3hzyeLEQK,5FtirUBjRAZ3k5arFFVwKz42ixWzhkEBLkaK9PraRZ78,True,846728,211682,1283,641,642,3zqXX6kzhkbW3d4TwD2CNjMRwxTbREXySekvq37kfCNk,51349,194621,-143272,606
2022-01-07 03:03:01.312232,2022-01-06 21:55:56-05:00,1922,ECuu1L4QGdemZ7FjAjVAAxYN6piinweY7Fuk5csVovfT,Amd8WGcpdtB8yoA83R1BUT5uryuqoKbcBexYacbrbGVX,True,17652618,4413154,26472,13236,13236,3zqXX6kzhkbW3d4TwD2CNjMRwxTbREXySekvq37kfCNk,1058881,4419891,-3361010,599
2022-01-07 03:03:01.312232,2022-01-06 21:55:56-05:00,1923,AGhvB6x3gmvAJSnr9UVtvhKqVg3Qgh1k4roHzrNHhAaa,HhhjXT6WJnz1HQfHcwKdBppuAhc8ncUcq1mkJ4EHqgpe,True,36490,9122,55,27,28,3zqXX6kzhkbW3d4TwD2CNjMRwxTbREXySekvq37kfCNk,2215,11049,-8834,607
2022-01-07 03:03:01.312232,2022-01-06 21:55:56-05:00,1924,GH6Q9E1jZPTTp46aDd57UNZPNS2D6PBSwyLL3EHSjGn2,2XvwZXNsrPWx4EfPvhTP933bzCC3SJHDQ8xARfrXdVY9,True,114088470,28522117,174508,87254,87254,3zqXX6kzhkbW3d4TwD2CNjMRwxTbREXySekvq37kfCNk,6980338,78095990,-71115652,611
2022-01-07 03:03:01.312232,2022-01-06 21:55:56-05:00,1925,HhwiZPKZBGa16oVi739s4qtMDMTwzWXc7iwNfX63t2UP,5AnbMbAFKy85yHt5y2M5S38nNkA1vT4ejY5NjGbRNUqn,True,7998801,1999700,12086,6043,6043,3zqXX6kzhkbW3d4TwD2CNjMRwxTbREXySekvq37kfCNk,483451,3746311,-3262860,604
2022-01-07 03:03:01.312232,2022-01-06 21:55:56-05:00,1926,CCHzYXr5zMXFu8MMZNkfUWGyUcF8xy7Vvhq7tNCtZg2L,AuEXkCJTTJ3HK8iP4qTWpQr4vp6HPRJZyZwfRjF8zjfp,True,846726,211681,1283,641,642,3zqXX6kzhkbW3d4TwD2CNjMRwxTbREXySekvq37kfCNk,51347,194621,-143274,606
2022-01-07 03:03:01.312232,2022-01-06 21:55:57-05:00,1927,ES1MDwRUa3hoToPKQiiZkzMYe9PDVnAQwMrEvZrzvnc1,C4wBG3xTDkmDQneB28xYnf1aBNEeq7UB8oR7NuEfLkFg,True,159076252,39769063,245536,122768,122768,3zqXX6kzhkbW3d4TwD2CNjMRwxTbREXySekvq37kfCNk,9821447,36145195,-26323748,617
2022-01-07 03:03:01.312232,2022-01-06 21:55:57-05:00,1928,921FBgLS3A1wA77uWitsnTvW737Q2jY7tzvgWtWLXNC7,E4eJ9H7cqP9zNpMH5xRBTAp9yaBCBihuJBNd6pqzteDG,True,846724,211681,1283,641,642,3zqXX6kzhkbW3d4TwD2CNjMRwxTbREXySekvq37kfCNk,51345,194621,-143276,606
2022-01-07 03:03:01.312232,2022-01-06 21:55:57-05:00,1929,5jin5wXjQQ25nGM2ECrCXcg1a95vquh6kM7rMRru6Ke7,EKM657EQ8HWWgf4cssByoYHoXGjFfTspTKXAGmygAPQG,True,217295651,54323912,334241,167120,167121,3zqXX6kzhkbW3d4TwD2CNjMRwxTbREXySekvq37kfCNk,13369654,78151389,-64781735,615
2022-01-07 03:03:01.312232,2022-01-06 21:55:57-05:00,1930,7MSzV5yy5FmrM4j1BcYSRiTGWfit1AJahheRUaXzz349,aPSTZLxBpVr3sucjbj95emRV2J1GrUWr7wbARYqJkQZ,True,25752790,6438197,38534,19267,19267,3zqXX6kzhkbW3d4TwD2CNjMRwxTbREXySekvq37kfCNk,1541385,5828595,-4287210,598
2022-01-07 03:03:01.312232,2022-01-06 21:55:57-05:00,1931,Hy3kzXneDN6FUkiZctU1vWe97BYvj6yZ7QvQzehfWmNr,EhXgQg8BTniANV525RpY76z7Hrh6DuqrMChjqEoXfVJe,True,7465411,1866352,11630,5815,5815,3zqXX6kzhkbW3d4TwD2CNjMRwxTbREXySekvq37kfCNk,465225,2833634,-2368409,623
2022-01-07 03:03:01.312232,2022-01-06 21:55:57-05:00,1932,BxXXWywnC3dSyLPJHt7owfBhgSiBWzkuD3T8hGYLqCH6,4vuwEBXXbXFMPmbJJJRop4FCWGyKR1sXhBc3EWF6MiB8,True,550284074,137571018,828827,414413,414414,3zqXX6kzhkbW3d4TwD2CNjMRwxTbREXySekvq37kfCNk,33153093,233407548,-200254455,602
2022-01-07 03:03:01.312232,2022-01-06 21:55:57-05:00,1933,4D7mDXe7SdmbAx7kaD1mBNuEa7DzMi6TAwXURxtLEazk,5pSnT91PHoLdN6uhPnUtoD7cboLmndn26y1XouPx8vwW,True,8569491,2142372,13264,6632,6632,3zqXX6kzhkbW3d4TwD2CNjMRwxTbREXySekvq37kfCNk,530585,1959094,-1428509,619
2022-01-07 03:03:01.312232,2022-01-06 21:55:57-05:00,1934,5RvNKzSeJ1fvqsKpcQu25evEZGmKjyEDgwsMZkykoT3P,BRqSGfE4XHXu4HrinwetWumfVTmr82iuF6Y5oSV6eMiK,True,847564,211891,1304,652,652,3zqXX6kzhkbW3d4TwD2CNjMRwxTbREXySekvq37kfCNk,52181,194617,-142436,615
2022-01-07 03:03:01.312232,2022-01-06 21:55:57-05:00,1935,6u6bPgAmK8ufACrQV99A1Y5nhGkue3KEUHmQQkcNkxwP,7636yXT5w4DcVpc7LJdN46aiggzSq6U2GXHXL5kyy9F3,True,685282721,171320680,1060491,530245,530246,3zqXX6kzhkbW3d4TwD2CNjMRwxTbREXySekvq37kfCNk,42419644,245736053,-203316409,619
2022-01-07 03:03:01.312232,2022-01-06 21:55:57-05:00,1936,DJiXXW7sjNsAAxWupDKBUsFhXSgPoerVYaAtJqqNgVbn,2MsqvNuJw1xQhJ3UnXt9i7oNHDuZpR9w7iE1WQcGqt5m,True,846703,211675,1283,641,642,3zqXX6kzhkbW3d4TwD2CNjMRwxTbREXySekvq37kfCNk,51324,194621,-143297,606
2022-01-07 03:03:01.312232,2022-01-06 21:55:58-05:00,1937,7W6ih2ZGXaE6tvuQFUPCvc7NvEJHy7UffgoVX3ZPdLXt,6uQCkeMjEXHBQxE2HD33RM1zyTsSko1fYZA1mWUggJ5B,True,148616,37154,223,111,112,3zqXX6kzhkbW3d4TwD2CNjMRwxTbREXySekvq37kfCNk,8930,44680,-35750,600
2022-01-07 03:03:01.312232,2022-01-06 21:55:58-05:00,1938,GGGyesjbt7h2XHHp9u8vpiWGugFwEbrtYaKrNQSDhQd7,8tydo1ZjGHmPBSqU33tywB3f9szdsHk1ckGFe4Ay5pgs,True,291640824,72910206,454982,227491,227491,3zqXX6kzhkbW3d4TwD2CNjMRwxTbREXySekvq37kfCNk,18199311,174865308,-156665997,624
2022-01-07 03:03:01.312232,2022-01-06 21:56:00-05:00,1939,5PbrpM9kjzF4R2eW2UTcRVXnhqWdRQWHZJXKLN43N8WC,6ip4ocbyHusy8CsVvcrpiRCUp2nq9cY8bHpTcUU3Wztq,True,45752651,11438162,71267,35633,35634,3zqXX6kzhkbW3d4TwD2CNjMRwxTbREXySekvq37kfCNk,2850683,14045603,-11194920,623
2022-01-07 03:03:01.312232,2022-01-06 21:56:05-05:00,1940,2QStaRnbSnDhA891Lb1bxjVeMYpJUpNdqaVkw3rqU45V,DakRWPnttPoRcjY5V7WLwiwBx39BapCo9Atog8dL17Ku,True,13083436,3270859,20275,10137,10138,3zqXX6kzhkbW3d4TwD2CNjMRwxTbREXySekvq37kfCNk,811017,2727581,-1916564,619
2022-01-07 03:03:01.312232,2022-01-06 21:56:05-05:00,1941,3njiRuSRMXRzKmamyiR72Hc38PU8UDDmWdfPhgxmGxEW,5WoF3gkgygyNNbwxWgVfqGWkExcDixuzgJQQjXEZQ6J5,True,1473961110,368490277,2296326,1148163,1148163,3zqXX6kzhkbW3d4TwD2CNjMRwxTbREXySekvq37kfCNk,91853042,795277304,-703424262,623
2022-01-07 03:03:01.312232,2022-01-06 21:56:07-05:00,1942,9gYrMXAGmGSV4VFjXzYP5WwH2aFpB1TxA6CqpYsosKLv,Dh8aH6RK48wu4fkT9xKw5XL7itxnPDuw3SDwPwvL5sva,True,153163,38290,229,114,115,3zqXX6kzhkbW3d4TwD2CNjMRwxTbREXySekvq37kfCNk,9168,43928,-34760,598
2022-01-07 03:03:01.312232,2022-01-06 21:56:07-05:00,1943,6dr65yANjSMmfBeKAuSxG3i16S9vMgF1CQ3zDyzh55Pn,EhrE5QpnshD41S4zPEBy2A5q2Gs2mwUrbHGo6WnT9zDP,True,1933141,483285,3023,1511,1512,3zqXX6kzhkbW3d4TwD2CNjMRwxTbREXySekvq37kfCNk,120936,719049,-598113,625
2022-01-07 03:03:01.312232,2022-01-06 22:01:28-05:00,1944,BZxJ6CtrVoiU86DMMieMeDFLNWtMpHGTvZfM7nyay6o4,6CRxRR8bisRLHFJBFWjyumYuy7j4C4PkjYH1K8gXhdWD,True,16553748,4138434,25876,12938,12938,4BnQKPLuE3DMTtxp8MjUBytgnhvxqq3ZTqZHTVZo4JJh,1035044,3606309,-2571265,625
2022-01-07 03:03:01.312232,2022-01-06 22:02:21-05:00,1945,Gbxc51WERLLeCtiHv7rDvE52aqF541RoQWG5n5aqErq6,4ngBoHbfXijLMqGKxFMNht9sbmxy2g5eqBmn8QsBmbx1,True,4373227,1093306,6843,3421,3422,3zqXX6kzhkbW3d4TwD2CNjMRwxTbREXySekvq37kfCNk,273746,1510180,-1236434,625
2022-01-07 03:03:01.312232,2022-01-06 22:02:36-05:00,1946,3Lv2XpiD4KBUHq7Zx6u3zNhpXoySodXHH8o8f5yaaPxG,H6TN4rhpBXkEH3mZnymYNcKfmnxRH2uzfwzeLH2q6ahP,True,1078991,269747,1685,842,843,3zqXX6kzhkbW3d4TwD2CNjMRwxTbREXySekvq37kfCNk,67412,331948,-264536,624
2022-01-07 03:26:38.830272,2022-01-06 22:06:57-05:00,1947,6CeKxTJvFqhyNEyzySiBBKEwYVMe7j3A6nkMes4BW6o2,DzDR9XvwY1z7ygQ8YrCXrwDGHSf67JZF8BzUnuFE2fxQ,True,25283489,6320872,39510,19755,19755,3zqXX6kzhkbW3d4TwD2CNjMRwxTbREXySekvq37kfCNk,1580427,6289448,-4709021,625
2022-01-07 03:26:38.830272,2022-01-06 22:06:57-05:00,1948,FpqCxvTkSiwDwD5qEt6hXJxzFDLFLAQ8VevK8zwRqYun,A3p6YQisCJKpNkF7vkjZRbEfbnUt7vTZdR2zPBUSdTkk,True,2370959389,592739847,3706344,1853172,1853172,4BnQKPLuE3DMTtxp8MjUBytgnhvxqq3ZTqZHTVZo4JJh,148253781,589971378,-441717597,625
2022-01-07 03:26:38.830272,2022-01-06 22:07:00-05:00,1949,8MKNsuGVaoYpdQy6NNyxDvRzh2DAquBUtri4nDsixUxs,D7M1SDmpZAs8vdPCCCa96UbDF15YQDxHmoGWB57tHiir,True,23908112,5977028,37275,18637,18638,3zqXX6kzhkbW3d4TwD2CNjMRwxTbREXySekvq37kfCNk,1491000,9210786,-7719786,623
2022-01-07 03:26:38.830272,2022-01-06 22:07:01-05:00,1950,8VnGmfop6qcUezAJ2M15jz2Nn6mPQgehDcJPvypq4XJn,6F6sqXNhgkW9ev8QNMm4ydywUUmemhwgydRQYNeqyUmi,True,61146596,15286649,95259,47629,47630,3zqXX6kzhkbW3d4TwD2CNjMRwxTbREXySekvq37kfCNk,3810397,42663801,-38853404,623
2022-01-07 03:26:38.830272,2022-01-06 22:07:09-05:00,1951,C2Dmfw4G8KKzFq38aRH2pLCRngnGZDvUUN3fHDMjFkoG,7kzJk3BTNvY3hGFNj7nDy9L5CAYus6eNiCAxWH8dSioX,True,2143119,535779,3346,1673,1673,3zqXX6kzhkbW3d4TwD2CNjMRwxTbREXySekvq37kfCNk,133868,996529,-862661,624
2022-01-07 03:26:38.830272,2022-01-06 22:07:11-05:00,1952,DAku12iueL13vRoTpKLyqdGaLQ2rWF6REe8Dr8soFvNs,H2vVH3LxkhGe6x6Mdwy67BYwTKNQM6XayKx7mhrwyfJM,True,2574509,643627,4009,2004,2005,3zqXX6kzhkbW3d4TwD2CNjMRwxTbREXySekvq37kfCNk,160375,960869,-800494,622
2022-01-07 03:26:38.830272,2022-01-06 22:07:13-05:00,1953,6eBSLXDMVoW2nG3n7s42RXDH8byY3C6n1RsUuegBLSrG,37dYrKnTXYer7Bu9xFfpArA4ZNo2B9bycFw9HywDtTRx,True,57252554,14313138,89567,44783,44784,4BnQKPLuE3DMTtxp8MjUBytgnhvxqq3ZTqZHTVZo4JJh,3582695,19759481,-16176786,625
2022-01-07 03:26:38.830272,2022-01-06 22:07:30-05:00,1954,F2v1YwVAwXLiUgsJ5uwn4qAAkTXitn1E75fJcPnGuAcy,5rdJ4H5GxPg4Juu77mGc7uya5LwEqLzDSRyG8mQ2mDbK,True,111296446,27824111,174018,87009,87009,3zqXX6kzhkbW3d4TwD2CNjMRwxTbREXySekvq37kfCNk,6960759,40020482,-33059723,625
2022-01-07 03:26:38.830272,2022-01-06 22:07:30-05:00,1955,Fd2HrzBAr4JobRPARZwpQHHVoSCEoog32A6tKMWAC1sK,BYappsar5sQf8VLem4wrLuTtrDFH9y8pEx1aMxfuU4Pq,True,173790229,43447557,271973,135986,135987,4BnQKPLuE3DMTtxp8MjUBytgnhvxqq3ZTqZHTVZo4JJh,10878925,62463785,-51584860,625
2022-01-07 03:26:38.830272,2022-01-06 22:07:30-05:00,1956,8NdcaYUC1X5CP7FMDip78uqtqmCt8GcZdCzLRTYTihmb,9Ei1K9bXWXSXcBfeX5exPSXGCAu62WSKzvnnd4wHvyVh,True,758230,189557,1185,592,593,4BnQKPLuE3DMTtxp8MjUBytgnhvxqq3ZTqZHTVZo4JJh,47416,238230,-190814,625
2022-01-07 03:26:38.830272,2022-01-06 22:07:37-05:00,1957,8RmB8o4zux2sD48dEsKpsX475KRxTwdk8QULUDU9xx8R,AKSiZnb4YKVB6B86aPPqvyXquhvN9xqt45bexBCZ7nx,True,365594718,91398679,571987,285993,285994,3zqXX6kzhkbW3d4TwD2CNjMRwxTbREXySekvq37kfCNk,22879489,157119196,-134239707,625
2022-01-07 03:26:38.830272,2022-01-06 22:07:37-05:00,1958,2FrqGFZjbiNykJyo9BZ5S9FguQJPJiTi681rJJsQ5dta,3QUncYP92NKrfpaTvuF9iQg11PXKgZAgEngwh6BbnCCj,True,4766077,1191519,7446,3723,3723,3zqXX6kzhkbW3d4TwD2CNjMRwxTbREXySekvq37kfCNk,297870,1389907,-1092037,624
2022-01-07 03:26:38.830272,2022-01-06 22:08:35-05:00,1959,6tFQaTqqffino9kwMZTL2xVNBG8k9VREFhXqVi2si3A3,3w3wGxBbS4bmXeqmvd595SAWFeXekVpnH4UdbeEs8Sx5,True,25282216,6320554,39469,19734,19735,4BnQKPLuE3DMTtxp8MjUBytgnhvxqq3ZTqZHTVZo4JJh,1578771,6289065,-4710294,624
2022-01-07 03:26:38.830272,2022-01-06 22:08:35-05:00,1960,AHm7zF4rpaxaayBLn5QDHgJSp8KAr647s4cNvQ9wLgd7,FDM33WngED24pukBvSDpPAzinW6afVAeGReum5nyLRiC,True,4776834,1194208,7465,3732,3733,4BnQKPLuE3DMTtxp8MjUBytgnhvxqq3ZTqZHTVZo4JJh,298615,1794942,-1496327,625
2022-01-07 03:26:38.830272,2022-01-06 22:08:35-05:00,1961,EmGW2aAG69ssWqCtbfDocRaM2u3TJsczn2HHP9jdmRvD,aypkDKsp9uqAB4F6mwvm5LofpsrFBuZT2MMWtE2eHdB,True,3724399,931099,5807,2903,2904,3zqXX6kzhkbW3d4TwD2CNjMRwxTbREXySekvq37kfCNk,232308,1253528,-1021220,623
2022-01-07 03:26:38.830272,2022-01-06 22:21:19-05:00,1962,6yw4GPvkqUbakcEWtqSCfjVLukty11xqjDpGxtEN9Km2,5ppEx7wkpqbG5nApCWMdRja3oRSheFmAAsNHUX7h2w2Y,True,9526141,2381535,14876,7438,7438,DddJ7EWCmYEEZETCBNgAUSg81Ls6fZtiAaY5ekJ5sXx1,595041,6798657,-6203616,624
2022-01-07 03:26:38.830272,2022-01-06 22:21:19-05:00,1963,ANQkPUoMjLHyRtypeKzxsKW1DFauQsh9SnB3rRgRXM1Y,7RHAExWpG8Q3PXwKhJs2yXmYK9WogGydvFYpx28p6pgr,True,418788060,104697015,655178,327589,327589,DddJ7EWCmYEEZETCBNgAUSg81Ls6fZtiAaY5ekJ5sXx1,26207159,183121845,-156914686,625
2022-01-07 03:26:38.830272,2022-01-06 22:21:27-05:00,1964,7iUx7JBwqUvPVPeCqMEXQdLccZJmaFYm1DUQiu3ouHa3,3EVZzhRmJnX9ZiBZZo9tenDtMogAyuA1yf2cKzvUWiuu,True,4950224,1237556,7725,3862,3863,DddJ7EWCmYEEZETCBNgAUSg81Ls6fZtiAaY5ekJ5sXx1,309036,1745417,-1436381,624
2022-01-07 03:26:38.830272,2022-01-06 22:21:31-05:00,1965,9zpPiboHF5HW7NfCx7hYdmJGwUomVMTiUFc4Um5KrDi3,8q3eBpuwV6dMNkib9N8XQAq2tBUcjSANRe5SXpd4dFhZ,True,47340218,11835054,74010,37005,37005,3zqXX6kzhkbW3d4TwD2CNjMRwxTbREXySekvq37kfCNk,2960434,10610216,-7649782,625
2022-01-07 03:26:38.830272,2022-01-06 22:21:43-05:00,1966,E8ifvhmyJGBGVQomo3AnZw2UcaLHcpGsTtuoCid8voU3,FMQUWTbTAfSLfrc6GTrz4DM2ZSgoxF3KtqGn8AyjVtsf,True,41034182,10258545,64181,32090,32091,DddJ7EWCmYEEZETCBNgAUSg81Ls6fZtiAaY5ekJ5sXx1,2567247,10008439,-7441192,625
2022-01-07 03:26:38.830272,2022-01-06 22:21:57-05:00,1967,9UyQC8vc6zJJaSdnjvTAzgmcsw4fC3xFBBiCC1w9Sbjx,3ppBfboe6FPmt7f6WrivspMUoAznZKWQMeh3rCgw7vjQ,True,51662638,12915659,80730,40365,40365,3zqXX6kzhkbW3d4TwD2CNjMRwxTbREXySekvq37kfCNk,3229211,11560550,-8331339,625
2022-01-07 03:26:38.830272,2022-01-06 22:22:19-05:00,1968,67Z7ZGhNu5xxEh9BYKWcXp9m1T4tFiE1o1M16hCzUWQA,CT7YKWixz7BhTbvg5F6M5HCyPGnHoFLNFuDV9GhoLTo3,True,18826228,4706557,29437,14718,14719,3zqXX6kzhkbW3d4TwD2CNjMRwxTbREXySekvq37kfCNk,1177480,8253130,-7075650,625
2022-01-07 03:26:38.830272,2022-01-06 22:22:19-05:00,1969,2F45BX9mRmtNCHPejKFknN5aNgGvR4vVLFjMaY1a7dR8,ALdSutsvEFRUEQGGBbi31QywTL1pdXSDWrNJzvNTaoXL,True,144442565,36110641,224368,112184,112184,3zqXX6kzhkbW3d4TwD2CNjMRwxTbREXySekvq37kfCNk,8974755,49694575,-40719820,621
2022-01-07 03:26:38.830272,2022-01-06 22:22:22-05:00,1970,D58t4uTjFumsUeYFaKnpV8BRTEQEqKXBreFTdwGrott7,67p6kHDfVqQijfcwugvZK59c3aRRH9x3eHxruqH8WEqF,True,4360080,1090019,6819,3409,3410,3zqXX6kzhkbW3d4TwD2CNjMRwxTbREXySekvq37kfCNk,272760,1502640,-1229880,625
2022-01-07 03:26:38.830272,2022-01-06 22:22:25-05:00,1971,CvZssqscu2dm35mwcE3zg9zedavbRjVJjWD59Py5ExUK,7pXaoR6aHKYofCmg1eHipygNYDteEaf8rbbS8BDYGQK6,True,4053631,1013407,6311,3155,3156,3zqXX6kzhkbW3d4TwD2CNjMRwxTbREXySekvq37kfCNk,252440,1009199,-756759,622
2022-01-07 03:26:38.830272,2022-01-06 22:22:26-05:00,1972,2VyFcgZDH1HTEvD1XaWhwqBCMmZ1k6TmZ3fEpPcBZR9E,G1wFJETTpdoc7CfypGCzkq1jssXPfUkiuLjK2cwVZ9dJ,True,464567,116141,724,362,362,3zqXX6kzhkbW3d4TwD2CNjMRwxTbREXySekvq37kfCNk,28977,173849,-144872,623
2022-01-07 03:26:38.830272,2022-01-06 22:22:27-05:00,1973,pgzvXpnUYiY7hLrfjmwScqLd8oj9vYcXpFvpm4y4JvG,GdqdQgoyBAFuXdbvoZyDhB3jyqJzVo4nkGh7EPFxkBF2,True,12211062,3052765,19069,9534,9535,3zqXX6kzhkbW3d4TwD2CNjMRwxTbREXySekvq37kfCNk,762792,8779847,-8017055,624
2022-01-07 03:26:38.830272,2022-01-06 22:22:38-05:00,1974,6nJyqvFKprwaVCE1gAa2P4RHKc6Pa6XFSJymx654zZ9K,4e7iJmdwzAPxp1Zi8Azo38YyPQdPKqqY4VLJyQ5rpdYP,True,14433352,3608338,22578,11289,11289,3zqXX6kzhkbW3d4TwD2CNjMRwxTbREXySekvq37kfCNk,903133,5479285,-4576152,625
2022-01-07 03:26:38.830272,2022-01-06 22:23:17-05:00,1975,CRaKcudjkQiSw5YPVjTLVdXvJskeGiHSYtq5ZcMPJhgQ,AgqTg3b3bAcaBmRidhNC4Uf9ZwNbeH52RQEqumWyuUs7,True,5013421,1253355,7838,3919,3919,3zqXX6kzhkbW3d4TwD2CNjMRwxTbREXySekvq37kfCNk,313520,2338630,-2025110,625
2022-01-07 03:26:38.830272,2022-01-06 22:23:42-05:00,1976,DYCYiQFH9QHzCo3eAw1pFoDu7pzwFMo1E2WDZjVFRz5w,CPh4FWsGak1kd1WFEH9qBjNhnun3R2tHtZA57zW8ugn5,True,300083187,75020796,468344,234172,234172,3zqXX6kzhkbW3d4TwD2CNjMRwxTbREXySekvq37kfCNk,18733773,115619018,-96885245,624
2022-01-07 03:26:38.830272,2022-01-06 22:23:53-05:00,1977,8BTja7VnFPe6M9BHTqg5LTpX6vd4ugTeWLzpq3oFP8WM,pscjH4sPnNL6zQBmvHjEEbix6BTstnsrSwGysNWyPkd,False,170190,170190,8505,425,8080,3zqXX6kzhkbW3d4TwD2CNjMRwxTbREXySekvq37kfCNk,8505,57012,-48507,499
2022-01-07 03:26:38.830272,2022-01-06 22:23:53-05:00,1978,9vcKW1GfrDZ3KLPh2pEVFF8ZyKqD1pJW1hiE8H98Av7S,C6Ki27mo4sCHu6u8UnR1p7WSgsTjFQxGGR9Lk9n5Rhjq,True,16082266,4020566,25165,12582,12583,3zqXX6kzhkbW3d4TwD2CNjMRwxTbREXySekvq37kfCNk,1006627,5700575,-4693948,625
2022-01-07 03:26:38.830272,2022-01-06 22:23:57-05:00,1979,36ByQojnxEckWdQTjqHfxKqCx9yjqWQsPsZyqaN72UWR,AZoirtS1fjX61agRM64tqThVinnJTh3BWgiHyNHPTgZP,True,4841223,1210305,7543,3771,3772,DddJ7EWCmYEEZETCBNgAUSg81Ls6fZtiAaY5ekJ5sXx1,301756,1987973,-1686217,623
2022-01-07 03:26:38.830272,2022-01-06 22:24:03-05:00,1980,M69XSefqeum2arinvHEqmA3L2XHWNFN17p4msRhRZXf,2vK15yYUANLSbAoiBfgJ9VLyqsmtEpd2iNytQjms8GaQ,True,1568220746,392055186,2452258,1226129,1226129,4BnQKPLuE3DMTtxp8MjUBytgnhvxqq3ZTqZHTVZo4JJh,98090334,773159501,-675069167,625
2022-01-07 03:26:38.830272,2022-01-06 22:24:04-05:00,1981,Ckqos6cdncPKj13DnCmDVZsZTqp6eS7277CRrT9WhcEr,AtUV8m7VQJvZq7GLCAHMf3jV7iamKEPnWVZHWuuVZQp1,True,7186053,1796513,11227,5613,5614,3zqXX6kzhkbW3d4TwD2CNjMRwxTbREXySekvq37kfCNk,449093,3352435,-2903342,624
2022-01-07 03:26:38.830272,2022-01-06 22:24:10-05:00,1982,HVZkXeDR3mc8oB9qFFwCK4RXpPojdcHk9tRGep6xtKGK,Bh3py7awPejWqeTMxtAgF7mPotL2Asxf8YrYJykq9nBt,True,38161182,9540295,59656,29828,29828,3zqXX6kzhkbW3d4TwD2CNjMRwxTbREXySekvq37kfCNk,2386244,11689531,-9303287,625
2022-01-07 03:26:38.830272,2022-01-06 22:24:10-05:00,1983,zLTuMVfVswjMkhyvjaXnvjcKXv5xNk3iSWSjRGpVqXf,J3D8NHUJCiSjvFYfJ5Es4YDhF1KcPZWRUmCQ5L92t8eB,True,704367079,176091769,1101152,550576,550576,3zqXX6kzhkbW3d4TwD2CNjMRwxTbREXySekvq37kfCNk,44046095,201121516,-157075421,625
2022-01-07 03:26:38.830272,2022-01-06 22:24:10-05:00,1984,6oroGB3mvzK3tDfiB9X2NJuL3x476pxhgRnt7VxqhdLo,2SoK8tKkLn2ppKURpTVazKsCEis4uahkHMsac1m85J4r,True,10366597,2591649,16187,8093,8094,3zqXX6kzhkbW3d4TwD2CNjMRwxTbREXySekvq37kfCNk,647501,7154202,-6506701,624
2022-01-07 03:26:38.830272,2022-01-06 22:24:10-05:00,1985,7bnCuBLXnPS3wDBunrzoV5qm1GwfnPfRBwV2f9Xzo3Aj,9Xd7GNcFrx7z66DRW8kK3d1jN4tzuiwv9jyDFbHUx9vW,False,173162,173162,8407,420,7987,3zqXX6kzhkbW3d4TwD2CNjMRwxTbREXySekvq37kfCNk,8407,58656,-50249,485
2022-01-07 03:26:38.830272,2022-01-06 22:24:12-05:00,1986,CBL2NbekJrXvBiAcoj4fzQ4PfLDwTntW7Zt4nruHFYEw,59EvfgYTdKkfjUJz5LddLUAqbEdLaihcMzjcrTZsyzyS,True,54136,13534,84,42,42,3zqXX6kzhkbW3d4TwD2CNjMRwxTbREXySekvq37kfCNk,3375,16165,-12790,623
2022-01-07 03:26:38.830272,2022-01-06 22:24:15-05:00,1987,8sneA6wAg6geVDJ1g7YWg4R1PfjuRVzeHp1nUBJinhZa,14i1uWtmcTjrdbg3DSr9vzd5NBnxqsn1A4QdgFBZqeYM,True,699973,174992,1091,545,546,4BnQKPLuE3DMTtxp8MjUBytgnhvxqq3ZTqZHTVZo4JJh,43673,220588,-176915,623
2022-01-07 03:26:38.830272,2022-01-06 22:24:24-05:00,1988,6uZobpBuFcQeYgZ4dApFi6iy4DB9GLHP1AAsQcCj6212,SGGFiPjjhscwroiWMqY4jTAHFw8eakpsEv35wNoHUPY,True,777882916,194470727,1208659,604329,604330,3zqXX6kzhkbW3d4TwD2CNjMRwxTbREXySekvq37kfCNk,48346367,200245020,-151898653,621
2022-01-07 03:26:38.830272,2022-01-06 22:24:35-05:00,1989,3qnPsgqW11AcDEmyjmJquPcPLyE3EdJQuVLJ5kinDrd3,86rZadBB7emKio76aFTahpbrFtxd9tqZ4Mxgzaavq2xU,True,914115,228528,1429,714,715,3zqXX6kzhkbW3d4TwD2CNjMRwxTbREXySekvq37kfCNk,57172,282122,-224950,625
2022-01-07 03:26:38.830272,2022-01-06 22:24:42-05:00,1990,7jvKp6onXyWgwsFrFWj4hYTXJsYYD6ot5mn6rPFuJriy,J7N6HiozevJVTiY9hDEUs2ud5BwT5QSE7wnMBS1w5ie2,True,188149096,47037273,292785,146392,146393,3zqXX6kzhkbW3d4TwD2CNjMRwxTbREXySekvq37kfCNk,11711427,77015251,-65303824,622
2022-01-07 03:26:38.830272,2022-01-06 22:24:50-05:00,1991,DMgPzJnMQfvpk6LWscs9V9CwnYDj4CEUgKB9S65WsTaY,BZRSLH1Vw1BQwXTZtBcgUYqmFF7TuzYxAaZ8TXUKwLUQ,True,50521,12629,78,39,39,3zqXX6kzhkbW3d4TwD2CNjMRwxTbREXySekvq37kfCNk,3152,19866,-16714,623
2022-01-07 03:26:38.830272,2022-01-06 22:24:58-05:00,1992,3C2MZQKh9x4zNTCMbhhvoafGaFMwUooqfy9MCgPyXs6E,AHjgWKpYPWe6ketjDHDKFBFsKQiRJ41jnkuo39MVYxZo,True,1224491865,306122966,1913777,956888,956889,72FwbpFGoLEazJEdpqNtPNefsadUrimUqma9wSoy4qiS,76551107,535270943,-458719836,625
2022-01-07 03:26:38.830272,2022-01-06 22:25:01-05:00,1993,864zY9zuCktUurPTtdGeLvUATnDqHZpT1GeWUApsXh2m,CzatBrNJUi7MeyfbNhszRaPMidgt8Xkcmy5ZwFMP9RCs,True,161994385,40498596,252987,126493,126494,3zqXX6kzhkbW3d4TwD2CNjMRwxTbREXySekvq37kfCNk,10119510,51519191,-41399681,624
2022-01-07 03:26:38.830272,2022-01-06 22:25:02-05:00,1994,ymyzGH4Qc7HH5PbKpVphCbsQgLLXyGkPcXamQJuNj5C,8oTLHaV2XzbKXNWRuUjCfHjUn61Pw93LYK14m9q2VDpZ,True,79555598,19888899,124483,62241,62242,3zqXX6kzhkbW3d4TwD2CNjMRwxTbREXySekvq37kfCNk,4979334,21037690,-16058356,625
2022-01-07 03:26:38.830272,2022-01-06 22:25:02-05:00,1995,7PzGZgzieFyyFs1dbajkNQgVxooFUNZrj1bUsQvrSwbp,A2gDREmSmJTBPPw3sbKVY3smC9wbHMDdv87gr4Tr2ES7,True,16448157,4112039,25689,12844,12845,3zqXX6kzhkbW3d4TwD2CNjMRwxTbREXySekvq37kfCNk,1027590,5084676,-4057086,624
2022-01-07 03:26:38.830272,2022-01-06 22:25:08-05:00,1996,3ogBPSRcKfmwzgumVDHBkXLi1eCsEFG2xzSJgD4LQDNy,7TXyqWgJqfe71MSWFA2n7ufZbUdzf7JJoWej8FNNtMXo,True,127613520,31903380,198581,99290,99291,3zqXX6kzhkbW3d4TwD2CNjMRwxTbREXySekvq37kfCNk,7943269,31973296,-24030027,622
2022-01-07 03:26:38.830272,2022-01-06 22:25:14-05:00,1997,B4Uc39nKzz9wBRQsCkMR4A7RwTJ8rSuwpR6EQn2AesRb,H49bGZgatRZVpj6QufZRVgYrQtH7LpdbiqKBs23151m,True,149692247,37423061,234258,117129,117129,3zqXX6kzhkbW3d4TwD2CNjMRwxTbREXySekvq37kfCNk,9370352,108860111,-99489759,625
2022-01-07 03:26:38.830272,2022-01-06 22:25:24-05:00,1998,3WcJUt8jQ1ngL3ZCGo6dFrc3GmTMTYtzeDva7mri2Tqx,HeG1Pz2oMjqtkfsRMsbqP3VpatnVEQzcWmKDVoFp4Htr,True,93747623,23436905,145779,72889,72890,3zqXX6kzhkbW3d4TwD2CNjMRwxTbREXySekvq37kfCNk,5831192,30725181,-24893989,622
2022-01-07 03:26:38.830272,2022-01-06 22:25:24-05:00,1999,GqAS41YJssg9aaEp3hs3sG98APCsXhiQBQszXaSjZ2bN,2wodJ3AhrXdE1T4oVL95KvoBND7PubG5Wd5GWiLCMZJU,True,1096586424,274146606,1676602,838301,838301,DddJ7EWCmYEEZETCBNgAUSg81Ls6fZtiAaY5ekJ5sXx1,67064099,719637802,-652573703,611
2022-01-07 03:26:38.830272,2022-01-06 22:25:24-05:00,2000,CagSUfZLwXuCdypC4KzU6FSNdmCj9dKDroPcNeaRtsyt,yxw5d1ztZuEUY2QjL7eLpr72QJAj5rJd6ERvg91cy1m,True,9338519,2334629,14240,7120,7120,3zqXX6kzhkbW3d4TwD2CNjMRwxTbREXySekvq37kfCNk,569611,2475415,-1905804,609
2022-01-07 03:26:38.830272,2022-01-06 22:25:24-05:00,2001,8xQ3tsWVUe75EG1HmocULJ3kh52utveoFMEPotTGrKno,i3SKW3ywrwYucX9ySEx1C4zaUKGnzLerP3V38437NyV,True,355840973,88960243,555411,277705,277706,3zqXX6kzhkbW3d4TwD2CNjMRwxTbREXySekvq37kfCNk,22216474,118947459,-96730985,624
2022-01-07 03:26:38.830272,2022-01-06 22:25:24-05:00,2002,FV9CBGGTbppLnBKh79f2LzD1diTiS5g6u89FcpZHZmnK,Fe7mtmCUziFqbbYTvrhAcAq1Ub7YLfTJRtQ1hG7GzJD1,True,31417229,7854307,48726,24363,24363,DddJ7EWCmYEEZETCBNgAUSg81Ls6fZtiAaY5ekJ5sXx1,1949067,8511872,-6562805,620
2022-01-07 03:26:38.830272,2022-01-06 22:25:24-05:00,2003,6Bq55LtGCEeGqh4JrFLCmmGc2iJfTTBJixivqH78aGSE,DSNrCgWJeNe2P9tAQu5FvCueTzNKDKds7wzuwTQSMRG,True,39664737,9916184,61934,30967,30967,3zqXX6kzhkbW3d4TwD2CNjMRwxTbREXySekvq37kfCNk,2477385,10523949,-8046564,624
2022-01-07 03:26:38.830272,2022-01-06 22:25:28-05:00,2004,2FEbsetZMkRqLjSC8GBbgecKgX5T1T1fci2sLQux29p8,H722Fcd6DkTFRZxqQWbPDufBfXEgmFfhiEpQZWhxwYv1,True,27892281,6973070,42673,21336,21337,3zqXX6kzhkbW3d4TwD2CNjMRwxTbREXySekvq37kfCNk,1706944,7559065,-5852121,611
2022-01-07 03:26:38.830272,2022-01-06 22:25:28-05:00,2005,Gs3WP18hbzNpbBgiU39e6tfkggfCKRyNqPqJQcthuHFD,4XAY25YUma6gUdG2GdbXeivum3t21g93ZagfWGTZYkWZ,True,42580457,10645113,65894,32947,32947,3zqXX6kzhkbW3d4TwD2CNjMRwxTbREXySekvq37kfCNk,2635795,16966845,-14331050,619
2022-01-07 03:26:38.830272,2022-01-06 22:25:29-05:00,2006,BPsM1um9ZJf7eNoVMsQCRSwgARMuLCGGSDxf9tZeNeEy,BpzDdXfxVygiSYSmsHV6uPxQMeTFtrURMCCqhswQjd5X,True,6961129,1740282,10706,5353,5353,3zqXX6kzhkbW3d4TwD2CNjMRwxTbREXySekvq37kfCNk,428276,1903800,-1475524,615
2022-01-07 03:26:38.830272,2022-01-06 22:25:29-05:00,2007,Cs2YxkuqBK1kjoYZbUZdUcxapPbv8oC75trwGgWoCPfG,2PgHQM1GhHykE4bQ1ggueAw2Zs1BFUW5hxvMvr8DojKM,True,328172094,82043023,509881,254940,254941,3zqXX6kzhkbW3d4TwD2CNjMRwxTbREXySekvq37kfCNk,20395278,142179413,-121784135,621
2022-01-07 03:26:38.830272,2022-01-06 22:25:29-05:00,2008,HGJoZvLakWfSDFwuvShNBc4kCf7nP7VqzyM3mELpbFEf,12Qn5jin7QvsBngXqYAv4UstyG3b6nRf1jsLp9Dp8G7k,True,93630891,23407722,143139,71569,71570,DddJ7EWCmYEEZETCBNgAUSg81Ls6fZtiAaY5ekJ5sXx1,5725578,30736298,-25010720,611
2022-01-07 03:26:38.830272,2022-01-06 22:25:30-05:00,2009,6rb3fRVWJ5cSzFcmuC1YwdrNxiNctvboDF7HwsfyGoCA,H6JaYfFZkRk6iSJrA4nVeuFpMVQtVwQZHVgK1TyaupTE,True,250586,62646,389,194,195,3zqXX6kzhkbW3d4TwD2CNjMRwxTbREXySekvq37kfCNk,15576,156689,-141113,621
2022-01-07 03:26:38.830272,2022-01-06 22:25:31-05:00,2010,BrHRMouGRz3LBNzd9anfdYMhWfg8yUPHL4PqJ8WdEDFS,4uzoLa3mC2VYHAPBoHLX4gTjPTC28rPf2fvEGtJWPYc,True,351310781,87827695,536211,268105,268106,DddJ7EWCmYEEZETCBNgAUSg81Ls6fZtiAaY5ekJ5sXx1,21448479,228878488,-207430009,610
2022-01-07 03:26:38.830272,2022-01-06 22:25:33-05:00,2011,DR7XL3qweFyTKDatQYS2LacqGLv2368cnGuWpEpk4hSL,Fd3BYCiiQfThDJsxBUNwYTMP8eNCrnXMVzE1wpejJqXa,True,27550,6887,42,21,21,3zqXX6kzhkbW3d4TwD2CNjMRwxTbREXySekvq37kfCNk,1709,10749,-9040,620
2022-01-07 03:26:38.830272,2022-01-06 22:25:33-05:00,2012,CwTus4FyoXYqyTKAYDp69NLhA1joYZ3tarzY6FFTr6fn,6ivuvYWU6i25MzJSY8rG9rPDKiq38E6QtrV1jvRubLGr,True,60451,15112,93,46,47,DddJ7EWCmYEEZETCBNgAUSg81Ls6fZtiAaY5ekJ5sXx1,3756,19129,-15373,621
2022-01-07 03:26:38.830272,2022-01-06 22:25:33-05:00,2013,BYvjENe16Ta77PqGV7JKEWrsqCTfkMGYwTSG5gXneDvd,EvxAXgvhPC6QkNurbK7vWyTApGo8J2R4EgMAknkHVU3d,True,17849248,4462312,27572,13786,13786,DddJ7EWCmYEEZETCBNgAUSg81Ls6fZtiAaY5ekJ5sXx1,1102913,8563632,-7460719,617
2022-01-07 03:26:38.830272,2022-01-06 22:25:41-05:00,2014,U3vvMQ4X4aKzVYfhMw1V1p58HRqaLnuXozqmmefYeD9,7JA94MArkNCFRhBq8f5a32DgMF6aPdFsoC5HvXDQ6NuR,True,1812806352,453201588,2768599,1384299,1384300,DddJ7EWCmYEEZETCBNgAUSg81Ls6fZtiAaY5ekJ5sXx1,110743996,709550205,-598806209,610
2022-01-07 03:26:38.830272,2022-01-06 22:25:52-05:00,2015,8xvLGVeDmhVYQhN2ZpWkVG9jCrukRsNQ4926a4TMiZqa,9ciBySSjvADwp47WkETiFWZKVTFL8Hf1XvK7aSxhcgQS,True,150819802,37704950,235004,117502,117502,DddJ7EWCmYEEZETCBNgAUSg81Ls6fZtiAaY5ekJ5sXx1,9400183,42702072,-33301889,623
2022-01-07 03:26:38.830272,2022-01-06 22:26:00-05:00,2016,F1JT1p2VuwK4L7zj7NNnZtYiZiNUCcTGKDkgdoX3BZdZ,3BKe4yzTwnnBnvTWP3britpPJ4oAWL7JZJzNLCxjUufS,True,30273,7568,47,23,24,3zqXX6kzhkbW3d4TwD2CNjMRwxTbREXySekvq37kfCNk,1889,4437,-2548,623
2022-01-07 03:26:38.830272,2022-01-06 22:26:24-05:00,2017,BWtXpiXn1bomr28mGfQFTx1Kd58CQipEnKmeweYowDEC,9jws1qkXvWAdEtBvURVEeGcGJzt4zG2gh8AJESvjKKrx,True,843913609,210978402,1314973,657486,657487,3zqXX6kzhkbW3d4TwD2CNjMRwxTbREXySekvq37kfCNk,52598934,333890094,-281291160,623
2022-01-07 03:26:38.830272,2022-01-06 22:26:24-05:00,2018,7D4rFmGMPKNAF75VRPxHAhSn2wTjiW8jmth1UD22Xqq9,GQ7BrT6vsXu8tHCMm75YdxFR2r9QTCrCUbdPEZBSAg9w,True,223329600,55832400,349379,174689,174690,3zqXX6kzhkbW3d4TwD2CNjMRwxTbREXySekvq37kfCNk,13975199,56146996,-42171797,625
2022-01-07 03:26:38.830272,2022-01-06 22:26:26-05:00,2019,7vKmhLV45Q5etXhJL5ng8rxWhYSiUCDmAbGnwBPr7zcx,cP6xPeuHLnjr858QK1F9qYn7rJpEbPy7wEJHoju6oV7,True,201640460,50410115,315145,157572,157573,DddJ7EWCmYEEZETCBNgAUSg81Ls6fZtiAaY5ekJ5sXx1,12605823,62857030,-50251207,625
2022-01-07 03:26:38.830272,2022-01-06 22:26:27-05:00,2020,5SwL5U5hhQXPW1HXFf4GuU4xkmXoAKx58pjY53NPHqWS,7zB7JvYFzEEwawJy7k7NXvBSG3UsbQte7JxgwvBNbS7U,True,1544463621,386115905,2403549,1201774,1201775,3zqXX6kzhkbW3d4TwD2CNjMRwxTbREXySekvq37kfCNk,96141963,606193352,-510051389,622
2022-01-07 03:26:38.830272,2022-01-06 22:26:35-05:00,2021,G5NLYTLxDZfJFKsJdMeWS8Ez95ZFwR5AX4hKhnfVJvoE,AwrC3pKhTeEDr1HCTWoKWjadteZccvqcisbC7vxTjn7w,True,76922124,19230531,119158,59579,59579,3zqXX6kzhkbW3d4TwD2CNjMRwxTbREXySekvq37kfCNk,4766353,31871366,-27105013,619
2022-01-07 03:41:13.603711,2022-01-06 22:26:42-05:00,2022,2PzBAkdXkrwH9VuoMALumQz86qkW7sSBQtCrHw14JUp3,D5vwWAMHVooobG2sCWv9EwtJrAFZG6cwKH4dfmA98tbt,True,12104369,3026092,18671,9335,9336,DddJ7EWCmYEEZETCBNgAUSg81Ls6fZtiAaY5ekJ5sXx1,746871,3828480,-3081609,617
2022-01-07 03:41:13.603711,2022-01-06 22:26:42-05:00,2023,5Z3ZFCA65WoWhm3okRuuziEMi7ajGAEHWUFchzBNba5S,FcomdrWidygkxMKzcsY5xELbmwC652uMci648LMTv7AB,True,57870,14467,89,44,45,DddJ7EWCmYEEZETCBNgAUSg81Ls6fZtiAaY5ekJ5sXx1,3583,17559,-13976,619
2022-01-07 03:41:13.603711,2022-01-06 22:26:42-05:00,2024,DrzTARa7RK8RXoxHZPKCBqYtMC8TAUHRw8SznXRKTa5M,FYANet92VhyXkKZqqBJR4sFxuCftWb68sgQU9VHCdTJk,True,153680,38420,239,119,120,DddJ7EWCmYEEZETCBNgAUSg81Ls6fZtiAaY5ekJ5sXx1,9573,45762,-36189,622
2022-01-07 03:41:13.603711,2022-01-06 22:26:46-05:00,2025,i7TcF4weYcqgrRdH3GpndbEYxCxfcSfr9JWYrAUg1CF,BkDfknUir7PnSEW8auoB87PytycEFwyX5kT2GY4SGJJL,True,24606137,6151534,38167,19083,19084,3zqXX6kzhkbW3d4TwD2CNjMRwxTbREXySekvq37kfCNk,1526685,16467530,-14940845,620
2022-01-07 03:41:13.603711,2022-01-06 22:27:01-05:00,2026,CK3ocyWzXQkJJZQmM6bBK4Nv6Rh3UEufjY6DvNU6gJZy,C924o4GY3p2BHLeAbFbe9SEysXqCUyD8sFu2d4NzkAV7,True,30295570,7573892,46760,23380,23380,DddJ7EWCmYEEZETCBNgAUSg81Ls6fZtiAaY5ekJ5sXx1,1870424,8131760,-6261336,617
2022-01-07 03:41:13.603711,2022-01-06 22:27:02-05:00,2027,E1wp3bmkcY3eiEYyGYwhTCsr7BZ7RfPa5DJTZFupcFwj,452hVdYkD5SDDrA6hv6DLPFvyS8PvR2P6DPNScGxWTsW,True,3748638,937159,5786,2893,2893,3zqXX6kzhkbW3d4TwD2CNjMRwxTbREXySekvq37kfCNk,231452,1228434,-996982,617
2022-01-07 03:41:13.603711,2022-01-06 22:27:02-05:00,2028,GJ3PbEfPK8jjrPgMmZtvN5fMSSy2dtiiAtZ8wcfgxVuc,FCUDVFb2TjDvehHE8fVBofqSykpb9W6Afc9QeHtj7te7,True,357233632,89308408,558379,279189,279190,3zqXX6kzhkbW3d4TwD2CNjMRwxTbREXySekvq37kfCNk,22335192,156845056,-134509864,625
2022-01-07 03:41:13.603711,2022-01-06 22:27:03-05:00,2029,89CkXnSZnr52Zsoh48efv9MQacrkB6GMtrbEpNJSyA2H,HcvRBS4Z22CpYgDNgm4TVF4AVXFDuYzBUAFcdHAwdpg4,True,13944255,3486063,21762,10881,10881,DddJ7EWCmYEEZETCBNgAUSg81Ls6fZtiAaY5ekJ5sXx1,870485,4307983,-3437498,624
2022-01-07 03:41:13.603711,2022-01-06 22:27:04-05:00,2030,2rCRdyfi65rpxRRmg7knaSb8t55FuPt3h8wF4Fzhy8MM,CLVY5nSG3jTdRo7tRSKgK9DJgW6aswfWKe4tLxzsENmb,True,2930756,732689,4578,2289,2289,3zqXX6kzhkbW3d4TwD2CNjMRwxTbREXySekvq37kfCNk,183148,784894,-601746,624
2022-01-07 03:41:13.603711,2022-01-06 22:27:04-05:00,2031,Cb4zhnvig11U4GcC4kqKrnDicGgPhUpfDQB1U7hP3nPa,DiRAMrKqaevGXeXg38KnhaYBERj8tNKU7oWFJvhS32kw,True,937652,234413,1445,722,723,DddJ7EWCmYEEZETCBNgAUSg81Ls6fZtiAaY5ekJ5sXx1,57831,245181,-187350,616
2022-01-07 03:41:13.603711,2022-01-06 22:27:04-05:00,2032,AKxRtcdpi7gWhAuL8ENj7zhgeQezzEXe9TSANE6bQoRA,2YH4vrU9deP8Cu6E8Hzf8GqKG1yVjv5pdz4FE7r5YKir,True,31836876,7959219,49517,24758,24759,DddJ7EWCmYEEZETCBNgAUSg81Ls6fZtiAaY5ekJ5sXx1,1980683,9817624,-7836941,622
2022-01-07 03:41:13.603711,2022-01-06 22:27:07-05:00,2033,GaEpNGa8jnwSRvjzzEMYkZe1pKcr2eiZtePrqFxpABjB,5CFZHuyWbJv14zPdX5dSQDREgHrCb4vsFvB6hLiEe3Ji,True,708574,177143,1106,553,553,3zqXX6kzhkbW3d4TwD2CNjMRwxTbREXySekvq37kfCNk,44244,221611,-177367,624
2022-01-07 03:41:13.603711,2022-01-06 22:27:12-05:00,2034,2NHv3c4ufYGo3xNr6KXymAZJdpfURrNiCKbXZ7s82Vwo,E4NYpYgHTvSG6LqH2bBV9Q1XJ6pAzCp9FLSKMzJmYRrQ,True,120293999,30073499,186514,93257,93257,3zqXX6kzhkbW3d4TwD2CNjMRwxTbREXySekvq37kfCNk,7460582,50555147,-43094565,620
2022-01-07 03:41:13.603711,2022-01-06 22:27:12-05:00,2035,Ar5QB4VBcUyzSCG23z2QNAbrWY55NbHCr1MNN6P2GAmh,BusFGTiDrJmxzwGUxWz9b3SFF3eseqtgh2DRHqyAwyVe,True,2151651,537912,3361,1680,1681,3zqXX6kzhkbW3d4TwD2CNjMRwxTbREXySekvq37kfCNk,134454,709389,-574935,624
2022-01-07 03:41:13.603711,2022-01-06 22:27:12-05:00,2036,6cnA7PeqQgpZdA7jBg4yMzTusm8JJHRWBMup84ywJfYo,FLqcukY7RehqY6ACrwVJnGH3eRgRDe93K1jLYCQN2F3U,True,631914312,157978578,987721,493860,493861,3zqXX6kzhkbW3d4TwD2CNjMRwxTbREXySekvq37kfCNk,39508863,253385178,-213876315,625
2022-01-07 03:41:13.603711,2022-01-06 22:27:16-05:00,2037,D3mXrJzhHf8qRaoCKLschUxAFoijFCFuT6bmNZH4W7Cj,9E3Xtqw7TncXWnbhAbFJMtuNmP6WS3ooGuptzyzw7UpA,True,269106,67276,420,210,210,DddJ7EWCmYEEZETCBNgAUSg81Ls6fZtiAaY5ekJ5sXx1,16814,119346,-102532,624
2022-01-07 03:41:13.603711,2022-01-06 22:27:19-05:00,2038,HutRztBianNUgm9sJDWKUQBmoVyy8y7CfnNk4hHjSkEW,EtVfvPyiy5bizbCZxR19TNUgETf3QcmziBvMtc6o5zjr,True,1146538144,286634536,1790208,895104,895104,3zqXX6kzhkbW3d4TwD2CNjMRwxTbREXySekvq37kfCNk,71608335,803274991,-731666656,624
2022-01-07 03:41:13.603711,2022-01-06 22:27:22-05:00,2039,DmEVzPyCKnm89v481V2ic57vyikwwMja75uVZ2rjvjfp,38fPZzP4NwTtx7Qu6DLSqx9Sv8e5CQbSrr2BMvVmSy4J,True,185780993,46445248,288668,144334,144334,DddJ7EWCmYEEZETCBNgAUSg81Ls6fZtiAaY5ekJ5sXx1,11546754,75997349,-64450595,621
2022-01-07 03:41:13.603711,2022-01-06 22:27:23-05:00,2040,JCBhqqPQxP1Xc41sSY6e1sQKRstHhe7D1v6rLz4hp3Qp,DWMUq2bMD1jqpxHtyXDFjcAwjA27yyMRe68hGcsK143m,True,32420,8105,50,25,25,3zqXX6kzhkbW3d4TwD2CNjMRwxTbREXySekvq37kfCNk,2024,9885,-7861,624
2022-01-07 03:41:13.603711,2022-01-06 22:27:26-05:00,2041,HqtTbC1LFreGvgfpZe7nCqkNnh8GHPQKosfmc19zb1yi,E39UNiHNkwQEd5GXkCtTPqSorQSB1kLx8kjzK4jdFoi3,True,1446049311,361512327,2257563,1128781,1128782,3zqXX6kzhkbW3d4TwD2CNjMRwxTbREXySekvq37kfCNk,90302536,529913494,-439610958,624
2022-01-07 03:41:13.603711,2022-01-06 22:27:28-05:00,2042,DvuRmJkfn6FQczUKgYeaSCqwy2NTMunuAKNrnmxMvnzS,7LpWTX9dgBtW75kfEoB5WuNsDwEdw5s8CYSHh3J4qagM,True,704434042,176108510,1098298,549149,549149,3zqXX6kzhkbW3d4TwD2CNjMRwxTbREXySekvq37kfCNk,43931930,233922627,-189990697,623
2022-01-07 03:41:13.603711,2022-01-06 22:27:45-05:00,2043,4MmpDGUTyMcYEqJ1RoZ46AN2BhrBUseHaHqF8AmiTPyD,7HW2YZpYM349HMfW7u4h9ESZ1AXkwN8JcVDTNFzp9aTz,True,558554960,139638740,873459,436729,436730,3zqXX6kzhkbW3d4TwD2CNjMRwxTbREXySekvq37kfCNk,34938388,227606997,-192668609,625
2022-01-07 03:41:13.603711,2022-01-06 22:27:47-05:00,2044,9YEzjb49Awvedv9yNc6LG54SkGBug2RYiJwiUV13mGsS,3H8w5WCD187NWWoZMNUCzUDdxTgqrRJLga8gDzUVXBgZ,True,5101829,1275457,7962,3981,3981,72FwbpFGoLEazJEdpqNtPNefsadUrimUqma9wSoy4qiS,318491,2453455,-2134964,624
2022-01-07 03:41:13.603711,2022-01-06 22:27:48-05:00,2045,BzSJ77zKaqtBk2cEL1XqFL97zTXXMRHmxtkgtXwCc3C,2g4KXTwy2MPSRQ2khNp1o1rn7CradEr9H4ySYKDoSWN9,True,46995744,11748936,73491,36745,36746,3zqXX6kzhkbW3d4TwD2CNjMRwxTbREXySekvq37kfCNk,2939672,37662925,-34723253,625
2022-01-07 03:41:13.603711,2022-01-06 22:27:48-05:00,2046,2NdwSLxsGok8PczpCZj9CVX2BymNU5MvHt7hWfGetg2M,8AQbDXeA6mD9QoZBFJcYbnHvZwKNxzA9CCHLAgdSfTA3,True,49559,12389,77,38,39,3zqXX6kzhkbW3d4TwD2CNjMRwxTbREXySekvq37kfCNk,3098,20268,-17170,625
2022-01-07 03:41:13.603711,2022-01-06 22:27:48-05:00,2047,9jdfc9GFTecsdRuTjWFGX13niKKmeBxRgtv5j86uhSnU,HLWMShobjSkaLyXrNjgwVaUGVtbtdUSnr1XjqpXn1bLR,True,1362390,340597,2120,1060,1060,3zqXX6kzhkbW3d4TwD2CNjMRwxTbREXySekvq37kfCNk,84828,479850,-395022,622
2022-01-07 03:41:13.603711,2022-01-06 22:27:55-05:00,2048,8BMDSWFtzq9fu1ubVGtSFw8fEaMg1uvJiECuJnN8e1pd,FwkETAXL296CirvQ2AJuSHHtdKsxkZkmXSwZVVHXVDhA,True,605473840,151368460,945389,472694,472695,DddJ7EWCmYEEZETCBNgAUSg81Ls6fZtiAaY5ekJ5sXx1,37815562,182341722,-144526160,624
2022-01-07 03:41:13.603711,2022-01-06 22:27:58-05:00,2049,EeUACm9TkjHKES5U7Yj1oPhYmcp7R3tvesGBiP8txEzq,3qkmm4aS6EDirEDejmbm5PDw2jpYkC7zKqrMkmgeE5BA,True,1074617,268654,1678,839,839,3zqXX6kzhkbW3d4TwD2CNjMRwxTbREXySekvq37kfCNk,67155,275482,-208327,624
2022-01-07 03:41:13.603711,2022-01-06 22:28:00-05:00,2050,6XHt7CrURSomkQrtVXV5JuKSZY4tQRpUyQKfCDaSTYaD,GCgcmPSDDBsn2smYbpiX3PJybDkQWtufPu4YRsbEEU8X,True,1569257212,392314303,2452785,1226392,1226393,3zqXX6kzhkbW3d4TwD2CNjMRwxTbREXySekvq37kfCNk,98111404,772144231,-674032827,625
2022-01-07 03:41:13.603711,2022-01-06 22:28:00-05:00,2051,EQUZQWk4WLT6LFeWZs3P9AQufFcoZouFETfhyxvuS2JM,Byc2mLXArmkjQPWaxCJksHZD2XpZyCQ2FRtDJyztU81V,True,442052411,110513102,688933,344466,344467,3zqXX6kzhkbW3d4TwD2CNjMRwxTbREXySekvq37kfCNk,27557342,196504295,-168946953,623
2022-01-07 03:41:13.603711,2022-01-06 22:28:05-05:00,2052,AtKuDfcFXqWUMnRqQpjedUMTb5CQKLc2zoqEAcQpysKQ,9bPFLYp5TDZruLLDXDYYCiPYcD982iF8xt5rfTkqwNsL,True,51765,12941,80,40,40,DddJ7EWCmYEEZETCBNgAUSg81Ls6fZtiAaY5ekJ5sXx1,3237,15389,-12152,625
2022-01-07 03:41:13.603711,2022-01-06 22:28:21-05:00,2053,EV21gv8jEvXtmGDoGRNm5LJEvTBccLMZyVDCLsp54jP3,DGxxoU52aQNoUQcxdvQtv2H5q2PhK6TGkLgNSaFgnZrb,True,20712543,5178135,31681,15840,15841,3zqXX6kzhkbW3d4TwD2CNjMRwxTbREXySekvq37kfCNk,1267246,6809500,-5542254,611
2022-01-07 03:41:13.603711,2022-01-06 22:28:24-05:00,2054,7LRBswSEDBjJzQ4YurfTxLydh7tFS2jVn5V95Z6wL7ci,fD41VYGmk66MW46KKb23vAqQvUSDScgXnVdsHhJBZzu,True,547195,136798,851,425,426,72FwbpFGoLEazJEdpqNtPNefsadUrimUqma9wSoy4qiS,34071,207694,-173623,622
2022-01-07 03:41:13.603711,2022-01-06 22:28:27-05:00,2055,8VT2nxz5ZYDJFd9uL2XZwEXxChd9pjuMJNMAcutZubL1,EhAkiRbouzUAWtqQFsN8HEEfi46UVN8H8tyBP7CbgeLe,True,42605,10651,66,33,33,3zqXX6kzhkbW3d4TwD2CNjMRwxTbREXySekvq37kfCNk,2647,15492,-12845,621
2022-01-07 03:41:13.603711,2022-01-06 22:28:30-05:00,2056,Mcbzp1LhZwpfmXTv1pqe9D1jCKHw443j9QKp6tUpzgM,8uforSMAKEih5jHfHp3gCqCvaugtCmhzVfVHA63Akz7F,True,9265036,2316259,14277,7138,7139,3zqXX6kzhkbW3d4TwD2CNjMRwxTbREXySekvq37kfCNk,571106,3818962,-3247856,616
2022-01-07 03:41:13.603711,2022-01-06 22:28:58-05:00,2057,Dc11Q7yj9HoSfndRUB8Ffaz5BcYNFnvbVWuRn8v7Zs7C,BC35JUb1znJxJhcaivpyUPt8Ydojec2ohC1TrFv7TntJ,True,2035221579,508805394,3180146,1590073,1590073,DddJ7EWCmYEEZETCBNgAUSg81Ls6fZtiAaY5ekJ5sXx1,127205851,677714824,-550508973,625
2022-01-07 03:41:13.603711,2022-01-06 22:29:02-05:00,2058,EanSXRkJu91FKUhPCzYxWkmM3PQUWcovEnoZXcd6vQ9E,Fg4EzAzHStoLRDPmoBUczdWnWrhAb7jKEujqAujLFT8,True,1596908669,399227167,2479734,1239867,1239867,GAUsoe8ZTCiGPm2hYxRPGxcPe5ShNzHK9eE3G2zgRjxd,99189365,447311710,-348122345,621
2022-01-07 03:41:13.603711,2022-01-06 22:29:10-05:00,2059,FSduW743jAGyyn8HTifEJitgb89Spp5gEeMXDE59aEHF,HjojGNpR3ACtLCP2mP8DKGyXj6SeqWPKjcCAofcyQpsm,True,856302754,214075688,1304292,652146,652146,3zqXX6kzhkbW3d4TwD2CNjMRwxTbREXySekvq37kfCNk,52171690,231167751,-178996061,609
2022-01-07 03:41:13.603711,2022-01-06 22:29:11-05:00,2060,CAkknoa9UFPMEZ1KWSfqtmnL7ArVNV3HRETLwecuuXP,4cHJYv3dxA6qjcuxUkGRuL7STWobGPKtoHFD4ACUbiWq,True,48526241,12131560,73911,36955,36956,DddJ7EWCmYEEZETCBNgAUSg81Ls6fZtiAaY5ekJ5sXx1,2956469,14892951,-11936482,609
2022-01-07 03:41:13.603711,2022-01-06 22:29:12-05:00,2061,Dn916KSmX3HqxT53hrxrbCrV3tdRMCPdaoiRLqetMrth,ATCXRiXgnjRRUbSTPBvtBXMENCqsViexSZbZ6aDaXXWA,True,5531222,1382804,8601,4300,4301,3zqXX6kzhkbW3d4TwD2CNjMRwxTbREXySekvq37kfCNk,344056,1927803,-1583747,622
2022-01-07 03:41:13.603711,2022-01-06 22:29:15-05:00,2062,CFFpbRxYEP18rqEGxxyG3bzSV13Lv7nfSmZvtUK17kCP,824UwqH2JcFsqYBk9MZ8tTnpka9udTL6WGX35YFtAJQk,True,16435297,4108824,25234,12617,12617,DddJ7EWCmYEEZETCBNgAUSg81Ls6fZtiAaY5ekJ5sXx1,1009363,5062688,-4053325,614
2022-01-07 03:41:13.603711,2022-01-06 22:29:15-05:00,2063,93ho4cgnpAJiJsG6uu2udkLVNU7rkz4QjCYfsqvpbPA5,45ouQn9gGwXqnTGfaP5CvU8fCKadBRA5kPwtfvJzykRU,True,271049887,67762471,423526,211763,211763,3zqXX6kzhkbW3d4TwD2CNjMRwxTbREXySekvq37kfCNk,16941053,69741927,-52800874,625
2022-01-07 03:41:13.603711,2022-01-06 22:29:15-05:00,2064,5hUZ9uQFcYnjAQVVaGLJWdKyg7y1XMpoo8osQ9DeY7Xd,BdYiKWsjuzJLcHh3814mJ4xQ9JxoQKKcr7AHZ7Vxoavq,True,187985,46996,288,144,144,GAUsoe8ZTCiGPm2hYxRPGxcPe5ShNzHK9eE3G2zgRjxd,11531,60817,-49286,613
2022-01-07 03:41:13.603711,2022-01-06 22:29:15-05:00,2065,Buioe5v3DyFwD9nquW5XdYeVYbSABCyg79eUHEvtvfaW,7T9gi7prCcZJkYJMSB5Ef6Bu4pAuBw4XLvumSFnqKDSi,True,3021874,755468,4655,2327,2328,DddJ7EWCmYEEZETCBNgAUSg81Ls6fZtiAaY5ekJ5sXx1,186230,1325910,-1139680,616
2022-01-07 03:41:13.603711,2022-01-06 22:29:18-05:00,2066,FjDp4bWCtqehFD7FunCrjrcdxMezTJj5aqh2VnBvHDQU,HRYeZqcqhP1RPiAGXziR1qCWwk4sF6c5ZYbvSDhX7foN,True,34258676,8564669,53227,26613,26614,3zqXX6kzhkbW3d4TwD2CNjMRwxTbREXySekvq37kfCNk,2129083,10053759,-7924676,621
2022-01-07 03:41:13.603711,2022-01-06 22:29:18-05:00,2067,CEbGTNX6WpaoKp4RBGSn9LzYM6yAYyeiMrgVYgJxA4zb,AiXUcGAFFm4tc7vKBscSNjZawV5YJqbv7D1KpxD3Zufg,True,84664323,21166080,130583,65291,65292,GAUsoe8ZTCiGPm2hYxRPGxcPe5ShNzHK9eE3G2zgRjxd,5223342,37042293,-31818951,616
2022-01-07 03:41:13.603711,2022-01-06 22:29:29-05:00,2068,3zH1b58jqbNU37y9kDTZZrotSeT8XzS1tuyAHPKWrbah,4trxDWV16x6sVcz7bxHehYHkjjyKebh3S9fyJf8txzK5,True,32330,8082,50,25,25,3zqXX6kzhkbW3d4TwD2CNjMRwxTbREXySekvq37kfCNk,2006,9749,-7743,620
2022-01-07 03:41:13.603711,2022-01-06 22:29:31-05:00,2069,8mbMH9EKd9kQDyFrYiDJCV9VaWxWCzpZBQZLyYN2yNVx,J9gT39dF1egMeQvweXYWeRAX3kpmBABijYZhfj6M2UqU,True,104180962,26045240,160182,80091,80091,3zqXX6kzhkbW3d4TwD2CNjMRwxTbREXySekvq37kfCNk,6407317,25961503,-19554186,615
2022-01-07 03:41:13.603711,2022-01-06 22:29:40-05:00,2070,4FazDUgfQ3AKoFcnWHr8E9Ht8jLA3tkxf75yrGZVHdmF,HzRMH6mbgEKydRCnnMvSsKgTEVNQi6nuzoR1xutYFdzg,True,261822,65455,408,204,204,3zqXX6kzhkbW3d4TwD2CNjMRwxTbREXySekvq37kfCNk,16327,154659,-138332,623
2022-01-07 03:41:13.603711,2022-01-06 22:29:41-05:00,2071,EgU9hX6VK7YXeCgCHVaJAMekCcyZa2MVWdKra5pN7Gwv,7y8Ad9XY34bqREvheXHT2tr8Jy11D6X3pu7yLVtjU4QV,True,42308266,10577066,66062,33031,33031,DddJ7EWCmYEEZETCBNgAUSg81Ls6fZtiAaY5ekJ5sXx1,2642496,16273397,-13630901,624
2022-01-07 03:41:13.603711,2022-01-06 22:30:01-05:00,2072,921FBgLS3A1wA77uWitsnTvW737Q2jY7tzvgWtWLXNC7,E4eJ9H7cqP9zNpMH5xRBTAp9yaBCBihuJBNd6pqzteDG,True,624106,156026,976,488,488,3zqXX6kzhkbW3d4TwD2CNjMRwxTbREXySekvq37kfCNk,39041,157436,-118395,625
2022-01-07 03:41:13.603711,2022-01-06 22:30:02-05:00,2073,ECuu1L4QGdemZ7FjAjVAAxYN6piinweY7Fuk5csVovfT,Amd8WGcpdtB8yoA83R1BUT5uryuqoKbcBexYacbrbGVX,True,13011378,3252844,20064,10032,10032,3zqXX6kzhkbW3d4TwD2CNjMRwxTbREXySekvq37kfCNk,802569,3551416,-2748847,616
2022-01-07 03:41:13.603711,2022-01-06 22:30:02-05:00,2074,H6tDNj9cHac223ckAnNfnC4bAJuNLBnf2pFk2iQdMzMP,28UL9dqgayCqCAexScXjdpobYGVDN44SGBVNAfBByk8C,True,285201652,71300413,436940,218470,218470,DddJ7EWCmYEEZETCBNgAUSg81Ls6fZtiAaY5ekJ5sXx1,17477600,127511007,-110033407,612
2022-01-07 03:41:13.603711,2022-01-06 22:30:02-05:00,2075,CCHzYXr5zMXFu8MMZNkfUWGyUcF8xy7Vvhq7tNCtZg2L,AuEXkCJTTJ3HK8iP4qTWpQr4vp6HPRJZyZwfRjF8zjfp,True,624103,156025,975,487,488,3zqXX6kzhkbW3d4TwD2CNjMRwxTbREXySekvq37kfCNk,39038,157436,-118398,625
2022-01-07 03:41:13.603711,2022-01-06 22:30:02-05:00,2076,BxXXWywnC3dSyLPJHt7owfBhgSiBWzkuD3T8hGYLqCH6,4vuwEBXXbXFMPmbJJJRop4FCWGyKR1sXhBc3EWF6MiB8,True,405608291,101402072,629119,314559,314560,DddJ7EWCmYEEZETCBNgAUSg81Ls6fZtiAaY5ekJ5sXx1,25164794,182463005,-157298211,620
2022-01-07 03:41:13.603711,2022-01-06 22:30:02-05:00,2077,3g1debT8Z2efQPuMNSDPUNZzDqarBG2acErsZ4HP7QGA,42wDHagxr5Nno3mUx6kyYGDjwR98aedRbh3ByB468agB,True,80630,20157,122,61,61,3zqXX6kzhkbW3d4TwD2CNjMRwxTbREXySekvq37kfCNk,4912,25119,-20207,609
2022-01-07 03:41:13.603711,2022-01-06 22:30:05-05:00,2078,7MSzV5yy5FmrM4j1BcYSRiTGWfit1AJahheRUaXzz349,aPSTZLxBpVr3sucjbj95emRV2J1GrUWr7wbARYqJkQZ,True,18981787,4745446,29187,14593,14594,GAUsoe8ZTCiGPm2hYxRPGxcPe5ShNzHK9eE3G2zgRjxd,1167485,4715704,-3548219,615
2022-01-07 03:41:13.603711,2022-01-06 22:30:05-05:00,2079,9gYrMXAGmGSV4VFjXzYP5WwH2aFpB1TxA6CqpYsosKLv,Dh8aH6RK48wu4fkT9xKw5XL7itxnPDuw3SDwPwvL5sva,True,112884,28221,173,86,87,3zqXX6kzhkbW3d4TwD2CNjMRwxTbREXySekvq37kfCNk,6935,34995,-28060,614
2022-01-07 03:41:13.603711,2022-01-06 22:30:05-05:00,2080,7W6ih2ZGXaE6tvuQFUPCvc7NvEJHy7UffgoVX3ZPdLXt,6uQCkeMjEXHBQxE2HD33RM1zyTsSko1fYZA1mWUggJ5B,True,109540,27385,169,84,85,3zqXX6kzhkbW3d4TwD2CNjMRwxTbREXySekvq37kfCNk,6771,35506,-28735,618
2022-01-07 03:41:13.603711,2022-01-06 22:30:05-05:00,2081,2bikYf33ZxxDmvkMNjWDGGqEpbYJPvWv5At3hzyeLEQK,5FtirUBjRAZ3k5arFFVwKz42ixWzhkEBLkaK9PraRZ78,True,624077,156019,975,487,488,3zqXX6kzhkbW3d4TwD2CNjMRwxTbREXySekvq37kfCNk,39013,157437,-118424,625
2022-01-07 03:41:13.603711,2022-01-06 22:30:05-05:00,2082,HhwiZPKZBGa16oVi739s4qtMDMTwzWXc7iwNfX63t2UP,5AnbMbAFKy85yHt5y2M5S38nNkA1vT4ejY5NjGbRNUqn,True,5895490,1473872,9173,4586,4587,3zqXX6kzhkbW3d4TwD2CNjMRwxTbREXySekvq37kfCNk,366959,2917716,-2550757,622
2022-01-07 03:41:13.603711,2022-01-06 22:30:07-05:00,2083,2ce2v2TCbjNH635NgbwTG3sqiRWYrRRaBpxPxBZJ929q,9cnoebT43FkWDFhidndGCVNiFD4NErv8DuL1Va4Jv9S8,True,25647669,6411917,39026,19513,19513,GAUsoe8ZTCiGPm2hYxRPGxcPe5ShNzHK9eE3G2zgRjxd,1561064,16359819,-14798755,608
2022-01-07 03:41:13.603711,2022-01-06 22:30:11-05:00,2084,DJiXXW7sjNsAAxWupDKBUsFhXSgPoerVYaAtJqqNgVbn,2MsqvNuJw1xQhJ3UnXt9i7oNHDuZpR9w7iE1WQcGqt5m,True,624077,156019,975,487,488,3zqXX6kzhkbW3d4TwD2CNjMRwxTbREXySekvq37kfCNk,39006,157430,-118424,625
2022-01-07 03:41:13.603711,2022-01-06 22:30:11-05:00,2085,EEcTbsFTUEifcdbPyjBLkS943daEx1RpR8F3uZxKRZbT,8V3JzDQ1VWYQLas8fxUsWJZZHe4gEmn74RehtUwLw3k5,True,22815078,5703769,34789,17394,17395,GAUsoe8ZTCiGPm2hYxRPGxcPe5ShNzHK9eE3G2zgRjxd,1391560,8725003,-7333443,609
2022-01-07 03:41:13.603711,2022-01-06 22:30:23-05:00,2086,AvwHizRhHUSahmvSg4jmTUErc7vAFSmkRAEsiKhXfW1m,3UrWYx8y9N5o9GYneSe6zyyHRTZzxwvcipQfHHYh7tEs,True,21341200,5335300,33142,16571,16571,3zqXX6kzhkbW3d4TwD2CNjMRwxTbREXySekvq37kfCNk,1325680,4974380,-3648700,621
2022-01-07 03:41:13.603711,2022-01-06 22:30:26-05:00,2087,AGhvB6x3gmvAJSnr9UVtvhKqVg3Qgh1k4roHzrNHhAaa,HhhjXT6WJnz1HQfHcwKdBppuAhc8ncUcq1mkJ4EHqgpe,True,26893,6723,42,21,21,3zqXX6kzhkbW3d4TwD2CNjMRwxTbREXySekvq37kfCNk,1682,8783,-7101,625
2022-01-07 03:41:13.603711,2022-01-06 22:31:01-05:00,2088,46TNhGwBVzedW8xSb9UY94HNeSom9iGiZzAjrKHiRM2G,7JVTiqNYeKHbyzRkKtvSEpqLPKykZso8cGUr3sX1j7QF,True,256289949,64072487,395656,197828,197828,3zqXX6kzhkbW3d4TwD2CNjMRwxTbREXySekvq37kfCNk,15826275,67787587,-51961312,617
2022-01-07 03:41:13.603711,2022-01-06 22:31:47-05:00,2089,9jeqT7xKb8hr5VRuQEFxnf93Y3zHsvmYDHz64nyE7Wte,9NqYMu528mFG2M7RYL1NuEvR9aiNAW13WwXDKuprQa7h,True,222092728,55523182,338859,169429,169430,GAUsoe8ZTCiGPm2hYxRPGxcPe5ShNzHK9eE3G2zgRjxd,13554393,85493417,-71939024,610
2022-01-07 03:41:13.603711,2022-01-06 22:31:47-05:00,2090,8trkirSQNdMmAcJdeswxs5cPjH8dD6U4eJtWiAdMsrDB,HaSzpQ45x2MipfN17U6jGBxX8tXboomVDhXNSrnEfLDr,True,19865426,4966356,30960,15480,15480,72FwbpFGoLEazJEdpqNtPNefsadUrimUqma9wSoy4qiS,1238424,5929015,-4690591,623
2022-01-07 03:41:13.603711,2022-01-06 22:31:50-05:00,2091,5jin5wXjQQ25nGM2ECrCXcg1a95vquh6kM7rMRru6Ke7,EKM657EQ8HWWgf4cssByoYHoXGjFfTspTKXAGmygAPQG,True,159952064,39988016,249853,124926,124927,GAUsoe8ZTCiGPm2hYxRPGxcPe5ShNzHK9eE3G2zgRjxd,9994136,61600500,-51606364,624
2022-01-07 03:41:13.603711,2022-01-06 22:31:52-05:00,2092,GjQQ2fQ7mrGjWZwjVYFUKp9NM1LmfkhEo675ovU5SPa8,ECgVUMRY5nB4MALs5drDyipF7YohCPuJpj2UegCs7HMn,True,131299924,32824981,205006,102503,102503,3zqXX6kzhkbW3d4TwD2CNjMRwxTbREXySekvq37kfCNk,8200249,37152926,-28952677,624
2022-01-07 03:41:13.603711,2022-01-06 22:31:57-05:00,2093,GH6Q9E1jZPTTp46aDd57UNZPNS2D6PBSwyLL3EHSjGn2,2XvwZXNsrPWx4EfPvhTP933bzCC3SJHDQ8xARfrXdVY9,True,83979849,20994962,130199,65099,65100,3zqXX6kzhkbW3d4TwD2CNjMRwxTbREXySekvq37kfCNk,5207985,60131362,-54923377,620
2022-01-07 03:41:13.603711,2022-01-06 22:31:57-05:00,2094,5RvNKzSeJ1fvqsKpcQu25evEZGmKjyEDgwsMZkykoT3P,BRqSGfE4XHXu4HrinwetWumfVTmr82iuF6Y5oSV6eMiK,True,623896,155974,975,487,488,3zqXX6kzhkbW3d4TwD2CNjMRwxTbREXySekvq37kfCNk,39016,157621,-118605,625
2022-01-07 03:41:13.603711,2022-01-06 22:32:04-05:00,2095,HAk9c831TRUhvpoK4d7PTqfJuJhSjnJUXWpnYsH85bDJ,DVSa3CJrVLTHAeFYjEF89ZjWRm86QwruUk2Y8RvGpjsr,True,139890,34971,218,109,109,GAUsoe8ZTCiGPm2hYxRPGxcPe5ShNzHK9eE3G2zgRjxd,8730,49454,-40724,624
2022-01-07 03:41:13.603711,2022-01-06 22:32:11-05:00,2096,ES1MDwRUa3hoToPKQiiZkzMYe9PDVnAQwMrEvZrzvnc1,C4wBG3xTDkmDQneB28xYnf1aBNEeq7UB8oR7NuEfLkFg,True,116974241,29243560,180678,90339,90339,3zqXX6kzhkbW3d4TwD2CNjMRwxTbREXySekvq37kfCNk,7227149,29303095,-22075946,617
2022-01-07 03:41:13.603711,2022-01-06 22:32:13-05:00,2097,gMjmD7WioyUdQdwNqE5fobLcxPwoJv5rAvLmJaf8Jjw,5n77euFjVJiwKrnbYq1KpcENW1mzBZj2BuDGyzazrkJ8,True,3928151,982037,6017,3008,3009,3zqXX6kzhkbW3d4TwD2CNjMRwxTbREXySekvq37kfCNk,240696,1367972,-1127276,612
2022-01-07 03:41:13.603711,2022-01-06 22:32:17-05:00,2098,2jDRvE3pQNjWy1NRFa4tzB3KmU5UkbUCHw8sQRFujo66,C4zNi2szDrEEh4coTF3WRUghfP4ZwAVVSYTLWfkejQRu,True,2875193350,718798337,4453569,2226784,2226785,GAUsoe8ZTCiGPm2hYxRPGxcPe5ShNzHK9eE3G2zgRjxd,178142769,714417652,-536274883,619
2022-01-07 03:41:13.603711,2022-01-06 22:32:21-05:00,2099,F9s8a7Cpiw5dw3a2aNFMofqwyDWNXvDLnSdJzoj1gRiV,GpKsQKJD79KBRWdCTkyi4zX7NaoCWsLUjrKxAwJB6o6s,True,173422990,43355747,271138,135569,135569,GAUsoe8ZTCiGPm2hYxRPGxcPe5ShNzHK9eE3G2zgRjxd,10845523,18276158,-7430635,625
2022-01-07 03:41:13.603711,2022-01-06 22:32:21-05:00,2100,6u6bPgAmK8ufACrQV99A1Y5nhGkue3KEUHmQQkcNkxwP,7636yXT5w4DcVpc7LJdN46aiggzSq6U2GXHXL5kyy9F3,True,503914211,125978552,781079,390539,390540,DddJ7EWCmYEEZETCBNgAUSg81Ls6fZtiAaY5ekJ5sXx1,31243194,193782171,-162538977,620
2022-01-07 03:41:13.603711,2022-01-06 22:32:21-05:00,2101,5PbrpM9kjzF4R2eW2UTcRVXnhqWdRQWHZJXKLN43N8WC,6ip4ocbyHusy8CsVvcrpiRCUp2nq9cY8bHpTcUU3Wztq,True,33643547,8410886,52598,26299,26299,3zqXX6kzhkbW3d4TwD2CNjMRwxTbREXySekvq37kfCNk,2103926,11171075,-9067149,625
2022-01-07 03:41:13.603711,2022-01-06 22:32:22-05:00,2102,2QStaRnbSnDhA891Lb1bxjVeMYpJUpNdqaVkw3rqU45V,DakRWPnttPoRcjY5V7WLwiwBx39BapCo9Atog8dL17Ku,True,9620053,2405013,14922,7461,7461,DddJ7EWCmYEEZETCBNgAUSg81Ls6fZtiAaY5ekJ5sXx1,596918,2226867,-1629949,620
2022-01-07 03:41:13.603711,2022-01-06 22:32:22-05:00,2103,JDeYjCLpfnzcfxDFgHf4aBcHsajwdR14GUaKAA9euzVf,EJbvKoyMZcoCx4vWa61uMbW2vr6mUhrgEuECdteVBuZZ,True,46851376,11712844,71393,35696,35697,3zqXX6kzhkbW3d4TwD2CNjMRwxTbREXySekvq37kfCNk,2855751,20738338,-17882587,609
2022-01-07 03:41:13.603711,2022-01-06 22:32:23-05:00,2104,3njiRuSRMXRzKmamyiR72Hc38PU8UDDmWdfPhgxmGxEW,5WoF3gkgygyNNbwxWgVfqGWkExcDixuzgJQQjXEZQ6J5,True,1083629766,270907441,1689228,844614,844614,DddJ7EWCmYEEZETCBNgAUSg81Ls6fZtiAaY5ekJ5sXx1,67569124,616998622,-549429498,623
2022-01-07 03:41:13.603711,2022-01-06 22:32:23-05:00,2105,J2gTwrYpzezkRupgBtgudQn5D33x6WjeBhTHnrA1qgqa,FBzoHRwqGRjnMvPEpiZVjtGZYJmAbneE4dpToXPzy8bv,True,146858233368,36714558342,228536438,114268219,114268219,3zqXX6kzhkbW3d4TwD2CNjMRwxTbREXySekvq37kfCNk,9141457524,40963710746,-31822253222,622
2022-01-07 03:41:13.603711,2022-01-06 22:32:31-05:00,2106,AHm7zF4rpaxaayBLn5QDHgJSp8KAr647s4cNvQ9wLgd7,FDM33WngED24pukBvSDpPAzinW6afVAeGReum5nyLRiC,True,3509976,877494,5462,2731,2731,DddJ7EWCmYEEZETCBNgAUSg81Ls6fZtiAaY5ekJ5sXx1,218500,1413396,-1194896,622
2022-01-07 03:41:13.603711,2022-01-06 22:32:31-05:00,2107,8MKNsuGVaoYpdQy6NNyxDvRzh2DAquBUtri4nDsixUxs,D7M1SDmpZAs8vdPCCCa96UbDF15YQDxHmoGWB57tHiir,True,17540273,4385068,26572,13286,13286,GAUsoe8ZTCiGPm2hYxRPGxcPe5ShNzHK9eE3G2zgRjxd,1062914,7243570,-6180656,605
2022-01-07 03:41:13.603711,2022-01-06 22:32:31-05:00,2108,FpqCxvTkSiwDwD5qEt6hXJxzFDLFLAQ8VevK8zwRqYun,A3p6YQisCJKpNkF7vkjZRbEfbnUt7vTZdR2zPBUSdTkk,True,1739151177,434787794,2636976,1318488,1318488,DddJ7EWCmYEEZETCBNgAUSg81Ls6fZtiAaY5ekJ5sXx1,105479072,475877684,-370398612,606
2022-01-07 03:41:13.603711,2022-01-06 22:32:31-05:00,2109,C2Dmfw4G8KKzFq38aRH2pLCRngnGZDvUUN3fHDMjFkoG,7kzJk3BTNvY3hGFNj7nDy9L5CAYus6eNiCAxWH8dSioX,True,1572668,393167,2396,1198,1198,DddJ7EWCmYEEZETCBNgAUSg81Ls6fZtiAaY5ekJ5sXx1,95850,777519,-681669,609
2022-01-07 03:41:13.603711,2022-01-06 22:32:31-05:00,2110,HdfQweV1KuYSpWdycZbpGrUc8yMcY3ZczLn1agKXMJaf,G1Ae1PZHkANkwFnhUKS1tvdFEv8dAFeojBkezh6rUNMh,True,32085391,8021347,48946,24473,24473,DddJ7EWCmYEEZETCBNgAUSg81Ls6fZtiAaY5ekJ5sXx1,1957844,11442281,-9484437,610
2022-01-07 03:41:13.603711,2022-01-06 22:32:31-05:00,2111,Fd2HrzBAr4JobRPARZwpQHHVoSCEoog32A6tKMWAC1sK,BYappsar5sQf8VLem4wrLuTtrDFH9y8pEx1aMxfuU4Pq,True,127617377,31904344,197041,98520,98521,3zqXX6kzhkbW3d4TwD2CNjMRwxTbREXySekvq37kfCNk,7881657,49295845,-41414188,617
2022-01-07 03:41:13.603711,2022-01-06 22:32:31-05:00,2112,8RmB8o4zux2sD48dEsKpsX475KRxTwdk8QULUDU9xx8R,AKSiZnb4YKVB6B86aPPqvyXquhvN9xqt45bexBCZ7nx,True,268500876,67125219,415308,207654,207654,DddJ7EWCmYEEZETCBNgAUSg81Ls6fZtiAaY5ekJ5sXx1,16612339,122988436,-106376097,618
2022-01-07 03:41:13.603711,2022-01-06 22:32:31-05:00,2113,4D7mDXe7SdmbAx7kaD1mBNuEa7DzMi6TAwXURxtLEazk,5pSnT91PHoLdN6uhPnUtoD7cboLmndn26y1XouPx8vwW,True,6284465,1571116,9345,4672,4673,3zqXX6kzhkbW3d4TwD2CNjMRwxTbREXySekvq37kfCNk,373816,1587853,-1214037,594
2022-01-07 03:41:13.603711,2022-01-06 22:32:32-05:00,2114,7CSCMFa9W52tBDVUbXbc3woAy3GByeA1wPJdp3MgznPa,3447ptuVFu6G8B6N63RmS8mRv4n9PfHneypHLvbeaGLn,True,637744643,159436159,965491,482745,482746,3zqXX6kzhkbW3d4TwD2CNjMRwxTbREXySekvq37kfCNk,38619667,213386053,-174766386,605
2022-01-07 03:41:13.603711,2022-01-06 22:32:32-05:00,2115,F2v1YwVAwXLiUgsJ5uwn4qAAkTXitn1E75fJcPnGuAcy,5rdJ4H5GxPg4Juu77mGc7uya5LwEqLzDSRyG8mQ2mDbK,True,81725915,20431478,126008,63004,63004,3zqXX6kzhkbW3d4TwD2CNjMRwxTbREXySekvq37kfCNk,5040321,31581636,-26541315,616
2022-01-07 03:41:13.603711,2022-01-06 22:32:33-05:00,2116,Bsr6kx1B6BSEd5UnJ7Z61M49iUb3bFrDVhiEtMVtPDF2,3CFd1pUJAJPA9fobwn4Jj2mRju1CWmoop4Mh4znypNWT,True,176092102,44023025,272351,136175,136176,DddJ7EWCmYEEZETCBNgAUSg81Ls6fZtiAaY5ekJ5sXx1,10894079,43923785,-33029706,618
2022-01-07 03:41:13.603711,2022-01-06 22:32:34-05:00,2117,DAku12iueL13vRoTpKLyqdGaLQ2rWF6REe8Dr8soFvNs,H2vVH3LxkhGe6x6Mdwy67BYwTKNQM6XayKx7mhrwyfJM,True,1887667,471916,2828,1414,1414,DddJ7EWCmYEEZETCBNgAUSg81Ls6fZtiAaY5ekJ5sXx1,113151,756737,-643586,599
2022-01-07 03:41:13.603711,2022-01-06 22:32:34-05:00,2118,6yw4GPvkqUbakcEWtqSCfjVLukty11xqjDpGxtEN9Km2,5ppEx7wkpqbG5nApCWMdRja3oRSheFmAAsNHUX7h2w2Y,True,6991921,1747980,10687,5343,5344,DddJ7EWCmYEEZETCBNgAUSg81Ls6fZtiAaY5ekJ5sXx1,427480,5232879,-4805399,611
2022-01-07 03:41:13.603711,2022-01-06 22:32:37-05:00,2119,ANQkPUoMjLHyRtypeKzxsKW1DFauQsh9SnB3rRgRXM1Y,7RHAExWpG8Q3PXwKhJs2yXmYK9WogGydvFYpx28p6pgr,True,307380856,76845214,471044,235522,235522,DddJ7EWCmYEEZETCBNgAUSg81Ls6fZtiAaY5ekJ5sXx1,18841792,143239518,-124397726,612
2022-01-07 03:41:13.603711,2022-01-06 22:32:37-05:00,2120,6eBSLXDMVoW2nG3n7s42RXDH8byY3C6n1RsUuegBLSrG,37dYrKnTXYer7Bu9xFfpArA4ZNo2B9bycFw9HywDtTRx,True,41979613,10494903,63333,31666,31667,DddJ7EWCmYEEZETCBNgAUSg81Ls6fZtiAaY5ekJ5sXx1,2533325,15625745,-13092420,603
2022-01-07 03:41:13.603711,2022-01-06 22:32:41-05:00,2121,6tFQaTqqffino9kwMZTL2xVNBG8k9VREFhXqVi2si3A3,3w3wGxBbS4bmXeqmvd595SAWFeXekVpnH4UdbeEs8Sx5,True,18556402,4639100,28351,14175,14176,GAUsoe8ZTCiGPm2hYxRPGxcPe5ShNzHK9eE3G2zgRjxd,1134042,5072028,-3937986,611
2022-01-07 03:41:13.603711,2022-01-06 22:32:41-05:00,2122,2FrqGFZjbiNykJyo9BZ5S9FguQJPJiTi681rJJsQ5dta,3QUncYP92NKrfpaTvuF9iQg11PXKgZAgEngwh6BbnCCj,True,3496516,874129,5309,2654,2655,GAUsoe8ZTCiGPm2hYxRPGxcPe5ShNzHK9eE3G2zgRjxd,212382,1109453,-897071,607
2022-01-07 03:41:13.603711,2022-01-06 22:32:42-05:00,2123,6dr65yANjSMmfBeKAuSxG3i16S9vMgF1CQ3zDyzh55Pn,EhrE5QpnshD41S4zPEBy2A5q2Gs2mwUrbHGo6WnT9zDP,True,1416011,354002,2096,1048,1048,3zqXX6kzhkbW3d4TwD2CNjMRwxTbREXySekvq37kfCNk,83876,566307,-482431,592
2022-01-07 03:41:13.603711,2022-01-06 22:32:43-05:00,2124,E8ifvhmyJGBGVQomo3AnZw2UcaLHcpGsTtuoCid8voU3,FMQUWTbTAfSLfrc6GTrz4DM2ZSgoxF3KtqGn8AyjVtsf,True,30140590,7535147,46700,23350,23350,DddJ7EWCmYEEZETCBNgAUSg81Ls6fZtiAaY5ekJ5sXx1,1868019,8083973,-6215954,619
2022-01-07 03:41:13.603711,2022-01-06 22:32:43-05:00,2125,3Lv2XpiD4KBUHq7Zx6u3zNhpXoySodXHH8o8f5yaaPxG,H6TN4rhpBXkEH3mZnymYNcKfmnxRH2uzfwzeLH2q6ahP,True,790488,197622,1174,587,587,DddJ7EWCmYEEZETCBNgAUSg81Ls6fZtiAaY5ekJ5sXx1,46971,264130,-217159,594
2022-01-07 03:41:13.603711,2022-01-06 22:32:44-05:00,2126,2F45BX9mRmtNCHPejKFknN5aNgGvR4vVLFjMaY1a7dR8,ALdSutsvEFRUEQGGBbi31QywTL1pdXSDWrNJzvNTaoXL,True,106195252,26548813,165342,82671,82671,DddJ7EWCmYEEZETCBNgAUSg81Ls6fZtiAaY5ekJ5sXx1,6613715,39290422,-32676707,622
2022-01-07 03:41:13.603711,2022-01-06 22:32:45-05:00,2127,6CeKxTJvFqhyNEyzySiBBKEwYVMe7j3A6nkMes4BW6o2,DzDR9XvwY1z7ygQ8YrCXrwDGHSf67JZF8BzUnuFE2fxQ,True,18525742,4631435,27601,13800,13801,3zqXX6kzhkbW3d4TwD2CNjMRwxTbREXySekvq37kfCNk,1104042,5072688,-3968646,595
2022-01-07 03:41:13.603711,2022-01-06 22:32:47-05:00,2128,9UyQC8vc6zJJaSdnjvTAzgmcsw4fC3xFBBiCC1w9Sbjx,3ppBfboe6FPmt7f6WrivspMUoAznZKWQMeh3rCgw7vjQ,True,37959153,9489788,59016,29508,29508,GAUsoe8ZTCiGPm2hYxRPGxcPe5ShNzHK9eE3G2zgRjxd,2360655,9397006,-7036351,621
2022-01-07 03:41:13.603711,2022-01-06 22:32:47-05:00,2129,8NdcaYUC1X5CP7FMDip78uqtqmCt8GcZdCzLRTYTihmb,9Ei1K9bXWXSXcBfeX5exPSXGCAu62WSKzvnnd4wHvyVh,True,556213,139053,844,422,422,DddJ7EWCmYEEZETCBNgAUSg81Ls6fZtiAaY5ekJ5sXx1,33771,189342,-155571,607
2022-01-07 03:41:13.603711,2022-01-06 22:32:50-05:00,2130,EmGW2aAG69ssWqCtbfDocRaM2u3TJsczn2HHP9jdmRvD,aypkDKsp9uqAB4F6mwvm5LofpsrFBuZT2MMWtE2eHdB,True,2734843,683710,4201,2100,2101,3zqXX6kzhkbW3d4TwD2CNjMRwxTbREXySekvq37kfCNk,168044,992417,-824373,614
2022-01-07 03:41:13.603711,2022-01-06 22:32:50-05:00,2131,GGGyesjbt7h2XHHp9u8vpiWGugFwEbrtYaKrNQSDhQd7,8tydo1ZjGHmPBSqU33tywB3f9szdsHk1ckGFe4Ay5pgs,True,213738158,53434539,318071,159035,159036,3zqXX6kzhkbW3d4TwD2CNjMRwxTbREXySekvq37kfCNk,12722875,135215658,-122492783,595
2022-01-07 03:41:13.603711,2022-01-06 22:32:50-05:00,2132,9zpPiboHF5HW7NfCx7hYdmJGwUomVMTiUFc4Um5KrDi3,8q3eBpuwV6dMNkib9N8XQAq2tBUcjSANRe5SXpd4dFhZ,True,34786480,8696620,54193,27096,27097,GAUsoe8ZTCiGPm2hYxRPGxcPe5ShNzHK9eE3G2zgRjxd,2167740,8623778,-6456038,623
2022-01-07 03:41:13.603711,2022-01-06 22:32:51-05:00,2133,8VnGmfop6qcUezAJ2M15jz2Nn6mPQgehDcJPvypq4XJn,6F6sqXNhgkW9ev8QNMm4ydywUUmemhwgydRQYNeqyUmi,True,44848135,11212033,67583,33791,33792,3zqXX6kzhkbW3d4TwD2CNjMRwxTbREXySekvq37kfCNk,2703326,32855230,-30151904,602
2022-01-07 03:41:13.603711,2022-01-06 22:33:14-05:00,2134,6NJFN855M3Q3RLTDNo57gTgAmwPD6G2E3WvMb1m5eNCN,3YpqNnonsvXaRT4nCC3G5FZx1jjVtbDPc36LiR6WK5jR,True,457150424,114287606,709718,354859,354859,3zqXX6kzhkbW3d4TwD2CNjMRwxTbREXySekvq37kfCNk,28388746,197956855,-169568109,620
2022-01-07 03:41:13.603711,2022-01-06 22:33:23-05:00,2135,GxFxvEUdWofneMmVvhCSScH9V6Zia5WJ2J9q6CpPnaq3,ATLykiHDii3Lw53MoZXwqu1FbBNPJbVNVGe2SoQMjVmY,True,26369806,6592451,41100,20550,20550,72FwbpFGoLEazJEdpqNtPNefsadUrimUqma9wSoy4qiS,1644029,9016723,-7372694,623
2022-01-07 03:41:13.603711,2022-01-06 22:34:36-05:00,2136,8swGZMrPrLAxZd7MxTbkCL13k3DmAJUw41jCp6Xo6awW,3fKnX7yTNXAT4uMmXVdTy47ALJT8h8YSD3WiBb4BGuzH,True,1394614360,348653590,2170936,1085468,1085468,3zqXX6kzhkbW3d4TwD2CNjMRwxTbREXySekvq37kfCNk,86837457,433795228,-346957771,622
2022-01-07 03:41:13.603711,2022-01-06 22:34:36-05:00,2137,D64rDiWT3YG28fCgXCmbNjYa2JakZbpKQ1D2XuLChUfV,8WmMWq8cTsGQym5pUbHm9dPCpJugBeWUMVERYFGLxWHj,True,214444465,53611116,330897,165448,165449,3zqXX6kzhkbW3d4TwD2CNjMRwxTbREXySekvq37kfCNk,13235917,48761452,-35525535,617
2022-01-07 03:41:13.603711,2022-01-06 22:35:44-05:00,2138,8E3K7vCHJ2xjdFofPRGLbMxrkm8UYEi926QmXPAFwsqe,4qHUDA1c43Dg4qi1ZPKqmpGYiEMUZ6r4UuzB5ftHCEhW,True,8514050494,2128512623,13305718,6652859,6652859,DddJ7EWCmYEEZETCBNgAUSg81Ls6fZtiAaY5ekJ5sXx1,532228735,3252564903,-2720336168,625
2022-01-07 03:41:13.603711,2022-01-06 22:35:58-05:00,2139,FhAt6pZW3k8StP9VLeWUfidpXfRLoKWdV7Wgxdh9cRy9,Guk93pTo3KcG8konHjJ52oi9rgexmmKhPQAkxZS1BtCG,True,1050728651,262682161,1640749,820374,820375,3zqXX6kzhkbW3d4TwD2CNjMRwxTbREXySekvq37kfCNk,65629996,347903258,-282273262,624
2022-01-07 03:41:13.603711,2022-01-06 22:37:56-05:00,2140,DMgPzJnMQfvpk6LWscs9V9CwnYDj4CEUgKB9S65WsTaY,BZRSLH1Vw1BQwXTZtBcgUYqmFF7TuzYxAaZ8TXUKwLUQ,True,37130,9282,57,28,29,3zqXX6kzhkbW3d4TwD2CNjMRwxTbREXySekvq37kfCNk,2312,15611,-13299,622
2022-01-07 03:41:13.603711,2022-01-06 22:37:57-05:00,2141,BAzH5niE2GX9CHGn3jK6Wv8Dd59PT95dX4dgfZXWoLPT,YNRnuEoNBPFsr7W91gc85TXAdA4ZnXfF2x951zbeRKF,True,130264,32565,202,101,101,GAUsoe8ZTCiGPm2hYxRPGxcPe5ShNzHK9eE3G2zgRjxd,8089,46914,-38825,620
2022-01-07 03:41:13.603711,2022-01-06 22:37:57-05:00,2142,Hy3kzXneDN6FUkiZctU1vWe97BYvj6yZ7QvQzehfWmNr,EhXgQg8BTniANV525RpY76z7Hrh6DuqrMChjqEoXfVJe,True,5489634,1372408,8586,4293,4293,GAUsoe8ZTCiGPm2hYxRPGxcPe5ShNzHK9eE3G2zgRjxd,343464,2229197,-1885733,625
2022-01-07 03:41:13.603711,2022-01-06 22:37:57-05:00,2143,864zY9zuCktUurPTtdGeLvUATnDqHZpT1GeWUApsXh2m,CzatBrNJUi7MeyfbNhszRaPMidgt8Xkcmy5ZwFMP9RCs,True,119037368,29759342,185202,92601,92601,3zqXX6kzhkbW3d4TwD2CNjMRwxTbREXySekvq37kfCNk,7408102,40917228,-33509126,622
2022-01-07 03:41:13.603711,2022-01-06 22:38:46-05:00,2144,G25vsB3sDqRhHoSK4KwR1TywfrJDtpejVbbevEG9sQ9a,5xFC3Hm13magnAA9GD1EnwC9PrPoEfQ7omEa9p9zCrB1,True,5339237,1334808,8255,4127,4128,3zqXX6kzhkbW3d4TwD2CNjMRwxTbREXySekvq37kfCNk,330215,1750381,-1420166,618
2022-01-07 03:41:13.603711,2022-01-06 22:39:06-05:00,2145,8WHDaiE6LqFFmCVMnPeLEQ99R6ft8b74UfmP9BqzjcE8,CGmoDGsdnjo3zMNrW78n2xxQr1aDPAiBYiXbyciLXYMu,True,1166607005,291651750,1820495,910247,910248,DddJ7EWCmYEEZETCBNgAUSg81Ls6fZtiAaY5ekJ5sXx1,72819831,355598533,-282778702,624
2022-01-07 03:41:13.603711,2022-01-06 22:39:07-05:00,2146,2VyFcgZDH1HTEvD1XaWhwqBCMmZ1k6TmZ3fEpPcBZR9E,G1wFJETTpdoc7CfypGCzkq1jssXPfUkiuLjK2cwVZ9dJ,True,341551,85387,534,267,267,DddJ7EWCmYEEZETCBNgAUSg81Ls6fZtiAaY5ekJ5sXx1,21378,136909,-115531,625
2022-01-07 03:41:13.603711,2022-01-06 22:39:27-05:00,2147,BWtXpiXn1bomr28mGfQFTx1Kd58CQipEnKmeweYowDEC,9jws1qkXvWAdEtBvURVEeGcGJzt4zG2gh8AJESvjKKrx,True,620484968,155121242,970843,485421,485422,DddJ7EWCmYEEZETCBNgAUSg81Ls6fZtiAaY5ekJ5sXx1,38833722,262279569,-223445847,625
2022-01-07 03:41:13.603711,2022-01-06 22:39:40-05:00,2148,5SwL5U5hhQXPW1HXFf4GuU4xkmXoAKx58pjY53NPHqWS,7zB7JvYFzEEwawJy7k7NXvBSG3UsbQte7JxgwvBNbS7U,True,1135670371,283917592,1776526,888263,888263,3zqXX6kzhkbW3d4TwD2CNjMRwxTbREXySekvq37kfCNk,71061069,476367994,-405306925,625
2022-01-07 03:41:13.603711,2022-01-06 22:39:43-05:00,2149,67Z7ZGhNu5xxEh9BYKWcXp9m1T4tFiE1o1M16hCzUWQA,CT7YKWixz7BhTbvg5F6M5HCyPGnHoFLNFuDV9GhoLTo3,True,13836145,3459036,21612,10806,10806,3zqXX6kzhkbW3d4TwD2CNjMRwxTbREXySekvq37kfCNk,864517,6454784,-5590267,624
2022-01-07 03:41:13.603711,2022-01-06 22:39:46-05:00,2150,CvZssqscu2dm35mwcE3zg9zedavbRjVJjWD59Py5ExUK,7pXaoR6aHKYofCmg1eHipygNYDteEaf8rbbS8BDYGQK6,True,2980136,745034,4651,2325,2326,3zqXX6kzhkbW3d4TwD2CNjMRwxTbREXySekvq37kfCNk,186041,813699,-627658,624
2022-01-07 03:41:13.603711,2022-01-06 22:40:06-05:00,2151,pgzvXpnUYiY7hLrfjmwScqLd8oj9vYcXpFvpm4y4JvG,GdqdQgoyBAFuXdbvoZyDhB3jyqJzVo4nkGh7EPFxkBF2,True,8976374,2244093,14045,7022,7023,DddJ7EWCmYEEZETCBNgAUSg81Ls6fZtiAaY5ekJ5sXx1,561800,6756517,-6194717,625
2022-01-07 03:41:13.603711,2022-01-06 22:40:26-05:00,2152,DdYgcyV1T2CDYiQVr4VL9Ym8RdKm93a7SKy8HxuyaoMW,GPdAeqeXb1UJ56AttcwwY1CyFhRyfptDC4BAX2Tc8MpE,True,2238282,559570,3502,1751,1751,3zqXX6kzhkbW3d4TwD2CNjMRwxTbREXySekvq37kfCNk,140082,901497,-761415,625
2022-01-07 03:41:13.603711,2022-01-06 22:40:26-05:00,2153,6nJyqvFKprwaVCE1gAa2P4RHKc6Pa6XFSJymx654zZ9K,4e7iJmdwzAPxp1Zi8Azo38YyPQdPKqqY4VLJyQ5rpdYP,True,10607998,2651999,16588,8294,8294,3zqXX6kzhkbW3d4TwD2CNjMRwxTbREXySekvq37kfCNk,663539,4312672,-3649133,625
2022-01-07 03:41:13.603711,2022-01-06 22:41:12-05:00,2154,BZxJ6CtrVoiU86DMMieMeDFLNWtMpHGTvZfM7nyay6o4,6CRxRR8bisRLHFJBFWjyumYuy7j4C4PkjYH1K8gXhdWD,True,12168644,3042159,19042,9521,9521,3zqXX6kzhkbW3d4TwD2CNjMRwxTbREXySekvq37kfCNk,761684,2936807,-2175123,625
2022-01-07 03:50:59.794373,2022-01-06 22:41:34-05:00,2155,Ckqos6cdncPKj13DnCmDVZsZTqp6eS7277CRrT9WhcEr,AtUV8m7VQJvZq7GLCAHMf3jV7iamKEPnWVZHWuuVZQp1,True,5279660,1319915,8199,4099,4100,3zqXX6kzhkbW3d4TwD2CNjMRwxTbREXySekvq37kfCNk,327986,2615374,-2287388,621
2022-01-07 03:50:59.794373,2022-01-06 22:41:34-05:00,2156,9vcKW1GfrDZ3KLPh2pEVFF8ZyKqD1pJW1hiE8H98Av7S,C6Ki27mo4sCHu6u8UnR1p7WSgsTjFQxGGR9Lk9n5Rhjq,True,11813483,2953370,18331,9165,9166,3zqXX6kzhkbW3d4TwD2CNjMRwxTbREXySekvq37kfCNk,733245,4501926,-3768681,620
2022-01-07 03:50:59.794373,2022-01-06 22:41:35-05:00,2157,zLTuMVfVswjMkhyvjaXnvjcKXv5xNk3iSWSjRGpVqXf,J3D8NHUJCiSjvFYfJ5Es4YDhF1KcPZWRUmCQ5L92t8eB,True,517612018,129403004,807041,403520,403521,DddJ7EWCmYEEZETCBNgAUSg81Ls6fZtiAaY5ekJ5sXx1,32281651,160755345,-128473694,623
2022-01-07 03:50:59.794373,2022-01-06 22:41:35-05:00,2158,2jPxG5FL6D6XEJsRszJ9cmQ54AWSpZyPFSbn3DpWBSuM,3toQou4UVNvyWYvMvkuv379RVEF2aN2TzCpKKBUqeQV6,True,821192343,205298085,1282044,641022,641022,3zqXX6kzhkbW3d4TwD2CNjMRwxTbREXySekvq37kfCNk,51281799,266851856,-215570057,624
2022-01-07 03:50:59.794373,2022-01-06 22:41:37-05:00,2159,Gbxc51WERLLeCtiHv7rDvE52aqF541RoQWG5n5aqErq6,4ngBoHbfXijLMqGKxFMNht9sbmxy2g5eqBmn8QsBmbx1,True,3213404,803350,5009,2504,2505,4BnQKPLuE3DMTtxp8MjUBytgnhvxqq3ZTqZHTVZo4JJh,200386,1194230,-993844,623
2022-01-07 03:50:59.794373,2022-01-06 22:41:37-05:00,2160,CBL2NbekJrXvBiAcoj4fzQ4PfLDwTntW7Zt4nruHFYEw,59EvfgYTdKkfjUJz5LddLUAqbEdLaihcMzjcrTZsyzyS,True,39783,9945,61,30,31,4BnQKPLuE3DMTtxp8MjUBytgnhvxqq3ZTqZHTVZo4JJh,2472,12884,-10412,621
2022-01-07 03:50:59.794373,2022-01-06 22:41:37-05:00,2161,6cnA7PeqQgpZdA7jBg4yMzTusm8JJHRWBMup84ywJfYo,FLqcukY7RehqY6ACrwVJnGH3eRgRDe93K1jLYCQN2F3U,True,464426888,116106722,725307,362653,362654,3zqXX6kzhkbW3d4TwD2CNjMRwxTbREXySekvq37kfCNk,29012296,198943722,-169931426,624
2022-01-07 03:50:59.794373,2022-01-06 22:41:38-05:00,2162,CRaKcudjkQiSw5YPVjTLVdXvJskeGiHSYtq5ZcMPJhgQ,AgqTg3b3bAcaBmRidhNC4Uf9ZwNbeH52RQEqumWyuUs7,True,3681381,920345,5674,2837,2837,3zqXX6kzhkbW3d4TwD2CNjMRwxTbREXySekvq37kfCNk,226997,1824516,-1597519,616
2022-01-07 03:50:59.794373,2022-01-06 22:41:39-05:00,2163,M69XSefqeum2arinvHEqmA3L2XHWNFN17p4msRhRZXf,2vK15yYUANLSbAoiBfgJ9VLyqsmtEpd2iNytQjms8GaQ,True,1152042072,288010518,1787864,893932,893932,GAUsoe8ZTCiGPm2hYxRPGxcPe5ShNzHK9eE3G2zgRjxd,71514588,601962189,-530447601,620
2022-01-07 03:50:59.794373,2022-01-06 22:41:39-05:00,2164,HVZkXeDR3mc8oB9qFFwCK4RXpPojdcHk9tRGep6xtKGK,Bh3py7awPejWqeTMxtAgF7mPotL2Asxf8YrYJykq9nBt,True,28038777,7009694,43611,21805,21806,GAUsoe8ZTCiGPm2hYxRPGxcPe5ShNzHK9eE3G2zgRjxd,1744478,9304066,-7559588,622
2022-01-07 03:50:59.794373,2022-01-06 22:41:41-05:00,2165,3qnPsgqW11AcDEmyjmJquPcPLyE3EdJQuVLJ5kinDrd3,86rZadBB7emKio76aFTahpbrFtxd9tqZ4Mxgzaavq2xU,True,671832,167958,1049,524,525,3zqXX6kzhkbW3d4TwD2CNjMRwxTbREXySekvq37kfCNk,41988,224456,-182468,624
2022-01-07 03:50:59.794373,2022-01-06 22:41:41-05:00,2166,6oroGB3mvzK3tDfiB9X2NJuL3x476pxhgRnt7VxqhdLo,2SoK8tKkLn2ppKURpTVazKsCEis4uahkHMsac1m85J4r,True,7616904,1904226,11831,5915,5916,3zqXX6kzhkbW3d4TwD2CNjMRwxTbREXySekvq37kfCNk,473270,5511342,-5038072,621
2022-01-07 03:50:59.794373,2022-01-06 22:41:53-05:00,2167,5rW9kqXB9feGSKSvSMNJF1FCsBYV3vGmTmc8MvzaZ3pi,7AjnjcfPJevW5521hXw4VtgRCfHSsAqyzyArukKfNcHo,True,46764183,11691045,72977,36488,36489,4BnQKPLuE3DMTtxp8MjUBytgnhvxqq3ZTqZHTVZo4JJh,2919104,19148558,-16229454,624
2022-01-07 03:50:59.794373,2022-01-06 22:41:57-05:00,2168,BrHRMouGRz3LBNzd9anfdYMhWfg8yUPHL4PqJ8WdEDFS,4uzoLa3mC2VYHAPBoHLX4gTjPTC28rPf2fvEGtJWPYc,True,258651050,64662762,402005,201002,201003,3zqXX6kzhkbW3d4TwD2CNjMRwxTbREXySekvq37kfCNk,16080232,176486018,-160405786,621
2022-01-07 03:50:59.794373,2022-01-06 22:41:57-05:00,2169,8sneA6wAg6geVDJ1g7YWg4R1PfjuRVzeHp1nUBJinhZa,14i1uWtmcTjrdbg3DSr9vzd5NBnxqsn1A4QdgFBZqeYM,True,514527,128631,803,401,402,3zqXX6kzhkbW3d4TwD2CNjMRwxTbREXySekvq37kfCNk,32128,175270,-143142,624
2022-01-07 03:50:59.794373,2022-01-06 22:41:57-05:00,2170,DmEVzPyCKnm89v481V2ic57vyikwwMja75uVZ2rjvjfp,38fPZzP4NwTtx7Qu6DLSqx9Sv8e5CQbSrr2BMvVmSy4J,True,136601287,34150321,213090,106545,106545,3zqXX6kzhkbW3d4TwD2CNjMRwxTbREXySekvq37kfCNk,8523628,59597368,-51073740,623
2022-01-07 03:50:59.794373,2022-01-06 22:41:57-05:00,2171,2FEbsetZMkRqLjSC8GBbgecKgX5T1T1fci2sLQux29p8,H722Fcd6DkTFRZxqQWbPDufBfXEgmFfhiEpQZWhxwYv1,True,20535203,5133800,32006,16003,16003,3zqXX6kzhkbW3d4TwD2CNjMRwxTbREXySekvq37kfCNk,1280263,6053368,-4773105,623
2022-01-07 03:50:59.794373,2022-01-06 22:41:57-05:00,2172,U3vvMQ4X4aKzVYfhMw1V1p58HRqaLnuXozqmmefYeD9,7JA94MArkNCFRhBq8f5a32DgMF6aPdFsoC5HvXDQ6NuR,True,1334841213,333710303,2080296,1040148,1040148,3zqXX6kzhkbW3d4TwD2CNjMRwxTbREXySekvq37kfCNk,83211846,557107728,-473895882,623
2022-01-07 03:50:59.794373,2022-01-06 22:41:59-05:00,2173,CagSUfZLwXuCdypC4KzU6FSNdmCj9dKDroPcNeaRtsyt,yxw5d1ztZuEUY2QjL7eLpr72QJAj5rJd6ERvg91cy1m,True,6874908,1718727,10659,5329,5330,GAUsoe8ZTCiGPm2hYxRPGxcPe5ShNzHK9eE3G2zgRjxd,426389,1984725,-1558336,620
2022-01-07 03:50:59.794373,2022-01-06 22:42:00-05:00,2174,DC4UVUDFWL3gVtgkX9hPtFgtxaA8DH5p94i4k9U3wyWv,3HCWqVvQQfRgSKitsTjGTduJ82ointZUSNtj13uea4kD,True,10680296858,2670074214,16608119,8304059,8304060,3zqXX6kzhkbW3d4TwD2CNjMRwxTbREXySekvq37kfCNk,664324785,2576157563,-1911832778,622
2022-01-07 03:50:59.794373,2022-01-06 22:42:00-05:00,2175,HGJoZvLakWfSDFwuvShNBc4kCf7nP7VqzyM3mELpbFEf,12Qn5jin7QvsBngXqYAv4UstyG3b6nRf1jsLp9Dp8G7k,True,68933024,17233256,107307,53653,53654,4BnQKPLuE3DMTtxp8MjUBytgnhvxqq3ZTqZHTVZo4JJh,4292294,24340550,-20048256,622
2022-01-07 03:50:59.794373,2022-01-06 22:42:00-05:00,2176,GqAS41YJssg9aaEp3hs3sG98APCsXhiQBQszXaSjZ2bN,2wodJ3AhrXdE1T4oVL95KvoBND7PubG5Wd5GWiLCMZJU,True,807265491,201816372,1255329,627664,627665,3zqXX6kzhkbW3d4TwD2CNjMRwxTbREXySekvq37kfCNk,50213170,554829916,-504616746,622
2022-01-07 03:50:59.794373,2022-01-06 22:42:05-05:00,2177,7PzGZgzieFyyFs1dbajkNQgVxooFUNZrj1bUsQvrSwbp,A2gDREmSmJTBPPw3sbKVY3smC9wbHMDdv87gr4Tr2ES7,True,12085615,3021403,18784,9392,9392,GAUsoe8ZTCiGPm2hYxRPGxcPe5ShNzHK9eE3G2zgRjxd,751398,4044718,-3293320,621
2022-01-07 03:50:59.794373,2022-01-06 22:42:07-05:00,2178,B4Uc39nKzz9wBRQsCkMR4A7RwTJ8rSuwpR6EQn2AesRb,H49bGZgatRZVpj6QufZRVgYrQtH7LpdbiqKBs23151m,True,109993369,27498342,171506,85753,85753,GAUsoe8ZTCiGPm2hYxRPGxcPe5ShNzHK9eE3G2zgRjxd,6860277,83753650,-76893373,623
2022-01-07 03:50:59.794373,2022-01-06 22:42:07-05:00,2179,ymyzGH4Qc7HH5PbKpVphCbsQgLLXyGkPcXamQJuNj5C,8oTLHaV2XzbKXNWRuUjCfHjUn61Pw93LYK14m9q2VDpZ,True,58454945,14613736,91077,45538,45539,DddJ7EWCmYEEZETCBNgAUSg81Ls6fZtiAaY5ekJ5sXx1,3643097,16898667,-13255570,623
2022-01-07 03:50:59.794373,2022-01-06 22:42:07-05:00,2180,9WJBnVi84E926j7xEd566WzrZJkPJWRgmEnYj9vyjuad,4dLaFS5F7TGyLdwuJLMGkz3bSL53aHzd9ZfpNmhHxXeF,True,92091867,23022966,141430,70715,70715,3zqXX6kzhkbW3d4TwD2CNjMRwxTbREXySekvq37kfCNk,5657228,34888871,-29231643,614
2022-01-07 03:50:59.794373,2022-01-06 22:42:07-05:00,2181,DvuRmJkfn6FQczUKgYeaSCqwy2NTMunuAKNrnmxMvnzS,7LpWTX9dgBtW75kfEoB5WuNsDwEdw5s8CYSHh3J4qagM,True,517463740,129365935,799296,399648,399648,DddJ7EWCmYEEZETCBNgAUSg81Ls6fZtiAaY5ekJ5sXx1,31971840,185344754,-153372914,617
2022-01-07 03:50:59.794373,2022-01-06 22:42:10-05:00,2182,3C2MZQKh9x4zNTCMbhhvoafGaFMwUooqfy9MCgPyXs6E,AHjgWKpYPWe6ketjDHDKFBFsKQiRJ41jnkuo39MVYxZo,True,899716166,224929041,1399614,699807,699807,3zqXX6kzhkbW3d4TwD2CNjMRwxTbREXySekvq37kfCNk,55984597,418690241,-362705644,622
2022-01-07 03:50:59.794373,2022-01-06 22:42:10-05:00,2183,4uygLJDk9DFCifJ56YwMrEsvd3oQNq8tYSLnMCyWorS6,GimL4uKGvg3FFmFQSWzAcjstv3Vmk5NMgDGMKTuXYVpB,True,3107403747,776850936,4748078,2374039,2374039,DddJ7EWCmYEEZETCBNgAUSg81Ls6fZtiAaY5ekJ5sXx1,189923142,909027835,-719104693,611
2022-01-07 03:50:59.794373,2022-01-06 22:42:10-05:00,2184,DYCYiQFH9QHzCo3eAw1pFoDu7pzwFMo1E2WDZjVFRz5w,CPh4FWsGak1kd1WFEH9qBjNhnun3R2tHtZA57zW8ugn5,True,220358009,55089501,339026,169513,169513,DddJ7EWCmYEEZETCBNgAUSg81Ls6fZtiAaY5ekJ5sXx1,13561047,90930553,-77369506,615
2022-01-07 03:50:59.794373,2022-01-06 22:42:14-05:00,2185,AUH6YGBV8tDVX1E1WTo92Mubfx1DGsqfGeyUBqxo4fSr,33QZgMwmW32WuvmxD8XNbmF9ea88bLe3YTtNwHV73Wwu,True,1252255239,313063809,1948482,974241,974241,3zqXX6kzhkbW3d4TwD2CNjMRwxTbREXySekvq37kfCNk,77939285,285534046,-207594761,622
2022-01-07 03:50:59.794373,2022-01-06 22:42:14-05:00,2186,8kJu5aqVSmW8FSZR9h6F75ftn9V2U9uMLBEKeqRaC855,FhVHByujkvwwtjTVpZ4mqSUqoMoBgeLUc5H7rbz3FgAt,True,529602910,132400727,812173,406086,406087,4BnQKPLuE3DMTtxp8MjUBytgnhvxqq3ZTqZHTVZo4JJh,32486954,234189070,-201702116,613
2022-01-07 03:50:59.794373,2022-01-06 22:42:15-05:00,2187,399591e8XgY52yCMorCQ2WL6dQZTC485ZooHtmGuirhZ,JCiXAooFmKmEPQ2S7C8iSk6CLcTyrPEe1SsPSLyUGySe,True,6414578,1603644,9819,4909,4910,DddJ7EWCmYEEZETCBNgAUSg81Ls6fZtiAaY5ekJ5sXx1,392765,2836683,-2443918,612
2022-01-07 03:50:59.794373,2022-01-06 22:42:24-05:00,2188,FsMiJiJZibohKoV5QRisWCjzuFd86xSxFb4m73AQmu93,7p3TSKBaG9SV2YNDnhutQKacPKpTTmgsEfzmK51t6sYb,True,1250126552,312531638,1949676,974838,974838,3zqXX6kzhkbW3d4TwD2CNjMRwxTbREXySekvq37kfCNk,77987043,277740491,-199753448,623
2022-01-07 03:50:59.794373,2022-01-06 22:42:24-05:00,2189,A4tDE948CPFPh1UwHb8sXryfKktbxZ8BCkqXgA5DJHA8,3zXeKMrsEpCe5fQumLNzCgpxcG1kLJFEAtJuqxLsC6ZG,True,518679330,129669832,801147,400573,400574,3zqXX6kzhkbW3d4TwD2CNjMRwxTbREXySekvq37kfCNk,32045915,166255594,-134209679,617
2022-01-07 03:50:59.794373,2022-01-06 22:42:24-05:00,2190,D9VKhnfLLCrntDGFYSfoxFaY76VnHmYZ1ZbyFXdKdibz,2hRCRH2pMDyQGYcXHa8Y6BZo6FbcGZf5VJC1v8Bp6tGa,True,550556319,137639079,850269,425134,425135,4BnQKPLuE3DMTtxp8MjUBytgnhvxqq3ZTqZHTVZo4JJh,34010785,145318156,-111307371,617
2022-01-07 03:50:59.794373,2022-01-06 22:42:24-05:00,2191,FnAT8HKGgisYfeAbxKU2gSbCp8KbZHULRpaJX1NVijHy,2u637Crc2QzfSJmCnRNqeib3aZQVn4NGncpgM3Ph6jvm,True,205325382,51331345,318567,159283,159284,3zqXX6kzhkbW3d4TwD2CNjMRwxTbREXySekvq37kfCNk,12742687,45627305,-32884618,620
2022-01-07 03:50:59.794373,2022-01-06 22:42:24-05:00,2192,BPsM1um9ZJf7eNoVMsQCRSwgARMuLCGGSDxf9tZeNeEy,BpzDdXfxVygiSYSmsHV6uPxQMeTFtrURMCCqhswQjd5X,True,5124017,1281004,8018,4009,4009,3zqXX6kzhkbW3d4TwD2CNjMRwxTbREXySekvq37kfCNk,320740,1524214,-1203474,625
2022-01-07 03:50:59.794373,2022-01-06 22:42:47-05:00,2193,7iUx7JBwqUvPVPeCqMEXQdLccZJmaFYm1DUQiu3ouHa3,3EVZzhRmJnX9ZiBZZo9tenDtMogAyuA1yf2cKzvUWiuu,True,3638968,909741,5690,2845,2845,3zqXX6kzhkbW3d4TwD2CNjMRwxTbREXySekvq37kfCNk,227611,1378598,-1150987,625
2022-01-07 03:50:59.794373,2022-01-06 22:42:47-05:00,2194,DMgD2KCEhTGFLUZ5GnfNcwfiiwKYbyVpoWiN6knMkCAf,5KU2vgBkPTNVHsSULjgX7ZkZS56U3Dy3xqLTxL5sUZJ3,True,6058199100,1514549775,9480337,4740168,4740169,4BnQKPLuE3DMTtxp8MjUBytgnhvxqq3ZTqZHTVZo4JJh,379213489,2998846952,-2619633463,625
2022-01-07 03:50:59.794373,2022-01-06 22:42:53-05:00,2195,EanSXRkJu91FKUhPCzYxWkmM3PQUWcovEnoZXcd6vQ9E,Fg4EzAzHStoLRDPmoBUczdWnWrhAb7jKEujqAujLFT8,True,1173143505,293285876,1804290,902145,902145,DddJ7EWCmYEEZETCBNgAUSg81Ls6fZtiAaY5ekJ5sXx1,72171634,357890722,-285719088,615
2022-01-07 03:50:59.794373,2022-01-06 22:42:55-05:00,2196,Dc11Q7yj9HoSfndRUB8Ffaz5BcYNFnvbVWuRn8v7Zs7C,BC35JUb1znJxJhcaivpyUPt8Ydojec2ohC1TrFv7TntJ,True,1493978301,373494575,2289695,1144847,1144848,3zqXX6kzhkbW3d4TwD2CNjMRwxTbREXySekvq37kfCNk,91587821,537058757,-445470936,613
2022-01-07 03:50:59.794373,2022-01-06 22:43:09-05:00,2197,3VdSA9CED9f5swRwHX2U15U7J6Muaq8VPnCNy9CaGDHe,2YYstfnfdYic5NWmEbcUEHpccNUVd1EhuCkExvMsoMk8,True,29995653,7498913,46639,23319,23320,3zqXX6kzhkbW3d4TwD2CNjMRwxTbREXySekvq37kfCNk,1865595,13371327,-11505732,621
2022-01-07 03:50:59.794373,2022-01-06 22:43:10-05:00,2198,AvwHizRhHUSahmvSg4jmTUErc7vAFSmkRAEsiKhXfW1m,3UrWYx8y9N5o9GYneSe6zyyHRTZzxwvcipQfHHYh7tEs,True,15688310,3922077,24373,12186,12187,3zqXX6kzhkbW3d4TwD2CNjMRwxTbREXySekvq37kfCNk,974948,4029079,-3054131,621
2022-01-07 03:50:59.794373,2022-01-06 22:43:12-05:00,2199,9KD2AifD5wFD4QkHYuawXbJgLWHrfj2QPF3fT8jhGVA5,Ga9gAqmkuHbqrr31sUFPqa1xa5WNxLWJWGPUaMxQqLdj,True,5821287,1455321,8963,4481,4482,3zqXX6kzhkbW3d4TwD2CNjMRwxTbREXySekvq37kfCNk,358552,2634057,-2275505,615
2022-01-07 03:50:59.794373,2022-01-06 22:43:12-05:00,2200,36ByQojnxEckWdQTjqHfxKqCx9yjqWQsPsZyqaN72UWR,AZoirtS1fjX61agRM64tqThVinnJTh3BWgiHyNHPTgZP,True,3555651,888912,5473,2736,2737,3zqXX6kzhkbW3d4TwD2CNjMRwxTbREXySekvq37kfCNk,218946,1558878,-1339932,615
2022-01-07 03:50:59.794373,2022-01-06 22:43:19-05:00,2201,6uZobpBuFcQeYgZ4dApFi6iy4DB9GLHP1AAsQcCj6212,SGGFiPjjhscwroiWMqY4jTAHFw8eakpsEv35wNoHUPY,True,571665187,142916295,884767,442383,442384,3zqXX6kzhkbW3d4TwD2CNjMRwxTbREXySekvq37kfCNk,35390706,161068827,-125678121,619
2022-01-07 03:50:59.794373,2022-01-06 22:43:20-05:00,2202,8xQ3tsWVUe75EG1HmocULJ3kh52utveoFMEPotTGrKno,i3SKW3ywrwYucX9ySEx1C4zaUKGnzLerP3V38437NyV,True,261436594,65359147,405423,202711,202712,DddJ7EWCmYEEZETCBNgAUSg81Ls6fZtiAaY5ekJ5sXx1,16216927,94211292,-77994365,620
2022-01-07 03:50:59.794373,2022-01-06 22:43:20-05:00,2203,BYvjENe16Ta77PqGV7JKEWrsqCTfkMGYwTSG5gXneDvd,EvxAXgvhPC6QkNurbK7vWyTApGo8J2R4EgMAknkHVU3d,True,13129614,3282403,20450,10225,10225,4BnQKPLuE3DMTtxp8MjUBytgnhvxqq3ZTqZHTVZo4JJh,818019,6670884,-5852865,623
2022-01-07 03:50:59.794373,2022-01-06 22:43:22-05:00,2204,5Rxuqgs4CaSKbfDXqBMFXkLTQ9dxrUjThXzoy3ouYVtK,BgvbKru66ebrGUcFFymGTmsaQv6GgcGMybiWaXqzBtwX,True,925771,231442,1445,722,723,3zqXX6kzhkbW3d4TwD2CNjMRwxTbREXySekvq37kfCNk,57820,439066,-381246,624
2022-01-07 03:50:59.794373,2022-01-06 22:43:28-05:00,2205,Cs2YxkuqBK1kjoYZbUZdUcxapPbv8oC75trwGgWoCPfG,2PgHQM1GhHykE4bQ1ggueAw2Zs1BFUW5hxvMvr8DojKM,True,241296413,60324103,376318,188159,188159,4BnQKPLuE3DMTtxp8MjUBytgnhvxqq3ZTqZHTVZo4JJh,15052739,111224434,-96171695,623
2022-01-07 03:50:59.794373,2022-01-06 22:43:28-05:00,2206,6rb3fRVWJ5cSzFcmuC1YwdrNxiNctvboDF7HwsfyGoCA,H6JaYfFZkRk6iSJrA4nVeuFpMVQtVwQZHVgK1TyaupTE,True,184249,46062,287,143,144,4BnQKPLuE3DMTtxp8MjUBytgnhvxqq3ZTqZHTVZo4JJh,11496,121023,-109527,623
2022-01-07 03:50:59.794373,2022-01-06 22:43:30-05:00,2207,DR7XL3qweFyTKDatQYS2LacqGLv2368cnGuWpEpk4hSL,Fd3BYCiiQfThDJsxBUNwYTMP8eNCrnXMVzE1wpejJqXa,True,20256,5064,31,15,16,GAUsoe8ZTCiGPm2hYxRPGxcPe5ShNzHK9eE3G2zgRjxd,1260,8448,-7188,622
2022-01-07 03:50:59.794373,2022-01-06 22:43:31-05:00,2208,FFoYoBmkfEsCWVXQf3BhKeaFMZD3YVKvfhPWkXdnCZS9,8yW6WApAuN43brF1HioTLdyxvQTQJzt875E26QqrWWFk,True,2352303,588075,3662,1831,1831,3zqXX6kzhkbW3d4TwD2CNjMRwxTbREXySekvq37kfCNk,146491,494188,-347697,622
2022-01-07 03:50:59.794373,2022-01-06 22:43:32-05:00,2209,CwTus4FyoXYqyTKAYDp69NLhA1joYZ3tarzY6FFTr6fn,6ivuvYWU6i25MzJSY8rG9rPDKiq38E6QtrV1jvRubLGr,True,44446,11111,69,34,35,GAUsoe8ZTCiGPm2hYxRPGxcPe5ShNzHK9eE3G2zgRjxd,2770,15194,-12424,623
2022-01-07 03:50:59.794373,2022-01-06 22:43:32-05:00,2210,FV9CBGGTbppLnBKh79f2LzD1diTiS5g6u89FcpZHZmnK,Fe7mtmCUziFqbbYTvrhAcAq1Ub7YLfTJRtQ1hG7GzJD1,True,23096868,5774217,35857,17928,17929,3zqXX6kzhkbW3d4TwD2CNjMRwxTbREXySekvq37kfCNk,1434287,6822453,-5388166,620
2022-01-07 03:50:59.794373,2022-01-06 22:43:37-05:00,2211,3ogBPSRcKfmwzgumVDHBkXLi1eCsEFG2xzSJgD4LQDNy,7TXyqWgJqfe71MSWFA2n7ufZbUdzf7JJoWej8FNNtMXo,True,93808155,23452038,146067,73033,73034,GAUsoe8ZTCiGPm2hYxRPGxcPe5ShNzHK9eE3G2zgRjxd,5842703,25767856,-19925153,622
2022-01-07 03:50:59.794373,2022-01-06 22:43:37-05:00,2212,Br1j5Ftafei7ysu5SmqVZSoRe4uS4qCPeKSPHg55pyiE,G8fc7QvXjfkgBFvAVUgJFQS3VaF1biL9rktBExGa87Ks,True,11767326918,2941831728,18393760,9196880,9196880,4BnQKPLuE3DMTtxp8MjUBytgnhvxqq3ZTqZHTVZo4JJh,735750408,3880883143,-3145132735,625
2022-01-07 03:50:59.794373,2022-01-06 22:43:40-05:00,2213,3WcJUt8jQ1ngL3ZCGo6dFrc3GmTMTYtzeDva7mri2Tqx,HeG1Pz2oMjqtkfsRMsbqP3VpatnVEQzcWmKDVoFp4Htr,True,68912905,17228226,107190,53595,53595,DddJ7EWCmYEEZETCBNgAUSg81Ls6fZtiAaY5ekJ5sXx1,4287600,24355976,-20068376,622
2022-01-07 03:50:59.794373,2022-01-06 22:43:48-05:00,2214,GjQQ2fQ7mrGjWZwjVYFUKp9NM1LmfkhEo675ovU5SPa8,ECgVUMRY5nB4MALs5drDyipF7YohCPuJpj2UegCs7HMn,True,96415063,24103765,148384,74192,74192,3zqXX6kzhkbW3d4TwD2CNjMRwxTbREXySekvq37kfCNk,5935363,29710358,-23774995,615
2022-01-07 03:50:59.794373,2022-01-06 22:43:51-05:00,2215,G5NLYTLxDZfJFKsJdMeWS8Ez95ZFwR5AX4hKhnfVJvoE,AwrC3pKhTeEDr1HCTWoKWjadteZccvqcisbC7vxTjn7w,True,56569866,14142466,88136,44068,44068,DddJ7EWCmYEEZETCBNgAUSg81Ls6fZtiAaY5ekJ5sXx1,3525468,24976223,-21450755,623
2022-01-07 03:50:59.794373,2022-01-06 22:43:54-05:00,2216,F9s8a7Cpiw5dw3a2aNFMofqwyDWNXvDLnSdJzoj1gRiV,GpKsQKJD79KBRWdCTkyi4zX7NaoCWsLUjrKxAwJB6o6s,True,127406093,31851523,197830,98915,98915,4BnQKPLuE3DMTtxp8MjUBytgnhvxqq3ZTqZHTVZo4JJh,7913235,16148266,-8235031,621
2022-01-07 03:50:59.794373,2022-01-06 22:43:59-05:00,2217,6Bq55LtGCEeGqh4JrFLCmmGc2iJfTTBJixivqH78aGSE,DSNrCgWJeNe2P9tAQu5FvCueTzNKDKds7wzuwTQSMRG,True,29154736,7288684,45540,22770,22770,DddJ7EWCmYEEZETCBNgAUSg81Ls6fZtiAaY5ekJ5sXx1,1821634,8450387,-6628753,624
2022-01-07 03:50:59.794373,2022-01-06 22:44:00-05:00,2218,8xvLGVeDmhVYQhN2ZpWkVG9jCrukRsNQ4926a4TMiZqa,9ciBySSjvADwp47WkETiFWZKVTFL8Hf1XvK7aSxhcgQS,True,110805116,27701279,171386,85693,85693,GAUsoe8ZTCiGPm2hYxRPGxcPe5ShNzHK9eE3G2zgRjxd,6855443,34142526,-27287083,618
2022-01-07 03:50:59.794373,2022-01-06 22:44:07-05:00,2219,5Z3ZFCA65WoWhm3okRuuziEMi7ajGAEHWUFchzBNba5S,FcomdrWidygkxMKzcsY5xELbmwC652uMci648LMTv7AB,True,42555,10638,66,33,33,3zqXX6kzhkbW3d4TwD2CNjMRwxTbREXySekvq37kfCNk,2646,13977,-11331,621
2022-01-07 03:50:59.794373,2022-01-06 22:44:07-05:00,2220,2PzBAkdXkrwH9VuoMALumQz86qkW7sSBQtCrHw14JUp3,D5vwWAMHVooobG2sCWv9EwtJrAFZG6cwKH4dfmA98tbt,True,8900968,2225242,13772,6886,6886,GAUsoe8ZTCiGPm2hYxRPGxcPe5ShNzHK9eE3G2zgRjxd,550891,3039409,-2488518,618
2022-01-07 03:50:59.794373,2022-01-06 22:44:07-05:00,2221,F1JT1p2VuwK4L7zj7NNnZtYiZiNUCcTGKDkgdoX3BZdZ,3BKe4yzTwnnBnvTWP3britpPJ4oAWL7JZJzNLCxjUufS,True,22234,5558,34,17,17,3zqXX6kzhkbW3d4TwD2CNjMRwxTbREXySekvq37kfCNk,1371,3754,-2383,616
2022-01-07 03:50:59.794373,2022-01-06 22:44:08-05:00,2222,EhANPABkSw9x9WnsDEi8pCg67iQTX2UGTTUpyjADTwdN,4FKLi98hyg9ZjM4MY6ctJsv7B6vPUnTYWdhrnNoYsztX,True,34331976,8582994,53500,26750,26750,4BnQKPLuE3DMTtxp8MjUBytgnhvxqq3ZTqZHTVZo4JJh,2140031,14996558,-12856527,623
2022-01-07 03:50:59.794373,2022-01-06 22:44:09-05:00,2223,i7TcF4weYcqgrRdH3GpndbEYxCxfcSfr9JWYrAUg1CF,BkDfknUir7PnSEW8auoB87PytycEFwyX5kT2GY4SGJJL,True,18093540,4523385,28186,14093,14093,3zqXX6kzhkbW3d4TwD2CNjMRwxTbREXySekvq37kfCNk,1127455,12694159,-11566704,623
2022-01-07 03:50:59.794373,2022-01-06 22:44:09-05:00,2224,7D4rFmGMPKNAF75VRPxHAhSn2wTjiW8jmth1UD22Xqq9,GQ7BrT6vsXu8tHCMm75YdxFR2r9QTCrCUbdPEZBSAg9w,True,164032462,41008115,254027,127013,127014,GAUsoe8ZTCiGPm2hYxRPGxcPe5ShNzHK9eE3G2zgRjxd,10161082,45255044,-35093962,619
2022-01-07 03:50:59.794373,2022-01-06 22:44:24-05:00,2225,7vKmhLV45Q5etXhJL5ng8rxWhYSiUCDmAbGnwBPr7zcx,cP6xPeuHLnjr858QK1F9qYn7rJpEbPy7wEJHoju6oV7,True,148107130,37026782,229186,114593,114593,3zqXX6kzhkbW3d4TwD2CNjMRwxTbREXySekvq37kfCNk,9167463,49979406,-40811943,618
2022-01-07 03:50:59.794373,2022-01-06 22:44:42-05:00,2226,DrzTARa7RK8RXoxHZPKCBqYtMC8TAUHRw8SznXRKTa5M,FYANet92VhyXkKZqqBJR4sFxuCftWb68sgQU9VHCdTJk,True,112761,28190,170,85,85,3zqXX6kzhkbW3d4TwD2CNjMRwxTbREXySekvq37kfCNk,6835,36476,-29641,606
2022-01-07 03:50:59.794373,2022-01-06 22:44:49-05:00,2227,HutRztBianNUgm9sJDWKUQBmoVyy8y7CfnNk4hHjSkEW,EtVfvPyiy5bizbCZxR19TNUgETf3QcmziBvMtc6o5zjr,True,842301756,210575439,1305406,652703,652703,GAUsoe8ZTCiGPm2hYxRPGxcPe5ShNzHK9eE3G2zgRjxd,52216275,618581770,-566365495,619
2022-01-07 03:50:59.794373,2022-01-06 22:44:49-05:00,2228,CK3ocyWzXQkJJZQmM6bBK4Nv6Rh3UEufjY6DvNU6gJZy,C924o4GY3p2BHLeAbFbe9SEysXqCUyD8sFu2d4NzkAV7,True,22251103,5562775,33827,16913,16914,DddJ7EWCmYEEZETCBNgAUSg81Ls6fZtiAaY5ekJ5sXx1,1353089,6519674,-5166585,608
2022-01-07 03:50:59.794373,2022-01-06 22:44:49-05:00,2229,4MmpDGUTyMcYEqJ1RoZ46AN2BhrBUseHaHqF8AmiTPyD,7HW2YZpYM349HMfW7u4h9ESZ1AXkwN8JcVDTNFzp9aTz,True,410376718,102594179,638135,319067,319068,DddJ7EWCmYEEZETCBNgAUSg81Ls6fZtiAaY5ekJ5sXx1,25525427,178569046,-153043619,621
2022-01-07 03:50:59.794373,2022-01-06 22:44:49-05:00,2230,AKxRtcdpi7gWhAuL8ENj7zhgeQezzEXe9TSANE6bQoRA,2YH4vrU9deP8Cu6E8Hzf8GqKG1yVjv5pdz4FE7r5YKir,True,23383921,5845980,35935,17967,17968,DddJ7EWCmYEEZETCBNgAUSg81Ls6fZtiAaY5ekJ5sXx1,1437430,7808880,-6371450,614
2022-01-07 03:50:59.794373,2022-01-06 22:44:49-05:00,2231,9jdfc9GFTecsdRuTjWFGX13niKKmeBxRgtv5j86uhSnU,HLWMShobjSkaLyXrNjgwVaUGVtbtdUSnr1XjqpXn1bLR,True,1001285,250321,1555,777,778,3zqXX6kzhkbW3d4TwD2CNjMRwxTbREXySekvq37kfCNk,62200,378975,-316775,621
2022-01-07 03:50:59.794373,2022-01-06 22:44:49-05:00,2232,8vva9SmKpMGW8wjpkvydQczxVK6VtN79qzH2i4JQSwg4,F8a3GLicsSapt4aLURoU4qHxJaxCij4LS6JVxoMF3YHT,True,3280340,820085,5081,2540,2541,3zqXX6kzhkbW3d4TwD2CNjMRwxTbREXySekvq37kfCNk,203247,692907,-489660,619
2022-01-07 03:50:59.794373,2022-01-06 22:44:49-05:00,2233,8BMDSWFtzq9fu1ubVGtSFw8fEaMg1uvJiECuJnN8e1pd,FwkETAXL296CirvQ2AJuSHHtdKsxkZkmXSwZVVHXVDhA,True,444996014,111249003,694020,347010,347010,3zqXX6kzhkbW3d4TwD2CNjMRwxTbREXySekvq37kfCNk,27760807,145267673,-117506866,623
2022-01-07 03:50:59.794373,2022-01-06 22:44:50-05:00,2234,Ar5QB4VBcUyzSCG23z2QNAbrWY55NbHCr1MNN6P2GAmh,BusFGTiDrJmxzwGUxWz9b3SFF3eseqtgh2DRHqyAwyVe,True,1580361,395090,2442,1221,1221,DddJ7EWCmYEEZETCBNgAUSg81Ls6fZtiAaY5ekJ5sXx1,97715,562295,-464580,618
2022-01-07 03:50:59.794373,2022-01-06 22:44:50-05:00,2235,E1wp3bmkcY3eiEYyGYwhTCsr7BZ7RfPa5DJTZFupcFwj,452hVdYkD5SDDrA6hv6DLPFvyS8PvR2P6DPNScGxWTsW,True,2753209,688302,4184,2092,2092,3zqXX6kzhkbW3d4TwD2CNjMRwxTbREXySekvq37kfCNk,167396,973403,-806007,608
2022-01-07 03:50:59.794373,2022-01-06 22:44:50-05:00,2236,EeUACm9TkjHKES5U7Yj1oPhYmcp7R3tvesGBiP8txEzq,3qkmm4aS6EDirEDejmbm5PDw2jpYkC7zKqrMkmgeE5BA,True,789816,197454,1233,616,617,GAUsoe8ZTCiGPm2hYxRPGxcPe5ShNzHK9eE3G2zgRjxd,49330,221723,-172393,624
2022-01-07 03:50:59.794373,2022-01-06 22:44:50-05:00,2237,HqtTbC1LFreGvgfpZe7nCqkNnh8GHPQKosfmc19zb1yi,E39UNiHNkwQEd5GXkCtTPqSorQSB1kLx8kjzK4jdFoi3,True,1062331234,265582808,1645980,822990,822990,4BnQKPLuE3DMTtxp8MjUBytgnhvxqq3ZTqZHTVZo4JJh,65839223,417770478,-351931255,619
2022-01-07 03:50:59.794373,2022-01-06 22:44:50-05:00,2238,D3mXrJzhHf8qRaoCKLschUxAFoijFCFuT6bmNZH4W7Cj,9E3Xtqw7TncXWnbhAbFJMtuNmP6WS3ooGuptzyzw7UpA,True,197678,49419,306,153,153,3zqXX6kzhkbW3d4TwD2CNjMRwxTbREXySekvq37kfCNk,12242,93294,-81052,619
2022-01-07 03:50:59.794373,2022-01-06 22:44:50-05:00,2239,EV21gv8jEvXtmGDoGRNm5LJEvTBccLMZyVDCLsp54jP3,DGxxoU52aQNoUQcxdvQtv2H5q2PhK6TGkLgNSaFgnZrb,True,15250235,3812558,23784,11892,11892,4BnQKPLuE3DMTtxp8MjUBytgnhvxqq3ZTqZHTVZo4JJh,951392,5392260,-4440868,623
2022-01-07 03:50:59.794373,2022-01-06 22:44:50-05:00,2240,6XHt7CrURSomkQrtVXV5JuKSZY4tQRpUyQKfCDaSTYaD,GCgcmPSDDBsn2smYbpiX3PJybDkQWtufPu4YRsbEEU8X,True,1153373214,288343303,1802223,901111,901112,3zqXX6kzhkbW3d4TwD2CNjMRwxTbREXySekvq37kfCNk,72088924,601205561,-529116637,625
2022-01-07 03:50:59.794373,2022-01-06 22:44:50-05:00,2241,2rCRdyfi65rpxRRmg7knaSb8t55FuPt3h8wF4Fzhy8MM,CLVY5nSG3jTdRo7tRSKgK9DJgW6aswfWKe4tLxzsENmb,True,2152516,538129,3325,1662,1663,4BnQKPLuE3DMTtxp8MjUBytgnhvxqq3ZTqZHTVZo4JJh,133019,629880,-496861,617
2022-01-07 03:50:59.794373,2022-01-06 22:44:50-05:00,2242,D58t4uTjFumsUeYFaKnpV8BRTEQEqKXBreFTdwGrott7,67p6kHDfVqQijfcwugvZK59c3aRRH9x3eHxruqH8WEqF,True,3203860,800964,4993,2496,2497,4BnQKPLuE3DMTtxp8MjUBytgnhvxqq3ZTqZHTVZo4JJh,199740,1188353,-988613,623
2022-01-07 03:50:59.794373,2022-01-06 22:44:50-05:00,2243,Cb4zhnvig11U4GcC4kqKrnDicGgPhUpfDQB1U7hP3nPa,DiRAMrKqaevGXeXg38KnhaYBERj8tNKU7oWFJvhS32kw,True,688665,172166,1045,522,523,72FwbpFGoLEazJEdpqNtPNefsadUrimUqma9wSoy4qiS,41812,196899,-155087,607
2022-01-07 03:50:59.794373,2022-01-06 22:44:51-05:00,2244,46TNhGwBVzedW8xSb9UY94HNeSom9iGiZzAjrKHiRM2G,7JVTiqNYeKHbyzRkKtvSEpqLPKykZso8cGUr3sX1j7QF,True,188488200,47122049,292533,146266,146267,GAUsoe8ZTCiGPm2hYxRPGxcPe5ShNzHK9eE3G2zgRjxd,11701357,54402309,-42700952,620
2022-01-07 03:50:59.794373,2022-01-06 22:44:51-05:00,2245,89CkXnSZnr52Zsoh48efv9MQacrkB6GMtrbEpNJSyA2H,HcvRBS4Z22CpYgDNgm4TVF4AVXFDuYzBUAFcdHAwdpg4,True,10241097,2560274,15790,7895,7895,DddJ7EWCmYEEZETCBNgAUSg81Ls6fZtiAaY5ekJ5sXx1,631628,3426849,-2795221,616
2022-01-07 03:50:59.794373,2022-01-06 22:44:51-05:00,2246,9YEzjb49Awvedv9yNc6LG54SkGBug2RYiJwiUV13mGsS,3H8w5WCD187NWWoZMNUCzUDdxTgqrRJLga8gDzUVXBgZ,True,3748667,937166,5820,2910,2910,DddJ7EWCmYEEZETCBNgAUSg81Ls6fZtiAaY5ekJ5sXx1,232824,1911753,-1678929,621
2022-01-07 03:50:59.794373,2022-01-06 22:44:51-05:00,2247,GaEpNGa8jnwSRvjzzEMYkZe1pKcr2eiZtePrqFxpABjB,5CFZHuyWbJv14zPdX5dSQDREgHrCb4vsFvB6hLiEe3Ji,True,520417,130104,803,401,402,GAUsoe8ZTCiGPm2hYxRPGxcPe5ShNzHK9eE3G2zgRjxd,32124,176164,-144040,617
2022-01-07 03:50:59.794373,2022-01-06 22:44:51-05:00,2248,75ycx5sUFBxDhY1uwuPCW22s2C6BydkJTje7q7zEQFGT,FpEgrVFRubjGK4DRjTqdVbxSECURpn16zfpoC31NbwnN,True,21778040,5444510,33347,16673,16674,DddJ7EWCmYEEZETCBNgAUSg81Ls6fZtiAaY5ekJ5sXx1,1333909,9552839,-8218930,612
2022-01-07 03:50:59.794373,2022-01-06 22:44:51-05:00,2249,2NHv3c4ufYGo3xNr6KXymAZJdpfURrNiCKbXZ7s82Vwo,E4NYpYgHTvSG6LqH2bBV9Q1XJ6pAzCp9FLSKMzJmYRrQ,True,88350837,22087709,135110,67555,67555,GAUsoe8ZTCiGPm2hYxRPGxcPe5ShNzHK9eE3G2zgRjxd,5404405,39595117,-34190712,611
2022-01-07 03:50:59.794373,2022-01-06 22:44:53-05:00,2250,GJ3PbEfPK8jjrPgMmZtvN5fMSSy2dtiiAtZ8wcfgxVuc,FCUDVFb2TjDvehHE8fVBofqSykpb9W6Afc9QeHtj7te7,True,262362935,65590733,405363,202681,202682,3zqXX6kzhkbW3d4TwD2CNjMRwxTbREXySekvq37kfCNk,16214524,122660325,-106445801,618
2022-01-07 03:50:59.794373,2022-01-06 22:44:54-05:00,2251,7jvKp6onXyWgwsFrFWj4hYTXJsYYD6ot5mn6rPFuJriy,J7N6HiozevJVTiY9hDEUs2ud5BwT5QSE7wnMBS1w5ie2,True,138343704,34585926,216263,108131,108132,3zqXX6kzhkbW3d4TwD2CNjMRwxTbREXySekvq37kfCNk,8650523,60396709,-51746186,625
2022-01-07 03:50:59.794373,2022-01-06 22:44:56-05:00,2252,JCBhqqPQxP1Xc41sSY6e1sQKRstHhe7D1v6rLz4hp3Qp,DWMUq2bMD1jqpxHtyXDFjcAwjA27yyMRe68hGcsK143m,True,23816,5954,36,18,18,GAUsoe8ZTCiGPm2hYxRPGxcPe5ShNzHK9eE3G2zgRjxd,1475,7870,-6395,619
2022-01-07 03:50:59.794373,2022-01-06 22:44:56-05:00,2253,AtKuDfcFXqWUMnRqQpjedUMTb5CQKLc2zoqEAcQpysKQ,9bPFLYp5TDZruLLDXDYYCiPYcD982iF8xt5rfTkqwNsL,True,38043,9510,59,29,30,3zqXX6kzhkbW3d4TwD2CNjMRwxTbREXySekvq37kfCNk,2376,12272,-9896,624
2022-01-07 03:50:59.794373,2022-01-06 22:44:56-05:00,2254,BzSJ77zKaqtBk2cEL1XqFL97zTXXMRHmxtkgtXwCc3C,2g4KXTwy2MPSRQ2khNp1o1rn7CradEr9H4ySYKDoSWN9,True,34527248,8631812,53665,26832,26833,3zqXX6kzhkbW3d4TwD2CNjMRwxTbREXySekvq37kfCNk,2146621,28908646,-26762025,621
2022-01-07 03:50:59.794373,2022-01-06 22:44:56-05:00,2255,EQUZQWk4WLT6LFeWZs3P9AQufFcoZouFETfhyxvuS2JM,Byc2mLXArmkjQPWaxCJksHZD2XpZyCQ2FRtDJyztU81V,True,324859163,81214790,504706,252353,252353,3zqXX6kzhkbW3d4TwD2CNjMRwxTbREXySekvq37kfCNk,20188263,153580337,-133392074,621
2022-01-07 03:50:59.794373,2022-01-06 22:45:00-05:00,2256,2NdwSLxsGok8PczpCZj9CVX2BymNU5MvHt7hWfGetg2M,8AQbDXeA6mD9QoZBFJcYbnHvZwKNxzA9CCHLAgdSfTA3,True,36410,9102,56,28,28,3zqXX6kzhkbW3d4TwD2CNjMRwxTbREXySekvq37kfCNk,2261,15900,-13639,620
2022-01-07 03:50:59.794373,2022-01-06 22:45:22-05:00,2257,aTkGURJptmKNNP6RSXSWsmVbfcriSAJaMuUiT2eZEfb,5qoGxL83PLhrguyk27X8xE6jGitRg5BaQpXzrcfEvCfJ,True,1224163868,306040967,1905967,952983,952984,4BnQKPLuE3DMTtxp8MjUBytgnhvxqq3ZTqZHTVZo4JJh,76238701,284740050,-208501349,622
2022-01-07 03:50:59.794373,2022-01-06 22:45:55-05:00,2258,243SAnGxchCVB1LQAUF4SsozR86yDwEdg2QQpbWGsMYe,5u8sNkb2oEQjUXJAB3yGStmv3Uwz16gBgExBo5myVK4b,True,63276051,15819012,98473,49236,49237,4BnQKPLuE3DMTtxp8MjUBytgnhvxqq3ZTqZHTVZo4JJh,3938934,15683654,-11744720,622
2022-01-07 04:13:40.361885,2022-01-06 23:00:06-05:00,2259,GxFxvEUdWofneMmVvhCSScH9V6Zia5WJ2J9q6CpPnaq3,ATLykiHDii3Lw53MoZXwqu1FbBNPJbVNVGe2SoQMjVmY,True,19382186,4845546,30121,15060,15061,3zqXX6kzhkbW3d4TwD2CNjMRwxTbREXySekvq37kfCNk,1204862,7129578,-5924716,621
2022-01-07 04:13:40.361885,2022-01-06 23:06:47-05:00,2260,EF6H6aW1p3qcAtiLFU9rbFYfsKfD683meHXDw8hLdaZK,8vfJbpnK7SQcjpEBCzZJRW8JosNbsmTeJ2YXZCbM225c,True,418800040,104700009,651273,325636,325637,GmqQKnMfFxkv6ChqGaZ2wmSFDow7R1x7WeRfU58GVvfw,26050944,116965240,-90914296,622
2022-01-07 04:13:40.361885,2022-01-06 23:06:53-05:00,2261,JDeYjCLpfnzcfxDFgHf4aBcHsajwdR14GUaKAA9euzVf,EJbvKoyMZcoCx4vWa61uMbW2vr6mUhrgEuECdteVBuZZ,True,34459691,8614922,52504,26252,26252,DddJ7EWCmYEEZETCBNgAUSg81Ls6fZtiAaY5ekJ5sXx1,2100160,16191044,-14090884,609
2022-01-07 04:13:40.361885,2022-01-06 23:07:07-05:00,2262,Bsr6kx1B6BSEd5UnJ7Z61M49iUb3bFrDVhiEtMVtPDF2,3CFd1pUJAJPA9fobwn4Jj2mRju1CWmoop4Mh4znypNWT,True,129543243,32385810,201893,100946,100947,3zqXX6kzhkbW3d4TwD2CNjMRwxTbREXySekvq37kfCNk,8075747,35375098,-27299351,623
2022-01-07 04:13:40.361885,2022-01-06 23:07:15-05:00,2263,Mcbzp1LhZwpfmXTv1pqe9D1jCKHw443j9QKp6tUpzgM,8uforSMAKEih5jHfHp3gCqCvaugtCmhzVfVHA63Akz7F,True,6820159,1705039,10671,5335,5336,3zqXX6kzhkbW3d4TwD2CNjMRwxTbREXySekvq37kfCNk,426875,2991387,-2564512,625
2022-01-07 04:13:40.361885,2022-01-06 23:07:16-05:00,2264,56488NdcUy6Hi6X5SLs2GFtW5pG4u5wJpH7vHdxTCx4z,tGgXjJeVr3W2m3T2NXPCqpBEd6HJKE2cRsgCyiDZQy4,True,92779054,23194763,144954,72477,72477,DddJ7EWCmYEEZETCBNgAUSg81Ls6fZtiAaY5ekJ5sXx1,5798191,39582834,-33784643,624
2022-01-07 04:13:40.361885,2022-01-06 23:08:02-05:00,2265,HAk9c831TRUhvpoK4d7PTqfJuJhSjnJUXWpnYsH85bDJ,DVSa3CJrVLTHAeFYjEF89ZjWRm86QwruUk2Y8RvGpjsr,True,102833,25707,160,80,80,GAUsoe8ZTCiGPm2hYxRPGxcPe5ShNzHK9eE3G2zgRjxd,6412,39046,-32634,623
2022-01-07 04:13:40.361885,2022-01-06 23:08:09-05:00,2266,6WNPf4rFCX74PuyvdmzRFqbxWhguuxTQqBSdnaTVBd5D,9N7a9aiHGQsxFMgVbmWoCF9w95d12xyT7XFAwpHGkTLA,True,5145395,1286348,8045,4022,4023,3zqXX6kzhkbW3d4TwD2CNjMRwxTbREXySekvq37kfCNk,321817,1076422,-754605,625
2022-01-07 04:13:40.361885,2022-01-06 23:08:15-05:00,2267,BWtXpiXn1bomr28mGfQFTx1Kd58CQipEnKmeweYowDEC,9jws1qkXvWAdEtBvURVEeGcGJzt4zG2gh8AJESvjKKrx,True,455849533,113962383,706996,353498,353498,4BnQKPLuE3DMTtxp8MjUBytgnhvxqq3ZTqZHTVZo4JJh,28279841,205393591,-177113750,620
2022-01-07 04:13:40.361885,2022-01-06 23:08:15-05:00,2268,7CSCMFa9W52tBDVUbXbc3woAy3GByeA1wPJdp3MgznPa,3447ptuVFu6G8B6N63RmS8mRv4n9PfHneypHLvbeaGLn,True,469552622,117388154,720466,360233,360233,3zqXX6kzhkbW3d4TwD2CNjMRwxTbREXySekvq37kfCNk,28818663,168653618,-139834955,613
2022-01-07 04:13:40.361885,2022-01-06 23:08:17-05:00,2269,5SwL5U5hhQXPW1HXFf4GuU4xkmXoAKx58pjY53NPHqWS,7zB7JvYFzEEwawJy7k7NXvBSG3UsbQte7JxgwvBNbS7U,True,834634925,208658731,1301015,650507,650508,3zqXX6kzhkbW3d4TwD2CNjMRwxTbREXySekvq37kfCNk,52040624,373189383,-321148759,623
2022-01-07 04:13:40.361885,2022-01-06 23:08:18-05:00,2270,7oxuCEhooUZ5z2nnZRD226rcqdZgAR75SamX9DD7ejUf,CPqBb5ptWUPUJhVjshxNZCHd5RDF3fve29z4vz72JhvM,True,579737,144932,899,449,450,GAUsoe8ZTCiGPm2hYxRPGxcPe5ShNzHK9eE3G2zgRjxd,35984,159470,-123486,620
2022-01-07 04:13:40.361885,2022-01-06 23:08:19-05:00,2271,DMgPzJnMQfvpk6LWscs9V9CwnYDj4CEUgKB9S65WsTaY,BZRSLH1Vw1BQwXTZtBcgUYqmFF7TuzYxAaZ8TXUKwLUQ,True,27288,6821,42,21,21,3zqXX6kzhkbW3d4TwD2CNjMRwxTbREXySekvq37kfCNk,1691,12227,-10536,619
2022-01-07 04:13:40.361885,2022-01-06 23:08:19-05:00,2272,864zY9zuCktUurPTtdGeLvUATnDqHZpT1GeWUApsXh2m,CzatBrNJUi7MeyfbNhszRaPMidgt8Xkcmy5ZwFMP9RCs,True,87297055,21824263,130718,65359,65359,GAUsoe8ZTCiGPm2hYxRPGxcPe5ShNzHK9eE3G2zgRjxd,5228745,32342087,-27113342,598
2022-01-07 04:13:40.361885,2022-01-06 23:08:28-05:00,2273,8trkirSQNdMmAcJdeswxs5cPjH8dD6U4eJtWiAdMsrDB,HaSzpQ45x2MipfN17U6jGBxX8tXboomVDhXNSrnEfLDr,True,14602366,3650591,22705,11352,11353,GAUsoe8ZTCiGPm2hYxRPGxcPe5ShNzHK9eE3G2zgRjxd,908239,4722893,-3814654,621
2022-01-07 04:13:40.361885,2022-01-06 23:08:29-05:00,2274,6NJFN855M3Q3RLTDNo57gTgAmwPD6G2E3WvMb1m5eNCN,3YpqNnonsvXaRT4nCC3G5FZx1jjVtbDPc36LiR6WK5jR,True,336035281,84008820,519978,259989,259989,3zqXX6kzhkbW3d4TwD2CNjMRwxTbREXySekvq37kfCNk,20799133,154812377,-134013244,618
2022-01-07 04:13:40.361885,2022-01-06 23:08:40-05:00,2275,D64rDiWT3YG28fCgXCmbNjYa2JakZbpKQ1D2XuLChUfV,8WmMWq8cTsGQym5pUbHm9dPCpJugBeWUMVERYFGLxWHj,True,157765315,39441328,245309,122654,122655,GAUsoe8ZTCiGPm2hYxRPGxcPe5ShNzHK9eE3G2zgRjxd,9812391,39526379,-29713988,621
2022-01-07 04:13:40.361885,2022-01-06 23:09:04-05:00,2276,8swGZMrPrLAxZd7MxTbkCL13k3DmAJUw41jCp6Xo6awW,3fKnX7yTNXAT4uMmXVdTy47ALJT8h8YSD3WiBb4BGuzH,True,1025198266,256299566,1593601,796800,796801,GAUsoe8ZTCiGPm2hYxRPGxcPe5ShNzHK9eE3G2zgRjxd,63744041,344806527,-281062486,621
2022-01-07 04:42:53.536462,2022-01-06 23:16:54-05:00,2277,6cnA7PeqQgpZdA7jBg4yMzTusm8JJHRWBMup84ywJfYo,FLqcukY7RehqY6ACrwVJnGH3eRgRDe93K1jLYCQN2F3U,True,340872517,85218129,519692,259846,259846,4BnQKPLuE3DMTtxp8MjUBytgnhvxqq3ZTqZHTVZo4JJh,20787705,155692468,-134904763,609
2022-01-07 04:42:53.536462,2022-01-06 23:16:54-05:00,2278,DmEVzPyCKnm89v481V2ic57vyikwwMja75uVZ2rjvjfp,38fPZzP4NwTtx7Qu6DLSqx9Sv8e5CQbSrr2BMvVmSy4J,True,100305282,25076320,153741,76870,76871,DddJ7EWCmYEEZETCBNgAUSg81Ls6fZtiAaY5ekJ5sXx1,6149660,46601394,-40451734,613
2022-01-07 04:42:53.536462,2022-01-06 23:16:56-05:00,2279,DC4UVUDFWL3gVtgkX9hPtFgtxaA8DH5p94i4k9U3wyWv,3HCWqVvQQfRgSKitsTjGTduJ82ointZUSNtj13uea4kD,True,7846482977,1961620744,12069664,6034832,6034832,4BnQKPLuE3DMTtxp8MjUBytgnhvxqq3ZTqZHTVZo4JJh,482786593,2084303618,-1601517025,615
2022-01-07 04:42:53.536462,2022-01-06 23:16:58-05:00,2280,DvuRmJkfn6FQczUKgYeaSCqwy2NTMunuAKNrnmxMvnzS,7LpWTX9dgBtW75kfEoB5WuNsDwEdw5s8CYSHh3J4qagM,True,380059615,95014903,576918,288459,288459,3zqXX6kzhkbW3d4TwD2CNjMRwxTbREXySekvq37kfCNk,23076727,146154679,-123077952,607
2022-01-07 04:42:53.536462,2022-01-06 23:17:08-05:00,2281,EanSXRkJu91FKUhPCzYxWkmM3PQUWcovEnoZXcd6vQ9E,Fg4EzAzHStoLRDPmoBUczdWnWrhAb7jKEujqAujLFT8,True,863371981,215842995,1343767,671883,671884,4BnQKPLuE3DMTtxp8MjUBytgnhvxqq3ZTqZHTVZo4JJh,53750711,284575412,-230824701,622
2022-01-07 04:42:53.536462,2022-01-06 23:17:08-05:00,2282,Dc11Q7yj9HoSfndRUB8Ffaz5BcYNFnvbVWuRn8v7Zs7C,BC35JUb1znJxJhcaivpyUPt8Ydojec2ohC1TrFv7TntJ,True,1099845511,274961377,1712325,856162,856163,GAUsoe8ZTCiGPm2hYxRPGxcPe5ShNzHK9eE3G2zgRjxd,68493032,423318670,-354825638,622
2022-01-07 04:42:53.536462,2022-01-06 23:17:14-05:00,2283,2jDRvE3pQNjWy1NRFa4tzB3KmU5UkbUCHw8sQRFujo66,C4zNi2szDrEEh4coTF3WRUghfP4ZwAVVSYTLWfkejQRu,True,2114836316,528709078,3294190,1647095,1647095,3zqXX6kzhkbW3d4TwD2CNjMRwxTbREXySekvq37kfCNk,131767625,575663501,-443895876,623
2022-01-07 04:42:53.536462,2022-01-06 23:17:18-05:00,2284,HdfQweV1KuYSpWdycZbpGrUc8yMcY3ZczLn1agKXMJaf,G1Ae1PZHkANkwFnhUKS1tvdFEv8dAFeojBkezh6rUNMh,True,23634772,5908693,36889,18444,18445,4BnQKPLuE3DMTtxp8MjUBytgnhvxqq3ZTqZHTVZo4JJh,1475561,9018179,-7542618,624
2022-01-07 04:42:53.536462,2022-01-06 23:17:20-05:00,2285,8E3K7vCHJ2xjdFofPRGLbMxrkm8UYEi926QmXPAFwsqe,4qHUDA1c43Dg4qi1ZPKqmpGYiEMUZ6r4UuzB5ftHCEhW,True,6258784476,1564696119,9779751,4889875,4889876,3zqXX6kzhkbW3d4TwD2CNjMRwxTbREXySekvq37kfCNk,391190059,2561414440,-2170224381,625
2022-01-07 04:42:53.536462,2022-01-06 23:17:53-05:00,2286,9WJBnVi84E926j7xEd566WzrZJkPJWRgmEnYj9vyjuad,4dLaFS5F7TGyLdwuJLMGkz3bSL53aHzd9ZfpNmhHxXeF,True,67807097,16951774,106084,53042,53042,4BnQKPLuE3DMTtxp8MjUBytgnhvxqq3ZTqZHTVZo4JJh,4243385,27429299,-23185914,625
2022-01-07 04:42:53.536462,2022-01-06 23:17:54-05:00,2287,Gs3WP18hbzNpbBgiU39e6tfkggfCKRyNqPqJQcthuHFD,4XAY25YUma6gUdG2GdbXeivum3t21g93ZagfWGTZYkWZ,True,31331044,7832760,49001,24500,24501,4BnQKPLuE3DMTtxp8MjUBytgnhvxqq3ZTqZHTVZo4JJh,1960047,13312649,-11352602,625
2022-01-07 04:42:53.536462,2022-01-06 23:18:11-05:00,2288,FhAt6pZW3k8StP9VLeWUfidpXfRLoKWdV7Wgxdh9cRy9,Guk93pTo3KcG8konHjJ52oi9rgexmmKhPQAkxZS1BtCG,True,772539761,193134939,1208549,604274,604275,3zqXX6kzhkbW3d4TwD2CNjMRwxTbREXySekvq37kfCNk,48341963,275561118,-227219155,625
2022-01-07 04:42:53.536462,2022-01-06 23:18:28-05:00,2289,4uygLJDk9DFCifJ56YwMrEsvd3oQNq8tYSLnMCyWorS6,GimL4uKGvg3FFmFQSWzAcjstv3Vmk5NMgDGMKTuXYVpB,True,2288903167,572225791,3579171,1789585,1789586,3zqXX6kzhkbW3d4TwD2CNjMRwxTbREXySekvq37kfCNk,143166850,724545895,-581379045,625
2022-01-07 04:42:53.536462,2022-01-06 23:18:32-05:00,2290,399591e8XgY52yCMorCQ2WL6dQZTC485ZooHtmGuirhZ,JCiXAooFmKmEPQ2S7C8iSk6CLcTyrPEe1SsPSLyUGySe,True,4723902,1180975,7379,3689,3690,4BnQKPLuE3DMTtxp8MjUBytgnhvxqq3ZTqZHTVZo4JJh,295174,2215147,-1919973,624
2022-01-07 04:42:53.536462,2022-01-06 23:18:42-05:00,2291,8kJu5aqVSmW8FSZR9h6F75ftn9V2U9uMLBEKeqRaC855,FhVHByujkvwwtjTVpZ4mqSUqoMoBgeLUc5H7rbz3FgAt,True,389945767,97486441,608931,304465,304466,3zqXX6kzhkbW3d4TwD2CNjMRwxTbREXySekvq37kfCNk,24357253,182903317,-158546064,624
2022-01-07 04:42:53.536462,2022-01-06 23:18:53-05:00,2292,BAzH5niE2GX9CHGn3jK6Wv8Dd59PT95dX4dgfZXWoLPT,YNRnuEoNBPFsr7W91gc85TXAdA4ZnXfF2x951zbeRKF,True,95820,23953,149,74,75,3zqXX6kzhkbW3d4TwD2CNjMRwxTbREXySekvq37kfCNk,5995,36997,-31002,625
2022-01-07 04:42:53.536462,2022-01-06 23:18:57-05:00,2293,7ptPfZnqDCvTWotn8wPGyzERTJYLBgk47j7qf8Ciq941,AfAGcFqFFPi6LCQXydgsPWidN35c7NbhBa7RLEaDQQCu,True,13975499,3493872,21793,10896,10897,4BnQKPLuE3DMTtxp8MjUBytgnhvxqq3ZTqZHTVZo4JJh,871735,3719671,-2847936,623
2022-01-07 04:42:53.536462,2022-01-06 23:19:09-05:00,2294,AUH6YGBV8tDVX1E1WTo92Mubfx1DGsqfGeyUBqxo4fSr,33QZgMwmW32WuvmxD8XNbmF9ea88bLe3YTtNwHV73Wwu,True,920789078,230197269,1436098,718049,718049,3zqXX6kzhkbW3d4TwD2CNjMRwxTbREXySekvq37kfCNk,57443943,231604009,-174160066,623
2022-01-07 04:42:53.536462,2022-01-06 23:19:17-05:00,2295,BgnsCfJ54ReunUtwPJLzkW4PWnqpBDWGNYxsW5PvDrbK,KpMqEkQ9dKMgCevsEK895wHd3fCLRPSzDmJSv3tKU4u,True,47095875799,11773968949,73510565,36755282,36755283,DddJ7EWCmYEEZETCBNgAUSg81Ls6fZtiAaY5ekJ5sXx1,2940422612,13825892084,-10885469472,624
2022-01-07 04:42:53.536462,2022-01-06 23:19:17-05:00,2296,FsMiJiJZibohKoV5QRisWCjzuFd86xSxFb4m73AQmu93,7p3TSKBaG9SV2YNDnhutQKacPKpTTmgsEfzmK51t6sYb,True,915180428,228795107,1336962,668481,668481,GAUsoe8ZTCiGPm2hYxRPGxcPe5ShNzHK9eE3G2zgRjxd,53478487,225769205,-172290718,584
2022-01-07 04:42:53.536462,2022-01-06 23:19:19-05:00,2297,A4tDE948CPFPh1UwHb8sXryfKktbxZ8BCkqXgA5DJHA8,3zXeKMrsEpCe5fQumLNzCgpxcG1kLJFEAtJuqxLsC6ZG,True,379695320,94923830,546767,273383,273384,3zqXX6kzhkbW3d4TwD2CNjMRwxTbREXySekvq37kfCNk,21870684,131853546,-109982862,576
2022-01-07 04:42:53.536462,2022-01-06 23:19:19-05:00,2298,FnAT8HKGgisYfeAbxKU2gSbCp8KbZHULRpaJX1NVijHy,2u637Crc2QzfSJmCnRNqeib3aZQVn4NGncpgM3Ph6jvm,True,150311857,37577964,217955,108977,108978,GAUsoe8ZTCiGPm2hYxRPGxcPe5ShNzHK9eE3G2zgRjxd,8718225,37065519,-28347294,580
2022-01-07 04:42:53.536462,2022-01-06 23:19:19-05:00,2299,8WHDaiE6LqFFmCVMnPeLEQ99R6ft8b74UfmP9BqzjcE8,CGmoDGsdnjo3zMNrW78n2xxQr1aDPAiBYiXbyciLXYMu,True,856589734,214147433,1315041,657520,657521,4BnQKPLuE3DMTtxp8MjUBytgnhvxqq3ZTqZHTVZo4JJh,52601658,283072121,-230470463,614
2022-01-07 04:42:53.536462,2022-01-06 23:19:19-05:00,2300,D9VKhnfLLCrntDGFYSfoxFaY76VnHmYZ1ZbyFXdKdibz,2hRCRH2pMDyQGYcXHa8Y6BZo6FbcGZf5VJC1v8Bp6tGa,True,403024065,100756016,580093,290046,290047,GAUsoe8ZTCiGPm2hYxRPGxcPe5ShNzHK9eE3G2zgRjxd,23203750,116589747,-93385997,575
2022-01-07 04:42:53.536462,2022-01-06 23:19:23-05:00,2301,5BJnMHFSiQjHRGFJDW1jnqCfkHHYWnQzmmccy9eA4jNj,9517JGYsPmvgPUM9pFRD2vipHmdgE578F7jA7Qq6jorm,True,1710836857,427709214,2637819,1318909,1318910,HfEnetJ7uBSmZWCjBNxdvv9HEC5nsW4wDV7wu6WnhWan,105512772,566681333,-461168561,616
2022-01-07 04:42:53.536462,2022-01-06 23:19:25-05:00,2302,9KD2AifD5wFD4QkHYuawXbJgLWHrfj2QPF3fT8jhGVA5,Ga9gAqmkuHbqrr31sUFPqa1xa5WNxLWJWGPUaMxQqLdj,True,4266177,1066544,6228,3114,3114,3zqXX6kzhkbW3d4TwD2CNjMRwxTbREXySekvq37kfCNk,249127,2055547,-1806420,583
2022-01-07 04:42:53.536462,2022-01-06 23:19:25-05:00,2303,36ByQojnxEckWdQTjqHfxKqCx9yjqWQsPsZyqaN72UWR,AZoirtS1fjX61agRM64tqThVinnJTh3BWgiHyNHPTgZP,True,2613546,653385,3996,1998,1998,3zqXX6kzhkbW3d4TwD2CNjMRwxTbREXySekvq37kfCNk,159852,1217996,-1058144,611
2022-01-07 04:42:53.536462,2022-01-06 23:19:27-05:00,2304,A36aouot1oFLUtswuBUM4EVcis9chKaSJu53MRoPDjab,33U9gpq1RRFMGWDrWa3ezXXkwgBewdAS6QGgGVPtGvqb,True,1180336891,295084222,1738514,869257,869257,3zqXX6kzhkbW3d4TwD2CNjMRwxTbREXySekvq37kfCNk,69540590,289203699,-219663109,589
2022-01-07 04:42:53.536462,2022-01-06 23:19:27-05:00,2305,8xvLGVeDmhVYQhN2ZpWkVG9jCrukRsNQ4926a4TMiZqa,9ciBySSjvADwp47WkETiFWZKVTFL8Hf1XvK7aSxhcgQS,True,81471252,20367813,125965,62982,62983,GAUsoe8ZTCiGPm2hYxRPGxcPe5ShNzHK9eE3G2zgRjxd,5038612,27137028,-22098416,618
2022-01-07 04:42:53.536462,2022-01-06 23:19:31-05:00,2306,Dn916KSmX3HqxT53hrxrbCrV3tdRMCPdaoiRLqetMrth,ATCXRiXgnjRRUbSTPBvtBXMENCqsViexSZbZ6aDaXXWA,True,4066904,1016725,6331,3165,3166,3zqXX6kzhkbW3d4TwD2CNjMRwxTbREXySekvq37kfCNk,253243,1522570,-1269327,622
2022-01-07 04:42:53.536462,2022-01-06 23:19:31-05:00,2307,3VdSA9CED9f5swRwHX2U15U7J6Muaq8VPnCNy9CaGDHe,2YYstfnfdYic5NWmEbcUEHpccNUVd1EhuCkExvMsoMk8,True,21976043,5494010,32369,16184,16185,3zqXX6kzhkbW3d4TwD2CNjMRwxTbREXySekvq37kfCNk,1294791,10444830,-9150039,589
2022-01-07 04:42:53.536462,2022-01-06 23:19:31-05:00,2308,3ogBPSRcKfmwzgumVDHBkXLi1eCsEFG2xzSJgD4LQDNy,7TXyqWgJqfe71MSWFA2n7ufZbUdzf7JJoWej8FNNtMXo,True,68882387,17220596,105300,52650,52650,3zqXX6kzhkbW3d4TwD2CNjMRwxTbREXySekvq37kfCNk,4212033,20629989,-16417956,611
2022-01-07 04:42:53.536462,2022-01-06 23:19:32-05:00,2309,A1j2G5FZRyWSjFt6dK87WHhLkQrPUVqHaM3KhSzhAKDT,2fMiHLYm4pL3YCd8aveTR4mT9uVxztQeMwb5eRZb4wUW,True,2288129,572032,3558,1779,1779,4BnQKPLuE3DMTtxp8MjUBytgnhvxqq3ZTqZHTVZo4JJh,142323,853891,-711568,622
2022-01-07 04:42:53.536462,2022-01-06 23:19:32-05:00,2310,5Rxuqgs4CaSKbfDXqBMFXkLTQ9dxrUjThXzoy3ouYVtK,BgvbKru66ebrGUcFFymGTmsaQv6GgcGMybiWaXqzBtwX,True,679163,169790,1027,513,514,GAUsoe8ZTCiGPm2hYxRPGxcPe5ShNzHK9eE3G2zgRjxd,41102,342204,-301102,605
2022-01-07 04:42:53.536462,2022-01-06 23:19:40-05:00,2311,AvwHizRhHUSahmvSg4jmTUErc7vAFSmkRAEsiKhXfW1m,3UrWYx8y9N5o9GYneSe6zyyHRTZzxwvcipQfHHYh7tEs,True,11513124,2878281,17392,8696,8696,HfEnetJ7uBSmZWCjBNxdvv9HEC5nsW4wDV7wu6WnhWan,695713,3239429,-2543716,604
2022-01-07 04:42:53.536462,2022-01-06 23:19:46-05:00,2312,GjQQ2fQ7mrGjWZwjVYFUKp9NM1LmfkhEo675ovU5SPa8,ECgVUMRY5nB4MALs5drDyipF7YohCPuJpj2UegCs7HMn,True,70858268,17714567,108078,54039,54039,3zqXX6kzhkbW3d4TwD2CNjMRwxTbREXySekvq37kfCNk,4323148,23607762,-19284614,610
2022-01-07 04:42:53.536462,2022-01-06 23:20:01-05:00,2313,F9s8a7Cpiw5dw3a2aNFMofqwyDWNXvDLnSdJzoj1gRiV,GpKsQKJD79KBRWdCTkyi4zX7NaoCWsLUjrKxAwJB6o6s,True,93629729,23407432,144407,72203,72204,3zqXX6kzhkbW3d4TwD2CNjMRwxTbREXySekvq37kfCNk,5776289,13877907,-8101618,616
2022-01-07 04:42:53.536462,2022-01-06 23:20:35-05:00,2314,GxFxvEUdWofneMmVvhCSScH9V6Zia5WJ2J9q6CpPnaq3,ATLykiHDii3Lw53MoZXwqu1FbBNPJbVNVGe2SoQMjVmY,True,14240954,3560238,21976,10988,10988,4BnQKPLuE3DMTtxp8MjUBytgnhvxqq3ZTqZHTVZo4JJh,879055,5618293,-4739238,617
2022-01-07 04:42:53.536462,2022-01-06 23:20:35-05:00,2315,9jeqT7xKb8hr5VRuQEFxnf93Y3zHsvmYDHz64nyE7Wte,9NqYMu528mFG2M7RYL1NuEvR9aiNAW13WwXDKuprQa7h,True,163561125,40890281,254764,127382,127382,4BnQKPLuE3DMTtxp8MjUBytgnhvxqq3ZTqZHTVZo4JJh,10190593,67153710,-56963117,623
2022-01-07 04:42:53.536462,2022-01-06 23:20:59-05:00,2316,J1sBDjpdBZcsSBS5eg95SSRjRqmQUR9cXJCsLJu8yCUt,F5wRpD2senMkGbL8Uquqo8W9x5NQDDa268dHuVFAZCww,True,8351545,2087886,12953,6476,6477,4BnQKPLuE3DMTtxp8MjUBytgnhvxqq3ZTqZHTVZo4JJh,518142,3575753,-3057611,620
2022-01-07 04:42:53.536462,2022-01-06 23:20:59-05:00,2317,s2NgHqXLYtUrRaA6LnDwmxcS5nqfURXw47DmLy7Pn9E,2qn4QbLj5miEB2zZB4v5dhptm3JRbpQRrpTBgPDzokw1,True,7207689,1801922,11165,5582,5583,4BnQKPLuE3DMTtxp8MjUBytgnhvxqq3ZTqZHTVZo4JJh,446614,4637773,-4191159,619
2022-01-07 04:42:53.536462,2022-01-06 23:21:00-05:00,2318,aTkGURJptmKNNP6RSXSWsmVbfcriSAJaMuUiT2eZEfb,5qoGxL83PLhrguyk27X8xE6jGitRg5BaQpXzrcfEvCfJ,True,900035817,225008954,1400865,700432,700433,3zqXX6kzhkbW3d4TwD2CNjMRwxTbREXySekvq37kfCNk,56034603,230535982,-174501379,622
2022-01-07 04:42:53.536462,2022-01-06 23:21:00-05:00,2319,8xQ3tsWVUe75EG1HmocULJ3kh52utveoFMEPotTGrKno,i3SKW3ywrwYucX9ySEx1C4zaUKGnzLerP3V38437NyV,True,192302304,48075576,300100,150050,150050,3zqXX6kzhkbW3d4TwD2CNjMRwxTbREXySekvq37kfCNk,12004032,74276059,-62272027,624
2022-01-07 04:42:53.536462,2022-01-06 23:21:01-05:00,2320,DYCYiQFH9QHzCo3eAw1pFoDu7pzwFMo1E2WDZjVFRz5w,CPh4FWsGak1kd1WFEH9qBjNhnun3R2tHtZA57zW8ugn5,True,162188011,40547002,252841,126420,126421,HfEnetJ7uBSmZWCjBNxdvv9HEC5nsW4wDV7wu6WnhWan,10113667,71221958,-61108291,623
2022-01-07 04:42:53.536462,2022-01-06 23:21:10-05:00,2321,CAkknoa9UFPMEZ1KWSfqtmnL7ArVNV3HRETLwecuuXP,4cHJYv3dxA6qjcuxUkGRuL7STWobGPKtoHFD4ACUbiWq,True,35733809,8933452,55366,27683,27683,HfEnetJ7uBSmZWCjBNxdvv9HEC5nsW4wDV7wu6WnhWan,2214669,11827922,-9613253,619
2022-01-07 04:42:53.536462,2022-01-06 23:21:10-05:00,2322,7LRBswSEDBjJzQ4YurfTxLydh7tFS2jVn5V95Z6wL7ci,fD41VYGmk66MW46KKb23vAqQvUSDScgXnVdsHhJBZzu,True,402109,100527,621,310,311,3zqXX6kzhkbW3d4TwD2CNjMRwxTbREXySekvq37kfCNk,24854,163360,-138506,618
2022-01-07 04:42:53.536462,2022-01-06 23:21:10-05:00,2323,C7a8BtMjuLXkzxZBC4Wk2gjkGBmucLmDjokf9pyA1Mu6,GxwYNWwYTtFMUxuZvNC5qrEYuJzYiEURQVuBxssfCJzr,True,5231623,1307905,8128,4064,4064,GAUsoe8ZTCiGPm2hYxRPGxcPe5ShNzHK9eE3G2zgRjxd,325125,1093502,-768377,621
2022-01-07 04:42:53.536462,2022-01-06 23:21:11-05:00,2324,8VT2nxz5ZYDJFd9uL2XZwEXxChd9pjuMJNMAcutZubL1,EhAkiRbouzUAWtqQFsN8HEEfi46UVN8H8tyBP7CbgeLe,True,31309,7827,48,24,24,3zqXX6kzhkbW3d4TwD2CNjMRwxTbREXySekvq37kfCNk,1930,12210,-10280,616
2022-01-07 04:42:53.536462,2022-01-06 23:21:16-05:00,2325,FSduW743jAGyyn8HTifEJitgb89Spp5gEeMXDE59aEHF,HjojGNpR3ACtLCP2mP8DKGyXj6SeqWPKjcCAofcyQpsm,True,630521434,157630358,975948,487974,487974,3zqXX6kzhkbW3d4TwD2CNjMRwxTbREXySekvq37kfCNk,39037944,184996254,-145958310,619
2022-01-07 04:42:53.536462,2022-01-06 23:21:18-05:00,2326,5hUZ9uQFcYnjAQVVaGLJWdKyg7y1XMpoo8osQ9DeY7Xd,BdYiKWsjuzJLcHh3814mJ4xQ9JxoQKKcr7AHZ7Vxoavq,True,138423,34605,216,108,108,4BnQKPLuE3DMTtxp8MjUBytgnhvxqq3ZTqZHTVZo4JJh,8650,48181,-39531,624
2022-01-07 04:42:53.536462,2022-01-06 23:21:18-05:00,2327,BhiAaiZu7fF8ndggJrLyiFVCRq526cNBw7VaeascEmNL,4en8MipPi7vq15NGhpPMQfptNdEyhp2j7fpgxBBtjyfz,True,2776559,694139,4329,2164,2165,4BnQKPLuE3DMTtxp8MjUBytgnhvxqq3ZTqZHTVZo4JJh,173189,989842,-816653,623
2022-01-07 04:42:53.536462,2022-01-06 23:21:25-05:00,2328,243SAnGxchCVB1LQAUF4SsozR86yDwEdg2QQpbWGsMYe,5u8sNkb2oEQjUXJAB3yGStmv3Uwz16gBgExBo5myVK4b,True,46475509,11618877,71200,35600,35600,3zqXX6kzhkbW3d4TwD2CNjMRwxTbREXySekvq37kfCNk,2848017,12638191,-9790174,612
2022-01-07 04:42:53.536462,2022-01-06 23:21:28-05:00,2329,CFFpbRxYEP18rqEGxxyG3bzSV13Lv7nfSmZvtUK17kCP,824UwqH2JcFsqYBk9MZ8tTnpka9udTL6WGX35YFtAJQk,True,12102089,3025522,18934,9467,9467,3zqXX6kzhkbW3d4TwD2CNjMRwxTbREXySekvq37kfCNk,757369,4021749,-3264380,625
2022-01-07 04:42:53.536462,2022-01-06 23:21:50-05:00,2330,JDeYjCLpfnzcfxDFgHf4aBcHsajwdR14GUaKAA9euzVf,EJbvKoyMZcoCx4vWa61uMbW2vr6mUhrgEuECdteVBuZZ,True,25378988,6344747,39546,19773,19773,4BnQKPLuE3DMTtxp8MjUBytgnhvxqq3ZTqZHTVZo4JJh,1581875,12615877,-11034002,623
2022-01-07 04:42:53.536462,2022-01-06 23:21:58-05:00,2331,8mbMH9EKd9kQDyFrYiDJCV9VaWxWCzpZBQZLyYN2yNVx,J9gT39dF1egMeQvweXYWeRAX3kpmBABijYZhfj6M2UqU,True,76698211,19174552,119863,59931,59932,HfEnetJ7uBSmZWCjBNxdvv9HEC5nsW4wDV7wu6WnhWan,4794557,20897790,-16103233,625
2022-01-07 04:42:53.536462,2022-01-06 23:22:06-05:00,2332,Buioe5v3DyFwD9nquW5XdYeVYbSABCyg79eUHEvtvfaW,7T9gi7prCcZJkYJMSB5Ef6Bu4pAuBw4XLvumSFnqKDSi,True,2224395,556098,3478,1739,1739,4BnQKPLuE3DMTtxp8MjUBytgnhvxqq3ZTqZHTVZo4JJh,139127,1035899,-896772,625
2022-01-07 04:42:53.536462,2022-01-06 23:22:08-05:00,2333,C4dbwF9mioaBkZnyBFvFs6Cqd362VuGPBGPbTY9CAnAk,CcUqBfu1hbWm5VVxbtF2Xm6HUz4CLFzuDsjUi6KtnZQg,True,5591541,1397885,8746,4373,4373,3zqXX6kzhkbW3d4TwD2CNjMRwxTbREXySekvq37kfCNk,349850,1158309,-808459,625
2022-01-07 04:42:53.536462,2022-01-06 23:22:23-05:00,2334,CEbGTNX6WpaoKp4RBGSn9LzYM6yAYyeiMrgVYgJxA4zb,AiXUcGAFFm4tc7vKBscSNjZawV5YJqbv7D1KpxD3Zufg,True,62307262,15576815,97238,48619,48619,3zqXX6kzhkbW3d4TwD2CNjMRwxTbREXySekvq37kfCNk,3889535,28944793,-25055258,624
2022-01-07 04:42:53.536462,2022-01-06 23:22:24-05:00,2335,ZoNjrSjYh4NJLW38LUPcf7jtEBxdaaM7T1zp795qjHE,FZx6v8cU25NwEosbKJ2n141o9uFAWURZB7NeCeX1trEn,True,4801585,1200396,7497,3748,3749,3zqXX6kzhkbW3d4TwD2CNjMRwxTbREXySekvq37kfCNk,299909,998324,-698415,624
2022-01-07 04:42:53.536462,2022-01-06 23:23:16-05:00,2336,3zH1b58jqbNU37y9kDTZZrotSeT8XzS1tuyAHPKWrbah,4trxDWV16x6sVcz7bxHehYHkjjyKebh3S9fyJf8txzK5,True,23772,5943,36,18,18,3zqXX6kzhkbW3d4TwD2CNjMRwxTbREXySekvq37kfCNk,1476,7760,-6284,620
2022-01-07 04:42:53.536462,2022-01-06 23:23:18-05:00,2337,DiPSJvnnEwg1En7HJfEsKrUbBgtUf4KzGMyMCZDQSYgp,s8UVC6vPBofuXUS6RW1aQmZ8C35PrC5r4A6ugmvzLGB,True,6109342,1527335,9511,4755,4756,3zqXX6kzhkbW3d4TwD2CNjMRwxTbREXySekvq37kfCNk,380457,1271115,-890658,622
2022-01-07 04:42:53.536462,2022-01-06 23:23:18-05:00,2338,FjDp4bWCtqehFD7FunCrjrcdxMezTJj5aqh2VnBvHDQU,HRYeZqcqhP1RPiAGXziR1qCWwk4sF6c5ZYbvSDhX7foN,True,25188739,6297184,39140,19570,19570,3zqXX6kzhkbW3d4TwD2CNjMRwxTbREXySekvq37kfCNk,1565634,8014419,-6448785,621
2022-01-07 04:42:53.536462,2022-01-06 23:23:23-05:00,2339,93ho4cgnpAJiJsG6uu2udkLVNU7rkz4QjCYfsqvpbPA5,45ouQn9gGwXqnTGfaP5CvU8fCKadBRA5kPwtfvJzykRU,True,199282849,49820712,311844,155922,155922,3zqXX6kzhkbW3d4TwD2CNjMRwxTbREXySekvq37kfCNk,12473764,56079545,-43605781,625
2022-01-07 04:42:53.536462,2022-01-06 23:23:24-05:00,2340,3g1debT8Z2efQPuMNSDPUNZzDqarBG2acErsZ4HP7QGA,42wDHagxr5Nno3mUx6kyYGDjwR98aedRbh3ByB468agB,True,59407,14851,92,46,46,GAUsoe8ZTCiGPm2hYxRPGxcPe5ShNzHK9eE3G2zgRjxd,3713,19935,-16222,625
2022-01-07 04:42:53.536462,2022-01-06 23:23:24-05:00,2341,4FazDUgfQ3AKoFcnWHr8E9Ht8jLA3tkxf75yrGZVHdmF,HzRMH6mbgEKydRCnnMvSsKgTEVNQi6nuzoR1xutYFdzg,True,192525,48131,301,150,151,72FwbpFGoLEazJEdpqNtPNefsadUrimUqma9wSoy4qiS,12040,119632,-107592,625
2022-01-07 04:42:53.536462,2022-01-06 23:23:24-05:00,2342,2ce2v2TCbjNH635NgbwTG3sqiRWYrRRaBpxPxBZJ929q,9cnoebT43FkWDFhidndGCVNiFD4NErv8DuL1Va4Jv9S8,True,18897429,4724357,29499,14749,14750,3zqXX6kzhkbW3d4TwD2CNjMRwxTbREXySekvq37kfCNk,1179999,12617396,-11437397,624
2022-01-07 04:42:53.536462,2022-01-06 23:23:26-05:00,2343,9gYrMXAGmGSV4VFjXzYP5WwH2aFpB1TxA6CqpYsosKLv,Dh8aH6RK48wu4fkT9xKw5XL7itxnPDuw3SDwPwvL5sva,True,83025,20756,127,63,64,4BnQKPLuE3DMTtxp8MjUBytgnhvxqq3ZTqZHTVZo4JJh,5108,27792,-22684,615
2022-01-07 04:42:53.536462,2022-01-06 23:23:26-05:00,2344,4mB2DVbQVqVk535v98Cj8SPNg1tTc3DFyY2Q7VBbY645,HXo255k3RgsTGsc4hiP6ZTXUspBTqJ37duQa5eK7tqp3,True,1233347068,308336767,1893461,946730,946731,3zqXX6kzhkbW3d4TwD2CNjMRwxTbREXySekvq37kfCNk,75738440,388270140,-312531700,614
2022-01-07 04:42:53.536462,2022-01-06 23:23:26-05:00,2345,H6tDNj9cHac223ckAnNfnC4bAJuNLBnf2pFk2iQdMzMP,28UL9dqgayCqCAexScXjdpobYGVDN44SGBVNAfBByk8C,True,209760021,52440005,321452,160726,160726,4BnQKPLuE3DMTtxp8MjUBytgnhvxqq3ZTqZHTVZo4JJh,12858112,99525103,-86666991,612
2022-01-07 04:42:53.536462,2022-01-06 23:23:26-05:00,2346,J5ttoY9YjAuVvggkCeps9sX7ivUWoqps5DzxjfgqddxT,mR1fxSNP4bX9GyzRS1UFLpHg31UAXwB8Du7dydCa7VR,True,6098206,1524551,9429,4714,4715,4BnQKPLuE3DMTtxp8MjUBytgnhvxqq3ZTqZHTVZo4JJh,377186,2089340,-1712154,618
2022-01-07 04:42:53.536462,2022-01-06 23:23:26-05:00,2347,E9FFPvygPSF22u7gqFq4w6yE5kV15zbeGDXFQc349RsG,yi1REPVUwKhr5ss5YJc56crYz8LVfkqNVMpKcdSfwfY,True,5237178,1309294,8081,4040,4041,4BnQKPLuE3DMTtxp8MjUBytgnhvxqq3ZTqZHTVZo4JJh,323247,1086069,-762822,617
2022-01-07 04:42:53.536462,2022-01-06 23:23:26-05:00,2348,7W6ih2ZGXaE6tvuQFUPCvc7NvEJHy7UffgoVX3ZPdLXt,6uQCkeMjEXHBQxE2HD33RM1zyTsSko1fYZA1mWUggJ5B,True,80567,20141,124,62,62,4BnQKPLuE3DMTtxp8MjUBytgnhvxqq3ZTqZHTVZo4JJh,4999,28139,-23140,620
2022-01-07 04:42:53.536462,2022-01-06 23:23:26-05:00,2349,EEcTbsFTUEifcdbPyjBLkS943daEx1RpR8F3uZxKRZbT,8V3JzDQ1VWYQLas8fxUsWJZZHe4gEmn74RehtUwLw3k5,True,16780668,4195167,25570,12785,12785,3zqXX6kzhkbW3d4TwD2CNjMRwxTbREXySekvq37kfCNk,1022824,6853552,-5830728,609
2022-01-07 04:42:53.536462,2022-01-06 23:23:39-05:00,2350,9LZ3rShLfzErXsGkh4dYfAm58GNPWhK6ohDy5RrLJhc,41tLyuvuJ5M7YctkSASD2R7RGGetD7FmKaZUdkTdgXgt,True,4535033,1133758,7050,3525,3525,3zqXX6kzhkbW3d4TwD2CNjMRwxTbREXySekvq37kfCNk,282009,946976,-664967,621
2022-01-07 04:42:53.536462,2022-01-06 23:23:39-05:00,2351,ECuu1L4QGdemZ7FjAjVAAxYN6piinweY7Fuk5csVovfT,Amd8WGcpdtB8yoA83R1BUT5uryuqoKbcBexYacbrbGVX,True,9569518,2392379,14790,7395,7395,3zqXX6kzhkbW3d4TwD2CNjMRwxTbREXySekvq37kfCNk,591604,2842257,-2250653,618
2022-01-07 04:42:53.536462,2022-01-06 23:23:39-05:00,2352,5BjBPqumCb9KC82ZNNch3dcRzbpGdRLJneru7o9a1D9R,FuZtBWKktxFu4yoiLVMzxq8fMhQyN8SGzGPz49xs3m6P,True,461930199,115482549,705841,352920,352921,3zqXX6kzhkbW3d4TwD2CNjMRwxTbREXySekvq37kfCNk,28233654,190023031,-161789377,611
2022-01-07 04:42:53.536462,2022-01-06 23:23:39-05:00,2353,BxXXWywnC3dSyLPJHt7owfBhgSiBWzkuD3T8hGYLqCH6,4vuwEBXXbXFMPmbJJJRop4FCWGyKR1sXhBc3EWF6MiB8,True,298315074,74578768,464643,232321,232322,3zqXX6kzhkbW3d4TwD2CNjMRwxTbREXySekvq37kfCNk,18585751,142452007,-123866256,623
2022-01-07 04:42:53.536462,2022-01-06 23:23:39-05:00,2354,7MSzV5yy5FmrM4j1BcYSRiTGWfit1AJahheRUaXzz349,aPSTZLxBpVr3sucjbj95emRV2J1GrUWr7wbARYqJkQZ,True,13960099,3490024,21482,10741,10741,3zqXX6kzhkbW3d4TwD2CNjMRwxTbREXySekvq37kfCNk,859306,3796716,-2937410,615
2022-01-07 04:42:53.536462,2022-01-06 23:23:39-05:00,2355,6d6HN8LWikwW2HYdy3BABWuxKHt1sgv4DcneACR133sE,4eKvzmfFvX96XbujKBhUauAvWP4yQYwZH3pd7gXzbCvJ,True,5231363,1307840,8092,4046,4046,3zqXX6kzhkbW3d4TwD2CNjMRwxTbREXySekvq37kfCNk,323693,1092330,-768637,618
2022-01-07 04:42:53.536462,2022-01-06 23:23:40-05:00,2356,EgU9hX6VK7YXeCgCHVaJAMekCcyZa2MVWdKra5pN7Gwv,7y8Ad9XY34bqREvheXHT2tr8Jy11D6X3pu7yLVtjU4QV,True,31053934,7763483,47326,23663,23663,DddJ7EWCmYEEZETCBNgAUSg81Ls6fZtiAaY5ekJ5sXx1,1893049,12793507,-10900458,609
2022-01-07 04:42:53.536462,2022-01-06 23:23:43-05:00,2357,HhwiZPKZBGa16oVi739s4qtMDMTwzWXc7iwNfX63t2UP,5AnbMbAFKy85yHt5y2M5S38nNkA1vT4ejY5NjGbRNUqn,True,4335964,1083991,6781,3390,3391,4BnQKPLuE3DMTtxp8MjUBytgnhvxqq3ZTqZHTVZo4JJh,271278,2270001,-1998723,625
2022-01-07 04:42:53.536462,2022-01-06 23:24:14-05:00,2358,DJiXXW7sjNsAAxWupDKBUsFhXSgPoerVYaAtJqqNgVbn,2MsqvNuJw1xQhJ3UnXt9i7oNHDuZpR9w7iE1WQcGqt5m,True,458587,114646,711,355,356,3zqXX6kzhkbW3d4TwD2CNjMRwxTbREXySekvq37kfCNk,28470,126760,-98290,620
2022-01-07 04:42:53.536462,2022-01-06 23:24:14-05:00,2359,AGhvB6x3gmvAJSnr9UVtvhKqVg3Qgh1k4roHzrNHhAaa,HhhjXT6WJnz1HQfHcwKdBppuAhc8ncUcq1mkJ4EHqgpe,True,19763,4940,30,15,15,DddJ7EWCmYEEZETCBNgAUSg81Ls6fZtiAaY5ekJ5sXx1,1230,6963,-5733,622
2022-01-07 04:42:53.536462,2022-01-06 23:24:14-05:00,2360,CCHzYXr5zMXFu8MMZNkfUWGyUcF8xy7Vvhq7tNCtZg2L,AuEXkCJTTJ3HK8iP4qTWpQr4vp6HPRJZyZwfRjF8zjfp,True,458572,114643,711,355,356,3zqXX6kzhkbW3d4TwD2CNjMRwxTbREXySekvq37kfCNk,28467,126772,-98305,620
2022-01-07 04:42:53.536462,2022-01-06 23:24:15-05:00,2361,4kbcrzH6o2LvLUCNphyL52i8uGzVD8wcUNEqoQ14z3VG,5Q1atmEBs2AqaDZsiZFG5stHzj1fE6ZvypgfkEc9LYqE,True,558119822,139529955,867362,433681,433681,72FwbpFGoLEazJEdpqNtPNefsadUrimUqma9wSoy4qiS,34694505,262763419,-228068914,621
2022-01-07 04:42:53.536462,2022-01-06 23:24:15-05:00,2362,921FBgLS3A1wA77uWitsnTvW737Q2jY7tzvgWtWLXNC7,E4eJ9H7cqP9zNpMH5xRBTAp9yaBCBihuJBNd6pqzteDG,True,458567,114641,711,355,356,GAUsoe8ZTCiGPm2hYxRPGxcPe5ShNzHK9eE3G2zgRjxd,28462,126772,-98310,620
2022-01-07 04:42:53.536462,2022-01-06 23:24:19-05:00,2363,GH6Q9E1jZPTTp46aDd57UNZPNS2D6PBSwyLL3EHSjGn2,2XvwZXNsrPWx4EfPvhTP933bzCC3SJHDQ8xARfrXdVY9,True,61743253,15435813,95599,47799,47800,DddJ7EWCmYEEZETCBNgAUSg81Ls6fZtiAaY5ekJ5sXx1,3823966,46258208,-42434242,619
2022-01-07 04:42:53.536462,2022-01-06 23:24:19-05:00,2364,4D7mDXe7SdmbAx7kaD1mBNuEa7DzMi6TAwXURxtLEazk,5pSnT91PHoLdN6uhPnUtoD7cboLmndn26y1XouPx8vwW,True,4637767,1159441,7199,3599,3600,3zqXX6kzhkbW3d4TwD2CNjMRwxTbREXySekvq37kfCNk,287974,1274085,-986111,620
2022-01-07 04:42:53.536462,2022-01-06 23:24:23-05:00,2365,AA9zFZTXqBR8Mw1fwEH59edzBiswoGasRNWsi6aLeysB,4VeitxYqqtRxyfdSVpshdJ3EDcgksRVnaHvAqWxTeujH,True,5318022,1329505,8284,4142,4142,4BnQKPLuE3DMTtxp8MjUBytgnhvxqq3ZTqZHTVZo4JJh,331367,1113345,-781978,623
2022-01-07 04:42:53.536462,2022-01-06 23:24:24-05:00,2366,2bikYf33ZxxDmvkMNjWDGGqEpbYJPvWv5At3hzyeLEQK,5FtirUBjRAZ3k5arFFVwKz42ixWzhkEBLkaK9PraRZ78,True,458221,114555,702,351,351,3zqXX6kzhkbW3d4TwD2CNjMRwxTbREXySekvq37kfCNk,28111,126767,-98656,613
2022-01-07 04:42:53.536462,2022-01-06 23:24:26-05:00,2367,5jin5wXjQQ25nGM2ECrCXcg1a95vquh6kM7rMRru6Ke7,EKM657EQ8HWWgf4cssByoYHoXGjFfTspTKXAGmygAPQG,True,117594432,29398608,183786,91893,91893,4BnQKPLuE3DMTtxp8MjUBytgnhvxqq3ZTqZHTVZo4JJh,7351457,48426062,-41074605,625
2022-01-07 04:42:53.536462,2022-01-06 23:24:27-05:00,2368,ES1MDwRUa3hoToPKQiiZkzMYe9PDVnAQwMrEvZrzvnc1,C4wBG3xTDkmDQneB28xYnf1aBNEeq7UB8oR7NuEfLkFg,True,86087140,21521785,134648,67324,67324,3zqXX6kzhkbW3d4TwD2CNjMRwxTbREXySekvq37kfCNk,5385939,23586544,-18200605,625
2022-01-07 04:42:53.536462,2022-01-06 23:24:29-05:00,2369,5RvNKzSeJ1fvqsKpcQu25evEZGmKjyEDgwsMZkykoT3P,BRqSGfE4XHXu4HrinwetWumfVTmr82iuF6Y5oSV6eMiK,True,458649,114662,716,358,358,3zqXX6kzhkbW3d4TwD2CNjMRwxTbREXySekvq37kfCNk,28678,126906,-98228,625
2022-01-07 04:42:53.536462,2022-01-06 23:24:42-05:00,2370,6dr65yANjSMmfBeKAuSxG3i16S9vMgF1CQ3zDyzh55Pn,EhrE5QpnshD41S4zPEBy2A5q2Gs2mwUrbHGo6WnT9zDP,True,1045661,261415,1630,815,815,3zqXX6kzhkbW3d4TwD2CNjMRwxTbREXySekvq37kfCNk,65226,443398,-378172,623
2022-01-07 04:42:53.536462,2022-01-06 23:24:45-05:00,2371,GGGyesjbt7h2XHHp9u8vpiWGugFwEbrtYaKrNQSDhQd7,8tydo1ZjGHmPBSqU33tywB3f9szdsHk1ckGFe4Ay5pgs,True,157757234,39439308,245681,122840,122841,4BnQKPLuE3DMTtxp8MjUBytgnhvxqq3ZTqZHTVZo4JJh,9827267,104243698,-94416431,622
2022-01-07 04:42:53.536462,2022-01-06 23:24:48-05:00,2372,6u6bPgAmK8ufACrQV99A1Y5nhGkue3KEUHmQQkcNkxwP,7636yXT5w4DcVpc7LJdN46aiggzSq6U2GXHXL5kyy9F3,True,370688954,92672238,578555,289277,289278,3zqXX6kzhkbW3d4TwD2CNjMRwxTbREXySekvq37kfCNk,23142209,152295286,-129153077,624
2022-01-07 04:42:53.536462,2022-01-06 23:24:49-05:00,2373,3Lv2XpiD4KBUHq7Zx6u3zNhpXoySodXHH8o8f5yaaPxG,H6TN4rhpBXkEH3mZnymYNcKfmnxRH2uzfwzeLH2q6ahP,True,583648,145912,911,455,456,GAUsoe8ZTCiGPm2hYxRPGxcPe5ShNzHK9eE3G2zgRjxd,36464,208552,-172088,624
2022-01-07 04:42:53.536462,2022-01-06 23:24:58-05:00,2374,2QStaRnbSnDhA891Lb1bxjVeMYpJUpNdqaVkw3rqU45V,DakRWPnttPoRcjY5V7WLwiwBx39BapCo9Atog8dL17Ku,True,7076412,1769103,11049,5524,5525,3zqXX6kzhkbW3d4TwD2CNjMRwxTbREXySekvq37kfCNk,441971,1803062,-1361091,624
2022-01-07 04:42:53.536462,2022-01-06 23:25:14-05:00,2375,6CeKxTJvFqhyNEyzySiBBKEwYVMe7j3A6nkMes4BW6o2,DzDR9XvwY1z7ygQ8YrCXrwDGHSf67JZF8BzUnuFE2fxQ,True,13675478,3418869,21372,10686,10686,3zqXX6kzhkbW3d4TwD2CNjMRwxTbREXySekvq37kfCNk,854911,4050228,-3195317,625
2022-01-07 04:42:53.536462,2022-01-06 23:25:53-05:00,2376,3njiRuSRMXRzKmamyiR72Hc38PU8UDDmWdfPhgxmGxEW,5WoF3gkgygyNNbwxWgVfqGWkExcDixuzgJQQjXEZQ6J5,True,796642128,199160532,1241056,620528,620528,3zqXX6kzhkbW3d4TwD2CNjMRwxTbREXySekvq37kfCNk,49642265,477805855,-428163590,623
2022-01-07 04:42:53.536462,2022-01-06 23:25:54-05:00,2377,8MKNsuGVaoYpdQy6NNyxDvRzh2DAquBUtri4nDsixUxs,D7M1SDmpZAs8vdPCCCa96UbDF15YQDxHmoGWB57tHiir,True,12927402,3231850,20149,10074,10075,3zqXX6kzhkbW3d4TwD2CNjMRwxTbREXySekvq37kfCNk,805985,5669283,-4863298,623
2022-01-07 04:42:53.536462,2022-01-06 23:25:54-05:00,2378,5PbrpM9kjzF4R2eW2UTcRVXnhqWdRQWHZJXKLN43N8WC,6ip4ocbyHusy8CsVvcrpiRCUp2nq9cY8bHpTcUU3Wztq,True,24730218,6182554,38599,19299,19300,3zqXX6kzhkbW3d4TwD2CNjMRwxTbREXySekvq37kfCNk,1543998,8846813,-7302815,624
2022-01-07 04:42:53.536462,2022-01-06 23:25:56-05:00,2379,8VnGmfop6qcUezAJ2M15jz2Nn6mPQgehDcJPvypq4XJn,6F6sqXNhgkW9ev8QNMm4ydywUUmemhwgydRQYNeqyUmi,True,33070133,8267533,51580,25790,25790,3zqXX6kzhkbW3d4TwD2CNjMRwxTbREXySekvq37kfCNk,2063239,25243159,-23179920,623
2022-01-07 04:42:53.536462,2022-01-06 23:25:56-05:00,2380,FpqCxvTkSiwDwD5qEt6hXJxzFDLFLAQ8VevK8zwRqYun,A3p6YQisCJKpNkF7vkjZRbEfbnUt7vTZdR2zPBUSdTkk,True,1281813131,320453282,2000963,1000481,1000482,3zqXX6kzhkbW3d4TwD2CNjMRwxTbREXySekvq37kfCNk,80038522,380411126,-300372604,624
2022-01-07 04:42:53.536462,2022-01-06 23:26:08-05:00,2381,DAku12iueL13vRoTpKLyqdGaLQ2rWF6REe8Dr8soFvNs,H2vVH3LxkhGe6x6Mdwy67BYwTKNQM6XayKx7mhrwyfJM,True,1392700,348175,2174,1087,1087,3zqXX6kzhkbW3d4TwD2CNjMRwxTbREXySekvq37kfCNk,86997,592738,-505741,624
2022-01-07 04:42:53.536462,2022-01-06 23:30:52-05:00,2382,C2Dmfw4G8KKzFq38aRH2pLCRngnGZDvUUN3fHDMjFkoG,7kzJk3BTNvY3hGFNj7nDy9L5CAYus6eNiCAxWH8dSioX,True,1158759,289689,1812,906,906,3zqXX6kzhkbW3d4TwD2CNjMRwxTbREXySekvq37kfCNk,72483,604477,-531994,625
2022-01-07 04:42:53.536462,2022-01-06 23:32:12-05:00,2383,6eBSLXDMVoW2nG3n7s42RXDH8byY3C6n1RsUuegBLSrG,37dYrKnTXYer7Bu9xFfpArA4ZNo2B9bycFw9HywDtTRx,True,30958334,7739583,48437,24218,24219,3zqXX6kzhkbW3d4TwD2CNjMRwxTbREXySekvq37kfCNk,1937495,12283202,-10345707,625
2022-01-07 04:42:53.536462,2022-01-06 23:32:34-05:00,2384,6uZobpBuFcQeYgZ4dApFi6iy4DB9GLHP1AAsQcCj6212,SGGFiPjjhscwroiWMqY4jTAHFw8eakpsEv35wNoHUPY,True,420572731,105143181,657014,328507,328507,3zqXX6kzhkbW3d4TwD2CNjMRwxTbREXySekvq37kfCNk,26280566,128719288,-102438722,624
2022-01-07 04:42:53.536462,2022-01-06 23:32:48-05:00,2385,8NdcaYUC1X5CP7FMDip78uqtqmCt8GcZdCzLRTYTihmb,9Ei1K9bXWXSXcBfeX5exPSXGCAu62WSKzvnnd4wHvyVh,True,409951,102487,640,320,320,3zqXX6kzhkbW3d4TwD2CNjMRwxTbREXySekvq37kfCNk,25637,149525,-123888,625
2022-01-07 04:42:53.536462,2022-01-06 23:32:52-05:00,2386,2FrqGFZjbiNykJyo9BZ5S9FguQJPJiTi681rJJsQ5dta,3QUncYP92NKrfpaTvuF9iQg11PXKgZAgEngwh6BbnCCj,True,2576566,644141,4018,2009,2009,3zqXX6kzhkbW3d4TwD2CNjMRwxTbREXySekvq37kfCNk,160743,879368,-718625,623
2022-01-07 04:42:53.536462,2022-01-06 23:32:57-05:00,2387,2VyFcgZDH1HTEvD1XaWhwqBCMmZ1k6TmZ3fEpPcBZR9E,G1wFJETTpdoc7CfypGCzkq1jssXPfUkiuLjK2cwVZ9dJ,True,251064,62765,392,196,196,4BnQKPLuE3DMTtxp8MjUBytgnhvxqq3ZTqZHTVZo4JJh,15697,107447,-91750,625
2022-01-07 04:42:53.536462,2022-01-06 23:33:03-05:00,2388,EF6H6aW1p3qcAtiLFU9rbFYfsKfD683meHXDw8hLdaZK,8vfJbpnK7SQcjpEBCzZJRW8JosNbsmTeJ2YXZCbM225c,True,307897420,76974355,479926,239963,239963,4BnQKPLuE3DMTtxp8MjUBytgnhvxqq3ZTqZHTVZo4JJh,19197060,93588736,-74391676,623
2022-01-07 04:42:53.536462,2022-01-06 23:33:22-05:00,2389,F2v1YwVAwXLiUgsJ5uwn4qAAkTXitn1E75fJcPnGuAcy,5rdJ4H5GxPg4Juu77mGc7uya5LwEqLzDSRyG8mQ2mDbK,True,60154581,15038645,94063,47031,47032,4BnQKPLuE3DMTtxp8MjUBytgnhvxqq3ZTqZHTVZo4JJh,3762554,24808454,-21045900,625
2022-01-07 04:42:53.536462,2022-01-06 23:33:35-05:00,2390,Fd2HrzBAr4JobRPARZwpQHHVoSCEoog32A6tKMWAC1sK,BYappsar5sQf8VLem4wrLuTtrDFH9y8pEx1aMxfuU4Pq,True,93924368,23481092,146934,73467,73467,4BnQKPLuE3DMTtxp8MjUBytgnhvxqq3ZTqZHTVZo4JJh,5877364,38726808,-32849444,625
2022-01-07 04:42:53.536462,2022-01-06 23:33:41-05:00,2391,8sneA6wAg6geVDJ1g7YWg4R1PfjuRVzeHp1nUBJinhZa,14i1uWtmcTjrdbg3DSr9vzd5NBnxqsn1A4QdgFBZqeYM,True,378280,94569,591,295,296,HfEnetJ7uBSmZWCjBNxdvv9HEC5nsW4wDV7wu6WnhWan,23650,138625,-114975,625
2022-01-07 04:42:53.536462,2022-01-06 23:33:55-05:00,2392,8RmB8o4zux2sD48dEsKpsX475KRxTwdk8QULUDU9xx8R,AKSiZnb4YKVB6B86aPPqvyXquhvN9xqt45bexBCZ7nx,True,197585849,49396462,309202,154601,154601,3zqXX6kzhkbW3d4TwD2CNjMRwxTbREXySekvq37kfCNk,12368115,95940638,-83572523,625
2022-01-07 04:42:53.536462,2022-01-06 23:33:58-05:00,2393,EmGW2aAG69ssWqCtbfDocRaM2u3TJsczn2HHP9jdmRvD,aypkDKsp9uqAB4F6mwvm5LofpsrFBuZT2MMWtE2eHdB,True,2013578,503394,3147,1573,1574,3zqXX6kzhkbW3d4TwD2CNjMRwxTbREXySekvq37kfCNk,125890,781726,-655836,625
2022-01-07 04:42:53.536462,2022-01-06 23:34:03-05:00,2394,6tFQaTqqffino9kwMZTL2xVNBG8k9VREFhXqVi2si3A3,3w3wGxBbS4bmXeqmvd595SAWFeXekVpnH4UdbeEs8Sx5,True,13667287,3416821,21324,10662,10662,DddJ7EWCmYEEZETCBNgAUSg81Ls6fZtiAaY5ekJ5sXx1,852971,4056479,-3203508,624
2022-01-07 04:42:53.536462,2022-01-06 23:34:03-05:00,2395,BJaaH1SK1pF2kZQzmYpLFfDtm52CR9a5rd39RAPtLe8q,HUsT5FVxaisdnCvG1BQxX6zffjfL2Rwx5mMo5y8SDV7e,True,126396948,31599236,196353,98176,98177,3zqXX6kzhkbW3d4TwD2CNjMRwxTbREXySekvq37kfCNk,7854146,29000292,-21146146,621
2022-01-07 04:42:53.536462,2022-01-06 23:34:03-05:00,2396,Br1j5Ftafei7ysu5SmqVZSoRe4uS4qCPeKSPHg55pyiE,G8fc7QvXjfkgBFvAVUgJFQS3VaF1biL9rktBExGa87Ks,True,8649926901,2162481724,13519467,6759733,6759734,DddJ7EWCmYEEZETCBNgAUSg81Ls6fZtiAaY5ekJ5sXx1,540778696,3076033572,-2535254876,625
2022-01-07 04:42:53.536462,2022-01-06 23:34:03-05:00,2397,6yw4GPvkqUbakcEWtqSCfjVLukty11xqjDpGxtEN9Km2,5ppEx7wkpqbG5nApCWMdRja3oRSheFmAAsNHUX7h2w2Y,True,5149336,1287334,8029,4014,4015,4BnQKPLuE3DMTtxp8MjUBytgnhvxqq3ZTqZHTVZo4JJh,321169,4019824,-3698655,623
2022-01-07 04:42:53.536462,2022-01-06 23:34:07-05:00,2398,ANQkPUoMjLHyRtypeKzxsKW1DFauQsh9SnB3rRgRXM1Y,7RHAExWpG8Q3PXwKhJs2yXmYK9WogGydvFYpx28p6pgr,True,226190481,56547620,349519,174759,174760,3zqXX6kzhkbW3d4TwD2CNjMRwxTbREXySekvq37kfCNk,13980768,111625071,-97644303,618
2022-01-07 04:42:53.536462,2022-01-06 23:34:08-05:00,2399,46TNhGwBVzedW8xSb9UY94HNeSom9iGiZzAjrKHiRM2G,7JVTiqNYeKHbyzRkKtvSEpqLPKykZso8cGUr3sX1j7QF,True,138566504,34641625,214976,107488,107488,3zqXX6kzhkbW3d4TwD2CNjMRwxTbREXySekvq37kfCNk,8599058,43424813,-34825755,620
2022-01-07 04:42:53.536462,2022-01-06 23:34:15-05:00,2400,gMjmD7WioyUdQdwNqE5fobLcxPwoJv5rAvLmJaf8Jjw,5n77euFjVJiwKrnbYq1KpcENW1mzBZj2BuDGyzazrkJ8,True,2892920,723230,4524,2262,2262,3zqXX6kzhkbW3d4TwD2CNjMRwxTbREXySekvq37kfCNk,180983,1079636,-898653,625
2022-01-07 04:42:53.536462,2022-01-06 23:34:18-05:00,2401,J2gTwrYpzezkRupgBtgudQn5D33x6WjeBhTHnrA1qgqa,FBzoHRwqGRjnMvPEpiZVjtGZYJmAbneE4dpToXPzy8bv,True,107950565098,26987641274,167458528,83729264,83729264,GAUsoe8ZTCiGPm2hYxRPGxcPe5ShNzHK9eE3G2zgRjxd,6698341146,32925444851,-26227103705,620
2022-01-07 04:42:53.536462,2022-01-06 23:34:19-05:00,2402,AHm7zF4rpaxaayBLn5QDHgJSp8KAr647s4cNvQ9wLgd7,FDM33WngED24pukBvSDpPAzinW6afVAeGReum5nyLRiC,True,2575188,643797,3880,1940,1940,3zqXX6kzhkbW3d4TwD2CNjMRwxTbREXySekvq37kfCNk,155233,1108700,-953467,602
2022-01-07 04:42:53.536462,2022-01-06 23:34:25-05:00,2403,9zpPiboHF5HW7NfCx7hYdmJGwUomVMTiUFc4Um5KrDi3,8q3eBpuwV6dMNkib9N8XQAq2tBUcjSANRe5SXpd4dFhZ,True,25538321,6384580,38923,19461,19462,3zqXX6kzhkbW3d4TwD2CNjMRwxTbREXySekvq37kfCNk,1556939,6950516,-5393577,609
2022-01-07 04:42:53.536462,2022-01-06 23:34:25-05:00,2404,9UyQC8vc6zJJaSdnjvTAzgmcsw4fC3xFBBiCC1w9Sbjx,3ppBfboe6FPmt7f6WrivspMUoAznZKWQMeh3rCgw7vjQ,True,27878138,6969534,42621,21310,21311,4BnQKPLuE3DMTtxp8MjUBytgnhvxqq3ZTqZHTVZo4JJh,1704878,7573380,-5868502,611
2022-01-07 04:42:53.536462,2022-01-06 23:34:25-05:00,2405,pgzvXpnUYiY7hLrfjmwScqLd8oj9vYcXpFvpm4y4JvG,GdqdQgoyBAFuXdbvoZyDhB3jyqJzVo4nkGh7EPFxkBF2,True,6595513,1648878,10241,5120,5121,3zqXX6kzhkbW3d4TwD2CNjMRwxTbREXySekvq37kfCNk,409678,5192486,-4782808,621
2022-01-07 04:42:53.536462,2022-01-06 23:34:25-05:00,2406,67Z7ZGhNu5xxEh9BYKWcXp9m1T4tFiE1o1M16hCzUWQA,CT7YKWixz7BhTbvg5F6M5HCyPGnHoFLNFuDV9GhoLTo3,True,10164908,2541227,15717,7858,7859,4BnQKPLuE3DMTtxp8MjUBytgnhvxqq3ZTqZHTVZo4JJh,628687,5033591,-4404904,618
2022-01-07 04:42:53.536462,2022-01-06 23:34:25-05:00,2407,6nJyqvFKprwaVCE1gAa2P4RHKc6Pa6XFSJymx654zZ9K,4e7iJmdwzAPxp1Zi8Azo38YyPQdPKqqY4VLJyQ5rpdYP,True,7797678,1949419,12177,6088,6089,3zqXX6kzhkbW3d4TwD2CNjMRwxTbREXySekvq37kfCNk,487082,3382254,-2895172,624
2022-01-07 04:42:53.536462,2022-01-06 23:34:25-05:00,2408,DdYgcyV1T2CDYiQVr4VL9Ym8RdKm93a7SKy8HxuyaoMW,GPdAeqeXb1UJ56AttcwwY1CyFhRyfptDC4BAX2Tc8MpE,True,1645306,411326,2571,1285,1286,4BnQKPLuE3DMTtxp8MjUBytgnhvxqq3ZTqZHTVZo4JJh,102848,707316,-604468,625
2022-01-07 04:42:53.536462,2022-01-06 23:34:25-05:00,2409,E8ifvhmyJGBGVQomo3AnZw2UcaLHcpGsTtuoCid8voU3,FMQUWTbTAfSLfrc6GTrz4DM2ZSgoxF3KtqGn8AyjVtsf,True,22137402,5534350,33722,16861,16861,4BnQKPLuE3DMTtxp8MjUBytgnhvxqq3ZTqZHTVZo4JJh,1348884,6478898,-5130014,609
2022-01-07 04:42:53.536462,2022-01-06 23:34:26-05:00,2410,2F45BX9mRmtNCHPejKFknN5aNgGvR4vVLFjMaY1a7dR8,ALdSutsvEFRUEQGGBbi31QywTL1pdXSDWrNJzvNTaoXL,True,77992237,19498059,119467,59733,59734,GAUsoe8ZTCiGPm2hYxRPGxcPe5ShNzHK9eE3G2zgRjxd,4778688,30940515,-26161827,612
2022-01-07 04:42:53.536462,2022-01-06 23:34:32-05:00,2411,CvZssqscu2dm35mwcE3zg9zedavbRjVJjWD59Py5ExUK,7pXaoR6aHKYofCmg1eHipygNYDteEaf8rbbS8BDYGQK6,True,2189391,547347,3381,1690,1691,3zqXX6kzhkbW3d4TwD2CNjMRwxTbREXySekvq37kfCNk,135245,651700,-516455,617
2022-01-07 04:42:53.536462,2022-01-06 23:34:41-05:00,2412,A2ZUT3A9EjtCkzcZveEvWF3pPwNVqdXkHK3fsNRAg8VX,4137TfTDDzK71KN2ZzJaoRPJDQDKQewSPdmZfKrxdVPD,True,198820042,49705010,309769,154884,154885,3zqXX6kzhkbW3d4TwD2CNjMRwxTbREXySekvq37kfCNk,12390790,55584548,-43193758,623
2022-01-07 04:42:53.536462,2022-01-06 23:34:44-05:00,2413,CRaKcudjkQiSw5YPVjTLVdXvJskeGiHSYtq5ZcMPJhgQ,AgqTg3b3bAcaBmRidhNC4Uf9ZwNbeH52RQEqumWyuUs7,True,2708672,677168,4210,2105,2105,HfEnetJ7uBSmZWCjBNxdvv9HEC5nsW4wDV7wu6WnhWan,168421,1418925,-1250504,621
2022-01-07 04:42:53.536462,2022-01-06 23:34:53-05:00,2414,864zY9zuCktUurPTtdGeLvUATnDqHZpT1GeWUApsXh2m,CzatBrNJUi7MeyfbNhszRaPMidgt8Xkcmy5ZwFMP9RCs,True,64340227,16085056,99136,49568,49568,3zqXX6kzhkbW3d4TwD2CNjMRwxTbREXySekvq37kfCNk,3965462,25433327,-21467865,616
2022-01-07 04:42:53.536462,2022-01-06 23:34:53-05:00,2415,DmrkajG3SrTXnYSYxGRfkzfvhkevD6RdtFk4SdLC2G6Q,5r7vkWH985E2mGSDBtznduhuu5PbZJ7d4zxjzhzEEZG1,True,102261383512,25565345877,158160637,79080318,79080319,4BnQKPLuE3DMTtxp8MjUBytgnhvxqq3ZTqZHTVZo4JJh,6326425487,42652304875,-36325879388,618
2022-01-07 04:42:53.536462,2022-01-06 23:34:55-05:00,2416,Ckqos6cdncPKj13DnCmDVZsZTqp6eS7277CRrT9WhcEr,AtUV8m7VQJvZq7GLCAHMf3jV7iamKEPnWVZHWuuVZQp1,True,3881988,970497,6031,3015,3016,3zqXX6kzhkbW3d4TwD2CNjMRwxTbREXySekvq37kfCNk,241259,2034558,-1793299,621
2022-01-07 04:42:53.536462,2022-01-06 23:34:56-05:00,2417,DmEVzPyCKnm89v481V2ic57vyikwwMja75uVZ2rjvjfp,38fPZzP4NwTtx7Qu6DLSqx9Sv8e5CQbSrr2BMvVmSy4J,True,73721311,18430327,112206,56103,56103,HfEnetJ7uBSmZWCjBNxdvv9HEC5nsW4wDV7wu6WnhWan,4488268,36335134,-31846866,608
2022-01-07 04:42:53.536462,2022-01-06 23:34:56-05:00,2418,9vcKW1GfrDZ3KLPh2pEVFF8ZyKqD1pJW1hiE8H98Av7S,C6Ki27mo4sCHu6u8UnR1p7WSgsTjFQxGGR9Lk9n5Rhjq,True,8685830,2171457,13472,6736,6736,3zqXX6kzhkbW3d4TwD2CNjMRwxTbREXySekvq37kfCNk,538905,3539701,-3000796,620
2022-01-07 04:42:53.536462,2022-01-06 23:34:57-05:00,2419,HVZkXeDR3mc8oB9qFFwCK4RXpPojdcHk9tRGep6xtKGK,Bh3py7awPejWqeTMxtAgF7mPotL2Asxf8YrYJykq9nBt,True,20618421,5154605,32152,16076,16076,3zqXX6kzhkbW3d4TwD2CNjMRwxTbREXySekvq37kfCNk,1286108,7366468,-6080360,623
2022-01-07 04:42:53.536462,2022-01-06 23:34:57-05:00,2420,BWtXpiXn1bomr28mGfQFTx1Kd58CQipEnKmeweYowDEC,9jws1qkXvWAdEtBvURVEeGcGJzt4zG2gh8AJESvjKKrx,True,334024614,83506153,492757,246378,246379,4BnQKPLuE3DMTtxp8MjUBytgnhvxqq3ZTqZHTVZo4JJh,19710309,160416604,-140706295,590
2022-01-07 04:42:53.536462,2022-01-06 23:34:57-05:00,2421,CBL2NbekJrXvBiAcoj4fzQ4PfLDwTntW7Zt4nruHFYEw,59EvfgYTdKkfjUJz5LddLUAqbEdLaihcMzjcrTZsyzyS,True,29253,7313,45,22,23,3zqXX6kzhkbW3d4TwD2CNjMRwxTbREXySekvq37kfCNk,1821,10216,-8395,622
2022-01-07 04:42:53.536462,2022-01-06 23:34:57-05:00,2422,zLTuMVfVswjMkhyvjaXnvjcKXv5xNk3iSWSjRGpVqXf,J3D8NHUJCiSjvFYfJ5Es4YDhF1KcPZWRUmCQ5L92t8eB,True,380575983,95143995,594148,297074,297074,4BnQKPLuE3DMTtxp8MjUBytgnhvxqq3ZTqZHTVZo4JJh,23765939,127756377,-103990438,624
2022-01-07 04:42:53.536462,2022-01-06 23:34:57-05:00,2423,M69XSefqeum2arinvHEqmA3L2XHWNFN17p4msRhRZXf,2vK15yYUANLSbAoiBfgJ9VLyqsmtEpd2iNytQjms8GaQ,True,847152507,211788126,1316982,658491,658491,3zqXX6kzhkbW3d4TwD2CNjMRwxTbREXySekvq37kfCNk,52679299,467406427,-414727128,621
2022-01-07 04:42:53.536462,2022-01-06 23:34:57-05:00,2424,6oroGB3mvzK3tDfiB9X2NJuL3x476pxhgRnt7VxqhdLo,2SoK8tKkLn2ppKURpTVazKsCEis4uahkHMsac1m85J4r,True,5600999,1400249,8716,4358,4358,HfEnetJ7uBSmZWCjBNxdvv9HEC5nsW4wDV7wu6WnhWan,348647,4238881,-3890234,622
2022-01-07 04:42:53.536462,2022-01-06 23:34:57-05:00,2425,D7XummfEc3NTK4qMvZegV3FrYuqc8mNgnQu3ujwemZtg,HHiRcecqzW7sGFTio7Ph6TYv3dGt64KWv4DEKgKm84fQ,True,24654804,6163701,36856,18428,18428,3zqXX6kzhkbW3d4TwD2CNjMRwxTbREXySekvq37kfCNk,1474261,10012757,-8538496,597
2022-01-07 04:42:53.536462,2022-01-06 23:34:57-05:00,2426,8WHDaiE6LqFFmCVMnPeLEQ99R6ft8b74UfmP9BqzjcE8,CGmoDGsdnjo3zMNrW78n2xxQr1aDPAiBYiXbyciLXYMu,True,629195504,157298874,950995,475497,475498,3zqXX6kzhkbW3d4TwD2CNjMRwxTbREXySekvq37kfCNk,38039820,224151120,-186111300,604
2022-01-07 04:42:53.536462,2022-01-06 23:34:57-05:00,2427,DvuRmJkfn6FQczUKgYeaSCqwy2NTMunuAKNrnmxMvnzS,7LpWTX9dgBtW75kfEoB5WuNsDwEdw5s8CYSHh3J4qagM,True,279603725,69900931,426470,213235,213235,3zqXX6kzhkbW3d4TwD2CNjMRwxTbREXySekvq37kfCNk,17058822,114813883,-97755061,610
2022-01-07 04:42:53.536462,2022-01-06 23:34:57-05:00,2428,DMgPzJnMQfvpk6LWscs9V9CwnYDj4CEUgKB9S65WsTaY,BZRSLH1Vw1BQwXTZtBcgUYqmFF7TuzYxAaZ8TXUKwLUQ,True,20028,5007,30,15,15,3zqXX6kzhkbW3d4TwD2CNjMRwxTbREXySekvq37kfCNk,1210,9553,-8343,604
2022-01-07 04:42:53.536462,2022-01-06 23:34:58-05:00,2429,5SwL5U5hhQXPW1HXFf4GuU4xkmXoAKx58pjY53NPHqWS,7zB7JvYFzEEwawJy7k7NXvBSG3UsbQte7JxgwvBNbS7U,True,611494738,152873684,906453,453226,453227,3zqXX6kzhkbW3d4TwD2CNjMRwxTbREXySekvq37kfCNk,36258153,291629418,-255371265,592
2022-01-07 04:42:53.536462,2022-01-06 23:34:58-05:00,2430,cQqH5PtXgtCk1Vs96PgxDxzUZf2Cfx5F63j1Nkz19cs,2VVizb2qVtj8ZEpLSmJXz9hXnAiGD7GdhBxT32PbFjAY,True,74966,18740,115,57,58,3zqXX6kzhkbW3d4TwD2CNjMRwxTbREXySekvq37kfCNk,4610,22461,-17851,614
2022-01-07 04:42:53.536462,2022-01-06 23:34:58-05:00,2431,6cnA7PeqQgpZdA7jBg4yMzTusm8JJHRWBMup84ywJfYo,FLqcukY7RehqY6ACrwVJnGH3eRgRDe93K1jLYCQN2F3U,True,250462102,62615525,376893,188446,188447,GAUsoe8ZTCiGPm2hYxRPGxcPe5ShNzHK9eE3G2zgRjxd,15075727,121451341,-106375614,601
2022-01-07 04:42:53.536462,2022-01-06 23:34:59-05:00,2432,DC4UVUDFWL3gVtgkX9hPtFgtxaA8DH5p94i4k9U3wyWv,3HCWqVvQQfRgSKitsTjGTduJ82ointZUSNtj13uea4kD,True,5772802264,1443200566,8966424,4483212,4483212,3zqXX6kzhkbW3d4TwD2CNjMRwxTbREXySekvq37kfCNk,358656960,1674029034,-1315372074,621
2022-01-07 04:42:53.536462,2022-01-06 23:35:04-05:00,2433,CagSUfZLwXuCdypC4KzU6FSNdmCj9dKDroPcNeaRtsyt,yxw5d1ztZuEUY2QjL7eLpr72QJAj5rJd6ERvg91cy1m,True,5055596,1263899,7853,3926,3927,3zqXX6kzhkbW3d4TwD2CNjMRwxTbREXySekvq37kfCNk,314140,1583478,-1269338,621
2022-01-07 04:42:53.536462,2022-01-06 23:35:04-05:00,2434,2jPxG5FL6D6XEJsRszJ9cmQ54AWSpZyPFSbn3DpWBSuM,3toQou4UVNvyWYvMvkuv379RVEF2aN2TzCpKKBUqeQV6,True,603492284,150873071,936944,468472,468472,HfEnetJ7uBSmZWCjBNxdvv9HEC5nsW4wDV7wu6WnhWan,37477770,211562725,-174084955,621
2022-01-07 04:42:53.536462,2022-01-06 23:35:05-05:00,2435,2FEbsetZMkRqLjSC8GBbgecKgX5T1T1fci2sLQux29p8,H722Fcd6DkTFRZxqQWbPDufBfXEgmFfhiEpQZWhxwYv1,True,15100454,3775113,23607,11803,11804,3zqXX6kzhkbW3d4TwD2CNjMRwxTbREXySekvq37kfCNk,944306,4825088,-3880782,625
2022-01-07 04:42:53.536462,2022-01-06 23:35:08-05:00,2436,5rW9kqXB9feGSKSvSMNJF1FCsBYV3vGmTmc8MvzaZ3pi,7AjnjcfPJevW5521hXw4VtgRCfHSsAqyzyArukKfNcHo,True,34370941,8592735,53427,26713,26714,3zqXX6kzhkbW3d4TwD2CNjMRwxTbREXySekvq37kfCNk,2137095,15011402,-12874307,621
2022-01-07 04:42:53.536462,2022-01-06 23:35:08-05:00,2437,U3vvMQ4X4aKzVYfhMw1V1p58HRqaLnuXozqmmefYeD9,7JA94MArkNCFRhBq8f5a32DgMF6aPdFsoC5HvXDQ6NuR,True,981562199,245390549,1534190,767095,767095,3zqXX6kzhkbW3d4TwD2CNjMRwxTbREXySekvq37kfCNk,61367635,436373682,-375006047,625
2022-01-07 04:42:53.536462,2022-01-06 23:35:09-05:00,2438,3C2MZQKh9x4zNTCMbhhvoafGaFMwUooqfy9MCgPyXs6E,AHjgWKpYPWe6ketjDHDKFBFsKQiRJ41jnkuo39MVYxZo,True,661653299,165413324,1032989,516494,516495,3zqXX6kzhkbW3d4TwD2CNjMRwxTbREXySekvq37kfCNk,41319573,326489890,-285170317,624
2022-01-07 04:42:53.536462,2022-01-06 23:35:09-05:00,2439,BZxJ6CtrVoiU86DMMieMeDFLNWtMpHGTvZfM7nyay6o4,6CRxRR8bisRLHFJBFWjyumYuy7j4C4PkjYH1K8gXhdWD,True,8938144,2234533,13816,6908,6908,4BnQKPLuE3DMTtxp8MjUBytgnhvxqq3ZTqZHTVZo4JJh,552667,2372354,-1819687,618
2022-01-07 04:42:53.536462,2022-01-06 23:35:15-05:00,2440,BrHRMouGRz3LBNzd9anfdYMhWfg8yUPHL4PqJ8WdEDFS,4uzoLa3mC2VYHAPBoHLX4gTjPTC28rPf2fvEGtJWPYc,True,190186646,47546661,295969,147984,147985,3zqXX6kzhkbW3d4TwD2CNjMRwxTbREXySekvq37kfCNk,11838763,135945438,-124106675,622
2022-01-07 04:42:53.536462,2022-01-06 23:35:15-05:00,2441,HGJoZvLakWfSDFwuvShNBc4kCf7nP7VqzyM3mELpbFEf,12Qn5jin7QvsBngXqYAv4UstyG3b6nRf1jsLp9Dp8G7k,True,50687661,12671915,79070,39535,39535,GAUsoe8ZTCiGPm2hYxRPGxcPe5ShNzHK9eE3G2zgRjxd,3162800,19211139,-16048339,623
2022-01-07 04:42:53.536462,2022-01-06 23:35:15-05:00,2442,GqAS41YJssg9aaEp3hs3sG98APCsXhiQBQszXaSjZ2bN,2wodJ3AhrXdE1T4oVL95KvoBND7PubG5Wd5GWiLCMZJU,True,593624455,148406113,925378,462689,462689,4BnQKPLuE3DMTtxp8MjUBytgnhvxqq3ZTqZHTVZo4JJh,37015120,427309111,-390293991,623
2022-01-07 04:42:53.536462,2022-01-06 23:35:17-05:00,2443,Hy3kzXneDN6FUkiZctU1vWe97BYvj6yZ7QvQzehfWmNr,EhXgQg8BTniANV525RpY76z7Hrh6DuqrMChjqEoXfVJe,True,4033129,1008282,6251,3125,3126,4BnQKPLuE3DMTtxp8MjUBytgnhvxqq3ZTqZHTVZo4JJh,250042,1748440,-1498398,619
2022-01-07 04:42:53.536462,2022-01-06 23:35:17-05:00,2444,7PzGZgzieFyyFs1dbajkNQgVxooFUNZrj1bUsQvrSwbp,A2gDREmSmJTBPPw3sbKVY3smC9wbHMDdv87gr4Tr2ES7,True,8887396,2221849,13850,6925,6925,3zqXX6kzhkbW3d4TwD2CNjMRwxTbREXySekvq37kfCNk,554031,3200839,-2646808,623
2022-01-07 04:42:53.536462,2022-01-06 23:35:18-05:00,2445,3qnPsgqW11AcDEmyjmJquPcPLyE3EdJQuVLJ5kinDrd3,86rZadBB7emKio76aFTahpbrFtxd9tqZ4Mxgzaavq2xU,True,493731,123432,767,383,384,3zqXX6kzhkbW3d4TwD2CNjMRwxTbREXySekvq37kfCNk,30698,177693,-146995,621
2022-01-07 04:42:53.536462,2022-01-06 23:35:19-05:00,2446,ymyzGH4Qc7HH5PbKpVphCbsQgLLXyGkPcXamQJuNj5C,8oTLHaV2XzbKXNWRuUjCfHjUn61Pw93LYK14m9q2VDpZ,True,42986114,10746528,67209,33604,33605,3zqXX6kzhkbW3d4TwD2CNjMRwxTbREXySekvq37kfCNk,2688377,13485177,-10796800,625
2022-01-07 04:42:53.536462,2022-01-06 23:35:28-05:00,2447,B4Uc39nKzz9wBRQsCkMR4A7RwTJ8rSuwpR6EQn2AesRb,H49bGZgatRZVpj6QufZRVgYrQtH7LpdbiqKBs23151m,True,80883090,20220772,126518,63259,63259,GAUsoe8ZTCiGPm2hYxRPGxcPe5ShNzHK9eE3G2zgRjxd,5060748,64342847,-59282099,625
2022-01-07 04:42:53.536462,2022-01-06 23:35:41-05:00,2448,Bsr6kx1B6BSEd5UnJ7Z61M49iUb3bFrDVhiEtMVtPDF2,3CFd1pUJAJPA9fobwn4Jj2mRju1CWmoop4Mh4znypNWT,True,95168423,23792105,147121,73560,73561,HfEnetJ7uBSmZWCjBNxdvv9HEC5nsW4wDV7wu6WnhWan,5884844,28349057,-22464213,618
2022-01-07 04:42:53.536462,2022-01-06 23:35:58-05:00,2449,BPsM1um9ZJf7eNoVMsQCRSwgARMuLCGGSDxf9tZeNeEy,BpzDdXfxVygiSYSmsHV6uPxQMeTFtrURMCCqhswQjd5X,True,3765278,941319,5855,2927,2928,4BnQKPLuE3DMTtxp8MjUBytgnhvxqq3ZTqZHTVZo4JJh,234238,1214579,-980341,622
2022-01-07 04:42:53.536462,2022-01-06 23:35:59-05:00,2450,DMgD2KCEhTGFLUZ5GnfNcwfiiwKYbyVpoWiN6knMkCAf,5KU2vgBkPTNVHsSULjgX7ZkZS56U3Dy3xqLTxL5sUZJ3,True,4452967518,1113241879,6954122,3477061,3477061,3zqXX6kzhkbW3d4TwD2CNjMRwxTbREXySekvq37kfCNk,278164905,2333907743,-2055742838,624
2022-01-07 04:42:53.536462,2022-01-06 23:35:59-05:00,2451,BYvjENe16Ta77PqGV7JKEWrsqCTfkMGYwTSG5gXneDvd,EvxAXgvhPC6QkNurbK7vWyTApGo8J2R4EgMAknkHVU3d,True,9654383,2413595,15070,7535,7535,3zqXX6kzhkbW3d4TwD2CNjMRwxTbREXySekvq37kfCNk,602820,5185299,-4582479,624
2022-01-07 04:42:53.536462,2022-01-06 23:36:12-05:00,2452,7CSCMFa9W52tBDVUbXbc3woAy3GByeA1wPJdp3MgznPa,3447ptuVFu6G8B6N63RmS8mRv4n9PfHneypHLvbeaGLn,True,345703187,86425796,540922,270461,270461,4BnQKPLuE3DMTtxp8MjUBytgnhvxqq3ZTqZHTVZo4JJh,21636916,132976809,-111339893,625
2022-01-07 04:42:53.536462,2022-01-06 23:36:21-05:00,2453,FV9CBGGTbppLnBKh79f2LzD1diTiS5g6u89FcpZHZmnK,Fe7mtmCUziFqbbYTvrhAcAq1Ub7YLfTJRtQ1hG7GzJD1,True,16991071,4247767,26586,13293,13293,3zqXX6kzhkbW3d4TwD2CNjMRwxTbREXySekvq37kfCNk,1063468,5436177,-4372709,625
2022-01-07 04:42:53.536462,2022-01-06 23:36:21-05:00,2454,9jeqT7xKb8hr5VRuQEFxnf93Y3zHsvmYDHz64nyE7Wte,9NqYMu528mFG2M7RYL1NuEvR9aiNAW13WwXDKuprQa7h,True,120256210,30064052,188029,94014,94015,4BnQKPLuE3DMTtxp8MjUBytgnhvxqq3ZTqZHTVZo4JJh,7521195,52658406,-45137211,625
2022-01-07 04:42:53.536462,2022-01-06 23:36:24-05:00,2455,6NJFN855M3Q3RLTDNo57gTgAmwPD6G2E3WvMb1m5eNCN,3YpqNnonsvXaRT4nCC3G5FZx1jjVtbDPc36LiR6WK5jR,True,246873719,61718429,378160,189080,189080,GAUsoe8ZTCiGPm2hYxRPGxcPe5ShNzHK9eE3G2zgRjxd,15126413,120794449,-105668036,612
2022-01-07 04:42:53.536462,2022-01-06 23:36:43-05:00,2456,D64rDiWT3YG28fCgXCmbNjYa2JakZbpKQ1D2XuLChUfV,8WmMWq8cTsGQym5pUbHm9dPCpJugBeWUMVERYFGLxWHj,True,115991361,28997840,180861,90430,90431,DddJ7EWCmYEEZETCBNgAUSg81Ls6fZtiAaY5ekJ5sXx1,7234456,31853578,-24619122,623
2022-01-07 04:42:53.536462,2022-01-06 23:36:47-05:00,2457,DR7XL3qweFyTKDatQYS2LacqGLv2368cnGuWpEpk4hSL,Fd3BYCiiQfThDJsxBUNwYTMP8eNCrnXMVzE1wpejJqXa,True,14893,3723,23,11,12,3zqXX6kzhkbW3d4TwD2CNjMRwxTbREXySekvq37kfCNk,928,6619,-5691,623
2022-01-07 04:42:53.536462,2022-01-06 23:36:49-05:00,2458,6rb3fRVWJ5cSzFcmuC1YwdrNxiNctvboDF7HwsfyGoCA,H6JaYfFZkRk6iSJrA4nVeuFpMVQtVwQZHVgK1TyaupTE,True,135459,33864,211,105,106,3zqXX6kzhkbW3d4TwD2CNjMRwxTbREXySekvq37kfCNk,8455,93329,-84874,624
2022-01-07 04:42:53.536462,2022-01-06 23:36:50-05:00,2459,3WcJUt8jQ1ngL3ZCGo6dFrc3GmTMTYtzeDva7mri2Tqx,HeG1Pz2oMjqtkfsRMsbqP3VpatnVEQzcWmKDVoFp4Htr,True,50673576,12668394,78980,39490,39490,GAUsoe8ZTCiGPm2hYxRPGxcPe5ShNzHK9eE3G2zgRjxd,3159215,19221640,-16062425,623
2022-01-07 04:42:53.536462,2022-01-06 23:36:52-05:00,2460,CwTus4FyoXYqyTKAYDp69NLhA1joYZ3tarzY6FFTr6fn,6ivuvYWU6i25MzJSY8rG9rPDKiq38E6QtrV1jvRubLGr,True,32680,8170,51,25,26,4BnQKPLuE3DMTtxp8MjUBytgnhvxqq3ZTqZHTVZo4JJh,2040,12014,-9974,624
2022-01-07 04:42:53.536462,2022-01-06 23:36:52-05:00,2461,Cs2YxkuqBK1kjoYZbUZdUcxapPbv8oC75trwGgWoCPfG,2PgHQM1GhHykE4bQ1ggueAw2Zs1BFUW5hxvMvr8DojKM,True,177398794,44349698,276689,138344,138345,3zqXX6kzhkbW3d4TwD2CNjMRwxTbREXySekvq37kfCNk,11067574,86770383,-75702809,623
2022-01-07 04:42:53.536462,2022-01-06 23:36:52-05:00,2462,FFoYoBmkfEsCWVXQf3BhKeaFMZD3YVKvfhPWkXdnCZS9,8yW6WApAuN43brF1HioTLdyxvQTQJzt875E26QqrWWFk,True,1729504,432376,2694,1347,1347,GAUsoe8ZTCiGPm2hYxRPGxcPe5ShNzHK9eE3G2zgRjxd,107761,403258,-295497,623
2022-01-07 04:42:53.536462,2022-01-06 23:37:12-05:00,2463,8swGZMrPrLAxZd7MxTbkCL13k3DmAJUw41jCp6Xo6awW,3fKnX7yTNXAT4uMmXVdTy47ALJT8h8YSD3WiBb4BGuzH,True,753553475,188388368,1170130,585065,585065,HfEnetJ7uBSmZWCjBNxdvv9HEC5nsW4wDV7wu6WnhWan,46805215,272992782,-226187567,621
2022-01-07 04:42:53.536462,2022-01-06 23:37:37-05:00,2464,Cb4zhnvig11U4GcC4kqKrnDicGgPhUpfDQB1U7hP3nPa,DiRAMrKqaevGXeXg38KnhaYBERj8tNKU7oWFJvhS32kw,True,507593,126898,794,397,397,DddJ7EWCmYEEZETCBNgAUSg81Ls6fZtiAaY5ekJ5sXx1,31760,156982,-125222,625
2022-01-07 04:42:53.536462,2022-01-06 23:37:37-05:00,2465,DrzTARa7RK8RXoxHZPKCBqYtMC8TAUHRw8SznXRKTa5M,FYANet92VhyXkKZqqBJR4sFxuCftWb68sgQU9VHCdTJk,True,83104,20776,129,64,65,DddJ7EWCmYEEZETCBNgAUSg81Ls6fZtiAaY5ekJ5sXx1,5182,28880,-23698,623
2022-01-07 04:42:53.536462,2022-01-06 23:37:37-05:00,2466,2d1qyEJRyGvB2H83ACSqUjqYLwcLHcURHWAKLXs4w9vp,EFA6rDFpTQcY2vjZMq6Qrjv56nJPN2FhWXNwFzkWtE2M,True,28537171,7134292,44360,22180,22180,DddJ7EWCmYEEZETCBNgAUSg81Ls6fZtiAaY5ekJ5sXx1,1774428,13733166,-11958738,621
2022-01-07 04:42:53.536462,2022-01-06 23:37:37-05:00,2467,F1JT1p2VuwK4L7zj7NNnZtYiZiNUCcTGKDkgdoX3BZdZ,3BKe4yzTwnnBnvTWP3britpPJ4oAWL7JZJzNLCxjUufS,True,16351,4087,25,12,13,3zqXX6kzhkbW3d4TwD2CNjMRwxTbREXySekvq37kfCNk,1009,3122,-2113,617
2022-01-07 04:42:53.536462,2022-01-06 23:37:38-05:00,2468,7vKmhLV45Q5etXhJL5ng8rxWhYSiUCDmAbGnwBPr7zcx,cP6xPeuHLnjr858QK1F9qYn7rJpEbPy7wEJHoju6oV7,True,108922681,27230670,168972,84486,84486,GAUsoe8ZTCiGPm2hYxRPGxcPe5ShNzHK9eE3G2zgRjxd,6758888,39525692,-32766804,620
2022-01-07 04:42:53.536462,2022-01-06 23:37:38-05:00,2469,8trkirSQNdMmAcJdeswxs5cPjH8dD6U4eJtWiAdMsrDB,HaSzpQ45x2MipfN17U6jGBxX8tXboomVDhXNSrnEfLDr,True,10736391,2684097,16753,8376,8377,4BnQKPLuE3DMTtxp8MjUBytgnhvxqq3ZTqZHTVZo4JJh,670150,3746529,-3076379,624
2022-01-07 04:42:53.536462,2022-01-06 23:37:39-05:00,2470,5Z3ZFCA65WoWhm3okRuuziEMi7ajGAEHWUFchzBNba5S,FcomdrWidygkxMKzcsY5xELbmwC652uMci648LMTv7AB,True,31295,7823,48,24,24,3zqXX6kzhkbW3d4TwD2CNjMRwxTbREXySekvq37kfCNk,1952,11073,-9121,623
2022-01-07 04:42:53.536462,2022-01-06 23:37:39-05:00,2471,2PzBAkdXkrwH9VuoMALumQz86qkW7sSBQtCrHw14JUp3,D5vwWAMHVooobG2sCWv9EwtJrAFZG6cwKH4dfmA98tbt,True,6545553,1636388,10141,5070,5071,3zqXX6kzhkbW3d4TwD2CNjMRwxTbREXySekvq37kfCNk,405641,2402204,-1996563,619
2022-01-07 04:42:53.536462,2022-01-06 23:37:41-05:00,2472,7D4rFmGMPKNAF75VRPxHAhSn2wTjiW8jmth1UD22Xqq9,GQ7BrT6vsXu8tHCMm75YdxFR2r9QTCrCUbdPEZBSAg9w,True,120636898,30159224,187388,93694,93694,3zqXX6kzhkbW3d4TwD2CNjMRwxTbREXySekvq37kfCNk,7495549,36203679,-28708130,621
2022-01-07 04:42:53.536462,2022-01-06 23:37:42-05:00,2473,6VJcr3VAEcEZaHEpt48QL8QxHKABufVp8n2JSEVTLh9U,8naR6kiySKj3vai9dCetdgCnCHgf2oyLjGqKTJ3Lz64Y,True,3770236913,942559228,5871194,2935597,2935597,3zqXX6kzhkbW3d4TwD2CNjMRwxTbREXySekvq37kfCNk,234847786,1395389118,-1160541332,622
2022-01-07 04:42:53.536462,2022-01-06 23:37:43-05:00,2474,EhANPABkSw9x9WnsDEi8pCg67iQTX2UGTTUpyjADTwdN,4FKLi98hyg9ZjM4MY6ctJsv7B6vPUnTYWdhrnNoYsztX,True,25247393,6311848,39497,19748,19749,DddJ7EWCmYEEZETCBNgAUSg81Ls6fZtiAaY5ekJ5sXx1,1579907,11723902,-10143995,625
2022-01-07 04:42:53.536462,2022-01-06 23:37:45-05:00,2475,i7TcF4weYcqgrRdH3GpndbEYxCxfcSfr9JWYrAUg1CF,BkDfknUir7PnSEW8auoB87PytycEFwyX5kT2GY4SGJJL,True,13306250,3326562,20817,10408,10409,3zqXX6kzhkbW3d4TwD2CNjMRwxTbREXySekvq37kfCNk,832711,9771648,-8938937,625
2022-01-07 04:42:53.536462,2022-01-06 23:37:45-05:00,2476,6Bq55LtGCEeGqh4JrFLCmmGc2iJfTTBJixivqH78aGSE,DSNrCgWJeNe2P9tAQu5FvCueTzNKDKds7wzuwTQSMRG,True,21412366,5353091,32953,16476,16477,DddJ7EWCmYEEZETCBNgAUSg81Ls6fZtiAaY5ekJ5sXx1,1318138,6743396,-5425258,615
2022-01-07 04:42:53.536462,2022-01-06 23:38:40-05:00,2477,CK3ocyWzXQkJJZQmM6bBK4Nv6Rh3UEufjY6DvNU6gJZy,C924o4GY3p2BHLeAbFbe9SEysXqCUyD8sFu2d4NzkAV7,True,16398271,4099567,25648,12824,12824,3zqXX6kzhkbW3d4TwD2CNjMRwxTbREXySekvq37kfCNk,1025935,5190935,-4165000,625
2022-01-07 04:42:53.536462,2022-01-06 23:38:40-05:00,2478,E1wp3bmkcY3eiEYyGYwhTCsr7BZ7RfPa5DJTZFupcFwj,452hVdYkD5SDDrA6hv6DLPFvyS8PvR2P6DPNScGxWTsW,True,2029047,507261,3173,1586,1587,3zqXX6kzhkbW3d4TwD2CNjMRwxTbREXySekvq37kfCNk,126948,767314,-640366,625
2022-01-07 04:42:53.536462,2022-01-06 23:39:48-05:00,2479,4ytoBUwuhAL4YYSCa6AgwrpeVF4eeU8H9NfDxMPZKxPo,Pby2szzsxDrXt4gnbmmaMccXxctZALr8miRtKhGKjsD,True,17280698,4320174,27042,13521,13521,GAUsoe8ZTCiGPm2hYxRPGxcPe5ShNzHK9eE3G2zgRjxd,1081689,6998663,-5916974,625
2022-01-07 05:59:46.759629,2022-01-07 00:59:26-05:00,2480,DMgPzJnMQfvpk6LWscs9V9CwnYDj4CEUgKB9S65WsTaY,BZRSLH1Vw1BQwXTZtBcgUYqmFF7TuzYxAaZ8TXUKwLUQ,False,14255,14255,413,20,393,GmqQKnMfFxkv6ChqGaZ2wmSFDow7R1x7WeRfU58GVvfw,413,7438,-7025,289
2022-01-07 06:57:25.997427,2022-01-07 01:46:11-05:00,2481,75ycx5sUFBxDhY1uwuPCW22s2C6BydkJTje7q7zEQFGT,FpEgrVFRubjGK4DRjTqdVbxSECURpn16zfpoC31NbwnN,True,16042283,4010570,25018,12509,12509,3zqXX6kzhkbW3d4TwD2CNjMRwxTbREXySekvq37kfCNk,1000746,7456195,-6455449,623
2022-01-07 06:57:25.997427,2022-01-07 01:46:13-05:00,2482,2NHv3c4ufYGo3xNr6KXymAZJdpfURrNiCKbXZ7s82Vwo,E4NYpYgHTvSG6LqH2bBV9Q1XJ6pAzCp9FLSKMzJmYRrQ,True,65081655,16270413,101326,50663,50663,HfEnetJ7uBSmZWCjBNxdvv9HEC5nsW4wDV7wu6WnhWan,4053059,30877636,-26824577,622
2022-01-07 06:57:25.997427,2022-01-07 01:50:00-05:00,2483,9jdfc9GFTecsdRuTjWFGX13niKKmeBxRgtv5j86uhSnU,HLWMShobjSkaLyXrNjgwVaUGVtbtdUSnr1XjqpXn1bLR,True,736816,184204,1152,576,576,3zqXX6kzhkbW3d4TwD2CNjMRwxTbREXySekvq37kfCNk,46104,297834,-251730,625
2022-01-07 06:57:25.997427,2022-01-07 01:50:00-05:00,2484,AKxRtcdpi7gWhAuL8ENj7zhgeQezzEXe9TSANE6bQoRA,2YH4vrU9deP8Cu6E8Hzf8GqKG1yVjv5pdz4FE7r5YKir,True,17207528,4301882,26547,13273,13274,3zqXX6kzhkbW3d4TwD2CNjMRwxTbREXySekvq37kfCNk,1061882,6170888,-5109006,617
2022-01-07 06:57:25.997427,2022-01-07 01:50:00-05:00,2485,D3mXrJzhHf8qRaoCKLschUxAFoijFCFuT6bmNZH4W7Cj,9E3Xtqw7TncXWnbhAbFJMtuNmP6WS3ooGuptzyzw7UpA,True,145470,36367,226,113,113,3zqXX6kzhkbW3d4TwD2CNjMRwxTbREXySekvq37kfCNk,9070,72649,-63579,623
2022-01-07 06:57:25.997427,2022-01-07 01:50:00-05:00,2486,HqtTbC1LFreGvgfpZe7nCqkNnh8GHPQKosfmc19zb1yi,E39UNiHNkwQEd5GXkCtTPqSorQSB1kLx8kjzK4jdFoi3,True,781758013,195439503,1219620,609810,609810,GAUsoe8ZTCiGPm2hYxRPGxcPe5ShNzHK9eE3G2zgRjxd,48784828,327733306,-278948478,624
2022-01-07 06:57:25.997427,2022-01-07 01:50:00-05:00,2487,HutRztBianNUgm9sJDWKUQBmoVyy8y7CfnNk4hHjSkEW,EtVfvPyiy5bizbCZxR19TNUgETf3QcmziBvMtc6o5zjr,True,619811437,154952859,966614,483307,483307,DddJ7EWCmYEEZETCBNgAUSg81Ls6fZtiAaY5ekJ5sXx1,38664576,475361177,-436696601,623
2022-01-07 06:57:25.997427,2022-01-07 01:50:00-05:00,2488,GJ3PbEfPK8jjrPgMmZtvN5fMSSy2dtiiAtZ8wcfgxVuc,FCUDVFb2TjDvehHE8fVBofqSykpb9W6Afc9QeHtj7te7,True,193070778,48267694,300112,150056,150056,4BnQKPLuE3DMTtxp8MjUBytgnhvxqq3ZTqZHTVZo4JJh,12004503,95540898,-83536395,621
2022-01-07 06:57:25.997427,2022-01-07 01:50:02-05:00,2489,8vva9SmKpMGW8wjpkvydQczxVK6VtN79qzH2i4JQSwg4,F8a3GLicsSapt4aLURoU4qHxJaxCij4LS6JVxoMF3YHT,True,2413837,603459,3761,1880,1881,3zqXX6kzhkbW3d4TwD2CNjMRwxTbREXySekvq37kfCNk,150458,564122,-413664,623
2022-01-07 06:57:25.997427,2022-01-07 01:50:04-05:00,2490,89CkXnSZnr52Zsoh48efv9MQacrkB6GMtrbEpNJSyA2H,HcvRBS4Z22CpYgDNgm4TVF4AVXFDuYzBUAFcdHAwdpg4,True,7536267,1884066,11681,5840,5841,GAUsoe8ZTCiGPm2hYxRPGxcPe5ShNzHK9eE3G2zgRjxd,467253,2708226,-2240973,620
2022-01-07 06:57:25.997427,2022-01-07 01:50:05-05:00,2491,Ar5QB4VBcUyzSCG23z2QNAbrWY55NbHCr1MNN6P2GAmh,BusFGTiDrJmxzwGUxWz9b3SFF3eseqtgh2DRHqyAwyVe,True,1162917,290729,1807,903,904,4BnQKPLuE3DMTtxp8MjUBytgnhvxqq3ZTqZHTVZo4JJh,72298,443088,-370790,621
2022-01-07 06:57:25.997427,2022-01-07 01:50:05-05:00,2492,JCBhqqPQxP1Xc41sSY6e1sQKRstHhe7D1v6rLz4hp3Qp,DWMUq2bMD1jqpxHtyXDFjcAwjA27yyMRe68hGcsK143m,True,17526,4381,27,13,14,DddJ7EWCmYEEZETCBNgAUSg81Ls6fZtiAaY5ekJ5sXx1,1094,6227,-5133,624
2022-01-07 06:57:25.997427,2022-01-07 01:50:05-05:00,2493,2p2fGXdKrmxjomLSnyaNg84J82cBBBNympZ6qQc8UZgU,HKAM8bazuLMUY6yapZJqYsgaWkTBqKHyMs1hSfpYsZGi,True,1980252705,495063176,3072900,1536450,1536450,DddJ7EWCmYEEZETCBNgAUSg81Ls6fZtiAaY5ekJ5sXx1,122916028,897865149,-774949121,620
2022-01-07 06:57:25.997427,2022-01-07 01:50:05-05:00,2494,2rCRdyfi65rpxRRmg7knaSb8t55FuPt3h8wF4Fzhy8MM,CLVY5nSG3jTdRo7tRSKgK9DJgW6aswfWKe4tLxzsENmb,True,1583645,395911,2452,1226,1226,4BnQKPLuE3DMTtxp8MjUBytgnhvxqq3ZTqZHTVZo4JJh,98106,501494,-403388,619
2022-01-07 06:57:25.997427,2022-01-07 01:50:05-05:00,2495,96DzqyUxsB1FKWrhLdTdjDcokuus6rbx83gLsghqPPwt,74CWb7SVoSy3ADysEzFEeMiS2fxHJ9gdUF9pzM3E52Gj,True,48675,12168,75,37,38,GAUsoe8ZTCiGPm2hYxRPGxcPe5ShNzHK9eE3G2zgRjxd,3026,17284,-14258,621
2022-01-07 06:57:25.997427,2022-01-07 01:50:05-05:00,2496,GaEpNGa8jnwSRvjzzEMYkZe1pKcr2eiZtePrqFxpABjB,5CFZHuyWbJv14zPdX5dSQDREgHrCb4vsFvB6hLiEe3Ji,True,382881,95720,592,296,296,3zqXX6kzhkbW3d4TwD2CNjMRwxTbREXySekvq37kfCNk,23685,139148,-115463,618
2022-01-07 06:57:25.997427,2022-01-07 01:50:06-05:00,2497,BzSJ77zKaqtBk2cEL1XqFL97zTXXMRHmxtkgtXwCc3C,2g4KXTwy2MPSRQ2khNp1o1rn7CradEr9H4ySYKDoSWN9,True,25405185,6351296,39727,19863,19864,3zqXX6kzhkbW3d4TwD2CNjMRwxTbREXySekvq37kfCNk,1589118,22150902,-20561784,625
2022-01-07 06:57:25.997427,2022-01-07 01:50:06-05:00,2498,9YEzjb49Awvedv9yNc6LG54SkGBug2RYiJwiUV13mGsS,3H8w5WCD187NWWoZMNUCzUDdxTgqrRJLga8gDzUVXBgZ,True,2757967,689491,4299,2149,2150,DddJ7EWCmYEEZETCBNgAUSg81Ls6fZtiAaY5ekJ5sXx1,171995,1484727,-1312732,623
2022-01-07 06:57:25.997427,2022-01-07 01:50:07-05:00,2499,4MmpDGUTyMcYEqJ1RoZ46AN2BhrBUseHaHqF8AmiTPyD,7HW2YZpYM349HMfW7u4h9ESZ1AXkwN8JcVDTNFzp9aTz,True,301907509,75476877,471269,235634,235635,3zqXX6kzhkbW3d4TwD2CNjMRwxTbREXySekvq37kfCNk,18850796,139510022,-120659226,624
2022-01-07 06:57:25.997427,2022-01-07 01:50:09-05:00,2500,2NdwSLxsGok8PczpCZj9CVX2BymNU5MvHt7hWfGetg2M,8AQbDXeA6mD9QoZBFJcYbnHvZwKNxzA9CCHLAgdSfTA3,True,26792,6698,41,20,21,3zqXX6kzhkbW3d4TwD2CNjMRwxTbREXySekvq37kfCNk,1675,12421,-10746,625
2022-01-07 06:57:25.997427,2022-01-07 01:50:09-05:00,2501,EQUZQWk4WLT6LFeWZs3P9AQufFcoZouFETfhyxvuS2JM,Byc2mLXArmkjQPWaxCJksHZD2XpZyCQ2FRtDJyztU81V,True,239031696,59757924,373576,186788,186788,3zqXX6kzhkbW3d4TwD2CNjMRwxTbREXySekvq37kfCNk,14943041,119600728,-104657687,625
2022-01-07 07:10:30.978874,2022-01-07 02:05:06-05:00,2502,DkvR2xUPMyXWGGkUSmDSfhp7RtvMkfbT1ThKCS3TwrXd,F7jYV6TtT1LZ5XCNn1zkbUfNMo4gGcQUczAQy1jLHpaW,True,1976614355,494153588,3083722,1541861,1541861,3zqXX6kzhkbW3d4TwD2CNjMRwxTbREXySekvq37kfCNk,123348881,697125526,-573776645,624
2022-01-07 07:10:30.978874,2022-01-07 02:05:06-05:00,2503,2jDRvE3pQNjWy1NRFa4tzB3KmU5UkbUCHw8sQRFujo66,C4zNi2szDrEEh4coTF3WRUghfP4ZwAVVSYTLWfkejQRu,True,1554898209,388724551,2414140,1207070,1207070,HfEnetJ7uBSmZWCjBNxdvv9HEC5nsW4wDV7wu6WnhWan,96565630,460789390,-364223760,621
2022-01-07 07:10:30.978874,2022-01-07 02:05:07-05:00,2504,DY6k3Dkwe18iLneaT8Xo3VpJWB6V4jWwQQjoDvEzdg2j,3GGV7S9FpRQGbARBXkvGFVqLrmw8JvYAcpnR1aKVUY2f,True,40200178,10050044,62248,31124,31124,4BnQKPLuE3DMTtxp8MjUBytgnhvxqq3ZTqZHTVZo4JJh,2489929,19783943,-17294014,619
2022-01-07 07:10:30.978874,2022-01-07 02:05:07-05:00,2505,8BMDSWFtzq9fu1ubVGtSFw8fEaMg1uvJiECuJnN8e1pd,FwkETAXL296CirvQ2AJuSHHtdKsxkZkmXSwZVVHXVDhA,True,327169959,81792489,505945,252972,252973,3zqXX6kzhkbW3d4TwD2CNjMRwxTbREXySekvq37kfCNk,20237815,114946621,-94708806,618
2022-01-07 07:10:30.978874,2022-01-07 02:05:08-05:00,2506,HdfQweV1KuYSpWdycZbpGrUc8yMcY3ZczLn1agKXMJaf,G1Ae1PZHkANkwFnhUKS1tvdFEv8dAFeojBkezh6rUNMh,True,17376769,4344192,27043,13521,13522,3zqXX6kzhkbW3d4TwD2CNjMRwxTbREXySekvq37kfCNk,1081735,7088019,-6006284,622
2022-01-07 07:10:30.978874,2022-01-07 02:05:08-05:00,2507,6XHt7CrURSomkQrtVXV5JuKSZY4tQRpUyQKfCDaSTYaD,GCgcmPSDDBsn2smYbpiX3PJybDkQWtufPu4YRsbEEU8X,True,848010680,212002670,1315362,657681,657681,DddJ7EWCmYEEZETCBNgAUSg81Ls6fZtiAaY5ekJ5sXx1,52614488,466483627,-413869139,620
2022-01-07 07:10:30.978874,2022-01-07 02:05:08-05:00,2508,Mcbzp1LhZwpfmXTv1pqe9D1jCKHw443j9QKp6tUpzgM,8uforSMAKEih5jHfHp3gCqCvaugtCmhzVfVHA63Akz7F,True,5015413,1253853,7840,3920,3920,3zqXX6kzhkbW3d4TwD2CNjMRwxTbREXySekvq37kfCNk,313638,2336730,-2023092,625
2022-01-07 07:10:30.978874,2022-01-07 02:05:08-05:00,2509,EeUACm9TkjHKES5U7Yj1oPhYmcp7R3tvesGBiP8txEzq,3qkmm4aS6EDirEDejmbm5PDw2jpYkC7zKqrMkmgeE5BA,True,580677,145169,899,449,450,DddJ7EWCmYEEZETCBNgAUSg81Ls6fZtiAaY5ekJ5sXx1,35965,176945,-140980,619
2022-01-07 07:10:30.978874,2022-01-07 02:05:11-05:00,2510,EV21gv8jEvXtmGDoGRNm5LJEvTBccLMZyVDCLsp54jP3,DGxxoU52aQNoUQcxdvQtv2H5q2PhK6TGkLgNSaFgnZrb,True,11212255,2803063,17338,8669,8669,3zqXX6kzhkbW3d4TwD2CNjMRwxTbREXySekvq37kfCNk,693553,4249629,-3556076,618
2022-01-07 07:10:30.978874,2022-01-07 02:05:12-05:00,2511,AtKuDfcFXqWUMnRqQpjedUMTb5CQKLc2zoqEAcQpysKQ,9bPFLYp5TDZruLLDXDYYCiPYcD982iF8xt5rfTkqwNsL,True,27974,6993,43,21,22,4BnQKPLuE3DMTtxp8MjUBytgnhvxqq3ZTqZHTVZo4JJh,1737,9719,-7982,620
2022-01-07 07:10:30.978874,2022-01-07 02:05:48-05:00,2512,9WJBnVi84E926j7xEd566WzrZJkPJWRgmEnYj9vyjuad,4dLaFS5F7TGyLdwuJLMGkz3bSL53aHzd9ZfpNmhHxXeF,True,49816533,12454133,77023,38511,38512,4BnQKPLuE3DMTtxp8MjUBytgnhvxqq3ZTqZHTVZo4JJh,3080921,21509357,-18428436,618
2022-01-07 07:10:30.978874,2022-01-07 02:05:48-05:00,2513,8E3K7vCHJ2xjdFofPRGLbMxrkm8UYEi926QmXPAFwsqe,4qHUDA1c43Dg4qi1ZPKqmpGYiEMUZ6r4UuzB5ftHCEhW,True,4596990507,1149247626,7067197,3533598,3533599,HfEnetJ7uBSmZWCjBNxdvv9HEC5nsW4wDV7wu6WnhWan,282687903,2009247791,-1726559888,614
2022-01-07 07:10:30.978874,2022-01-07 02:05:51-05:00,2514,4uygLJDk9DFCifJ56YwMrEsvd3oQNq8tYSLnMCyWorS6,GimL4uKGvg3FFmFQSWzAcjstv3Vmk5NMgDGMKTuXYVpB,True,1682053934,420513483,2609241,1304620,1304621,DddJ7EWCmYEEZETCBNgAUSg81Ls6fZtiAaY5ekJ5sXx1,104369674,575250927,-470881253,620
2022-01-07 07:10:30.978874,2022-01-07 02:05:51-05:00,2515,D9VKhnfLLCrntDGFYSfoxFaY76VnHmYZ1ZbyFXdKdibz,2hRCRH2pMDyQGYcXHa8Y6BZo6FbcGZf5VJC1v8Bp6tGa,True,298313074,74578268,464081,232040,232041,4BnQKPLuE3DMTtxp8MjUBytgnhvxqq3ZTqZHTVZo4JJh,18563247,92564552,-74001305,622
2022-01-07 07:10:30.978874,2022-01-07 02:05:54-05:00,2516,A4tDE948CPFPh1UwHb8sXryfKktbxZ8BCkqXgA5DJHA8,3zXeKMrsEpCe5fQumLNzCgpxcG1kLJFEAtJuqxLsC6ZG,True,281018646,70254661,436793,218396,218397,3zqXX6kzhkbW3d4TwD2CNjMRwxTbREXySekvq37kfCNk,17471748,103718088,-86246340,621
2022-01-07 07:10:30.978874,2022-01-07 02:05:55-05:00,2517,399591e8XgY52yCMorCQ2WL6dQZTC485ZooHtmGuirhZ,JCiXAooFmKmEPQ2S7C8iSk6CLcTyrPEe1SsPSLyUGySe,True,3472002,868000,5391,2695,2696,HfEnetJ7uBSmZWCjBNxdvv9HEC5nsW4wDV7wu6WnhWan,215643,1726550,-1510907,621
2022-01-07 07:10:30.978874,2022-01-07 02:05:55-05:00,2518,8kJu5aqVSmW8FSZR9h6F75ftn9V2U9uMLBEKeqRaC855,FhVHByujkvwwtjTVpZ4mqSUqoMoBgeLUc5H7rbz3FgAt,True,286666808,71666702,446362,223181,223181,3zqXX6kzhkbW3d4TwD2CNjMRwxTbREXySekvq37kfCNk,17854480,142563826,-124709346,622
2022-01-07 07:10:30.978874,2022-01-07 02:06:06-05:00,2519,CFFpbRxYEP18rqEGxxyG3bzSV13Lv7nfSmZvtUK17kCP,824UwqH2JcFsqYBk9MZ8tTnpka9udTL6WGX35YFtAJQk,True,8898596,2224649,13884,6942,6942,3zqXX6kzhkbW3d4TwD2CNjMRwxTbREXySekvq37kfCNk,555382,3181640,-2626258,624
2022-01-07 07:10:30.978874,2022-01-07 02:06:06-05:00,2520,7LRBswSEDBjJzQ4YurfTxLydh7tFS2jVn5V95Z6wL7ci,fD41VYGmk66MW46KKb23vAqQvUSDScgXnVdsHhJBZzu,True,295645,73911,453,226,227,DddJ7EWCmYEEZETCBNgAUSg81Ls6fZtiAaY5ekJ5sXx1,18128,127945,-109817,613
2022-01-07 07:10:30.978874,2022-01-07 02:06:06-05:00,2521,FSduW743jAGyyn8HTifEJitgb89Spp5gEeMXDE59aEHF,HjojGNpR3ACtLCP2mP8DKGyXj6SeqWPKjcCAofcyQpsm,True,463602775,115900693,712722,356361,356361,3zqXX6kzhkbW3d4TwD2CNjMRwxTbREXySekvq37kfCNk,28508896,147269069,-118760173,614
2022-01-07 07:10:30.978874,2022-01-07 02:06:06-05:00,2522,6WNPf4rFCX74PuyvdmzRFqbxWhguuxTQqBSdnaTVBd5D,9N7a9aiHGQsxFMgVbmWoCF9w95d12xyT7XFAwpHGkTLA,True,3777896,944474,5761,2880,2881,3zqXX6kzhkbW3d4TwD2CNjMRwxTbREXySekvq37kfCNk,230464,877570,-647106,610
2022-01-07 07:10:30.978874,2022-01-07 02:06:06-05:00,2523,5hUZ9uQFcYnjAQVVaGLJWdKyg7y1XMpoo8osQ9DeY7Xd,BdYiKWsjuzJLcHh3814mJ4xQ9JxoQKKcr7AHZ7Vxoavq,True,101782,25445,158,79,79,DddJ7EWCmYEEZETCBNgAUSg81Ls6fZtiAaY5ekJ5sXx1,6340,38025,-31685,622
2022-01-07 07:10:30.978874,2022-01-07 02:06:08-05:00,2524,CAkknoa9UFPMEZ1KWSfqtmnL7ArVNV3HRETLwecuuXP,4cHJYv3dxA6qjcuxUkGRuL7STWobGPKtoHFD4ACUbiWq,True,26272557,6568139,40412,20206,20206,DddJ7EWCmYEEZETCBNgAUSg81Ls6fZtiAaY5ekJ5sXx1,1616497,9354248,-7737751,615
2022-01-07 07:10:30.978874,2022-01-07 02:06:09-05:00,2525,C7a8BtMjuLXkzxZBC4Wk2gjkGBmucLmDjokf9pyA1Mu6,GxwYNWwYTtFMUxuZvNC5qrEYuJzYiEURQVuBxssfCJzr,True,3846444,961611,5938,2969,2969,4BnQKPLuE3DMTtxp8MjUBytgnhvxqq3ZTqZHTVZo4JJh,237527,891085,-653558,617
2022-01-07 07:10:30.978874,2022-01-07 02:06:09-05:00,2526,8VT2nxz5ZYDJFd9uL2XZwEXxChd9pjuMJNMAcutZubL1,EhAkiRbouzUAWtqQFsN8HEEfi46UVN8H8tyBP7CbgeLe,True,23020,5755,35,17,18,3zqXX6kzhkbW3d4TwD2CNjMRwxTbREXySekvq37kfCNk,1407,9580,-8173,611
2022-01-07 07:10:30.978874,2022-01-07 02:06:19-05:00,2527,FnAT8HKGgisYfeAbxKU2gSbCp8KbZHULRpaJX1NVijHy,2u637Crc2QzfSJmCnRNqeib3aZQVn4NGncpgM3Ph6jvm,True,111188070,27797017,172878,86439,86439,3zqXX6kzhkbW3d4TwD2CNjMRwxTbREXySekvq37kfCNk,6915128,29722339,-22807211,621
2022-01-07 07:10:30.978874,2022-01-07 02:06:19-05:00,2528,s2NgHqXLYtUrRaA6LnDwmxcS5nqfURXw47DmLy7Pn9E,2qn4QbLj5miEB2zZB4v5dhptm3JRbpQRrpTBgPDzokw1,True,5298929,1324732,8139,4069,4070,3zqXX6kzhkbW3d4TwD2CNjMRwxTbREXySekvq37kfCNk,325585,3575794,-3250209,614
2022-01-07 07:10:30.978874,2022-01-07 02:06:28-05:00,2529,8mbMH9EKd9kQDyFrYiDJCV9VaWxWCzpZBQZLyYN2yNVx,J9gT39dF1egMeQvweXYWeRAX3kpmBABijYZhfj6M2UqU,True,56409999,14102499,88220,44110,44110,3zqXX6kzhkbW3d4TwD2CNjMRwxTbREXySekvq37kfCNk,3528813,16719944,-13191131,625
2022-01-07 07:10:30.978874,2022-01-07 02:07:31-05:00,2530,ZoNjrSjYh4NJLW38LUPcf7jtEBxdaaM7T1zp795qjHE,FZx6v8cU25NwEosbKJ2n141o9uFAWURZB7NeCeX1trEn,True,3530327,882581,5488,2744,2744,4BnQKPLuE3DMTtxp8MjUBytgnhvxqq3ZTqZHTVZo4JJh,219533,814207,-594674,621
2022-01-07 07:10:30.978874,2022-01-07 02:07:31-05:00,2531,Buioe5v3DyFwD9nquW5XdYeVYbSABCyg79eUHEvtvfaW,7T9gi7prCcZJkYJMSB5Ef6Bu4pAuBw4XLvumSFnqKDSi,True,1635042,408760,2536,1268,1268,DddJ7EWCmYEEZETCBNgAUSg81Ls6fZtiAaY5ekJ5sXx1,101460,807295,-705835,620
2022-01-07 07:10:30.978874,2022-01-07 02:07:31-05:00,2532,CEbGTNX6WpaoKp4RBGSn9LzYM6yAYyeiMrgVYgJxA4zb,AiXUcGAFFm4tc7vKBscSNjZawV5YJqbv7D1KpxD3Zufg,True,45809339,11452334,71125,35562,35563,DddJ7EWCmYEEZETCBNgAUSg81Ls6fZtiAaY5ekJ5sXx1,2845006,22557593,-19712587,621
2022-01-07 07:10:30.978874,2022-01-07 02:07:32-05:00,2533,FsMiJiJZibohKoV5QRisWCjzuFd86xSxFb4m73AQmu93,7p3TSKBaG9SV2YNDnhutQKacPKpTTmgsEfzmK51t6sYb,True,676624402,169156100,1053529,526764,526765,3zqXX6kzhkbW3d4TwD2CNjMRwxTbREXySekvq37kfCNk,42141193,181154135,-139012942,622
2022-01-07 07:10:30.978874,2022-01-07 02:07:32-05:00,2534,C4dbwF9mioaBkZnyBFvFs6Cqd362VuGPBGPbTY9CAnAk,CcUqBfu1hbWm5VVxbtF2Xm6HUz4CLFzuDsjUi6KtnZQg,True,4110058,1027514,6378,3189,3189,DddJ7EWCmYEEZETCBNgAUSg81Ls6fZtiAaY5ekJ5sXx1,255157,945100,-689943,620
2022-01-07 07:10:30.978874,2022-01-07 02:07:33-05:00,2535,3zH1b58jqbNU37y9kDTZZrotSeT8XzS1tuyAHPKWrbah,4trxDWV16x6sVcz7bxHehYHkjjyKebh3S9fyJf8txzK5,True,17493,4373,27,13,14,3zqXX6kzhkbW3d4TwD2CNjMRwxTbREXySekvq37kfCNk,1095,6145,-5050,625
2022-01-07 07:10:30.978874,2022-01-07 02:07:39-05:00,2536,AUH6YGBV8tDVX1E1WTo92Mubfx1DGsqfGeyUBqxo4fSr,33QZgMwmW32WuvmxD8XNbmF9ea88bLe3YTtNwHV73Wwu,True,676662637,169165659,1045976,522988,522988,4BnQKPLuE3DMTtxp8MjUBytgnhvxqq3ZTqZHTVZo4JJh,41839072,186422630,-144583558,618
2022-01-07 07:10:30.978874,2022-01-07 02:07:42-05:00,2537,9KD2AifD5wFD4QkHYuawXbJgLWHrfj2QPF3fT8jhGVA5,Ga9gAqmkuHbqrr31sUFPqa1xa5WNxLWJWGPUaMxQqLdj,True,3153030,788257,4879,2439,2440,DddJ7EWCmYEEZETCBNgAUSg81Ls6fZtiAaY5ekJ5sXx1,195180,1596600,-1401420,619
2022-01-07 07:10:30.978874,2022-01-07 02:08:01-05:00,2538,A36aouot1oFLUtswuBUM4EVcis9chKaSJu53MRoPDjab,33U9gpq1RRFMGWDrWa3ezXXkwgBewdAS6QGgGVPtGvqb,True,871884491,217971122,1353123,676561,676562,3zqXX6kzhkbW3d4TwD2CNjMRwxTbREXySekvq37kfCNk,54124939,232296892,-178171953,620
2022-01-07 07:10:30.978874,2022-01-07 02:08:02-05:00,2539,3VdSA9CED9f5swRwHX2U15U7J6Muaq8VPnCNy9CaGDHe,2YYstfnfdYic5NWmEbcUEHpccNUVd1EhuCkExvMsoMk8,True,16231974,4057993,25165,12582,12583,DddJ7EWCmYEEZETCBNgAUSg81Ls6fZtiAaY5ekJ5sXx1,1006612,8119224,-7112612,620
2022-01-07 07:10:30.978874,2022-01-07 02:08:02-05:00,2540,HwosLQgDY1xtHQRQ4hzroPQHFWssPzTj5vRkP37FcviB,HKTNEYNXrephNkH7apbobK4mcQXcNayQA4W1NgM6sLr8,True,109266636,27316659,170289,85144,85145,3zqXX6kzhkbW3d4TwD2CNjMRwxTbREXySekvq37kfCNk,6811580,28604431,-21792851,623
2022-01-07 07:10:30.978874,2022-01-07 02:08:15-05:00,2541,H6tDNj9cHac223ckAnNfnC4bAJuNLBnf2pFk2iQdMzMP,28UL9dqgayCqCAexScXjdpobYGVDN44SGBVNAfBByk8C,True,154545925,38636481,241854,120927,120927,3zqXX6kzhkbW3d4TwD2CNjMRwxTbREXySekvq37kfCNk,9674184,77448918,-67774734,625
2022-01-07 07:10:30.978874,2022-01-07 02:08:15-05:00,2542,EEcTbsFTUEifcdbPyjBLkS943daEx1RpR8F3uZxKRZbT,8V3JzDQ1VWYQLas8fxUsWJZZHe4gEmn74RehtUwLw3k5,True,12363548,3090887,19205,9602,9603,3zqXX6kzhkbW3d4TwD2CNjMRwxTbREXySekvq37kfCNk,768231,5363233,-4595002,621
2022-01-07 07:10:30.978874,2022-01-07 02:08:15-05:00,2543,FjDp4bWCtqehFD7FunCrjrcdxMezTJj5aqh2VnBvHDQU,HRYeZqcqhP1RPiAGXziR1qCWwk4sF6c5ZYbvSDhX7foN,True,18525540,4631385,28747,14373,14374,HfEnetJ7uBSmZWCjBNxdvv9HEC5nsW4wDV7wu6WnhWan,1149885,6352495,-5202610,620
2022-01-07 07:10:30.978874,2022-01-07 02:08:15-05:00,2544,EgU9hX6VK7YXeCgCHVaJAMekCcyZa2MVWdKra5pN7Gwv,7y8Ad9XY34bqREvheXHT2tr8Jy11D6X3pu7yLVtjU4QV,True,22880804,5720201,35574,17787,17787,3zqXX6kzhkbW3d4TwD2CNjMRwxTbREXySekvq37kfCNk,1422991,10007991,-8585000,621
2022-01-07 07:10:30.978874,2022-01-07 02:08:15-05:00,2545,3g1debT8Z2efQPuMNSDPUNZzDqarBG2acErsZ4HP7QGA,42wDHagxr5Nno3mUx6kyYGDjwR98aedRbh3ByB468agB,True,43693,10923,68,34,34,3zqXX6kzhkbW3d4TwD2CNjMRwxTbREXySekvq37kfCNk,2734,15764,-13030,625
2022-01-07 07:10:30.978874,2022-01-07 02:08:15-05:00,2546,5BjBPqumCb9KC82ZNNch3dcRzbpGdRLJneru7o9a1D9R,FuZtBWKktxFu4yoiLVMzxq8fMhQyN8SGzGPz49xs3m6P,True,340340325,85085081,530646,265323,265323,HfEnetJ7uBSmZWCjBNxdvv9HEC5nsW4wDV7wu6WnhWan,21225843,148677052,-127451209,623
2022-01-07 07:10:30.978874,2022-01-07 02:08:15-05:00,2547,DiPSJvnnEwg1En7HJfEsKrUbBgtUf4KzGMyMCZDQSYgp,s8UVC6vPBofuXUS6RW1aQmZ8C35PrC5r4A6ugmvzLGB,True,4493201,1123300,6989,3494,3495,3zqXX6kzhkbW3d4TwD2CNjMRwxTbREXySekvq37kfCNk,279571,1036372,-756801,622
2022-01-07 07:10:30.978874,2022-01-07 02:08:16-05:00,2548,2ce2v2TCbjNH635NgbwTG3sqiRWYrRRaBpxPxBZJ929q,9cnoebT43FkWDFhidndGCVNiFD4NErv8DuL1Va4Jv9S8,True,13898435,3474608,21697,10848,10849,3zqXX6kzhkbW3d4TwD2CNjMRwxTbREXySekvq37kfCNk,867915,9720604,-8852689,624
2022-01-07 07:10:30.978874,2022-01-07 02:08:16-05:00,2549,4FazDUgfQ3AKoFcnWHr8E9Ht8jLA3tkxf75yrGZVHdmF,HzRMH6mbgEKydRCnnMvSsKgTEVNQi6nuzoR1xutYFdzg,True,141596,35399,221,110,111,3zqXX6kzhkbW3d4TwD2CNjMRwxTbREXySekvq37kfCNk,8861,92354,-83493,625
2022-01-07 07:10:30.978874,2022-01-07 02:08:35-05:00,2550,93ho4cgnpAJiJsG6uu2udkLVNU7rkz4QjCYfsqvpbPA5,45ouQn9gGwXqnTGfaP5CvU8fCKadBRA5kPwtfvJzykRU,True,146551977,36637994,229198,114599,114599,3zqXX6kzhkbW3d4TwD2CNjMRwxTbREXySekvq37kfCNk,9167938,44782745,-35614807,625
2022-01-07 07:10:30.978874,2022-01-07 02:09:00-05:00,2551,5kwvkEtRFFD84j4ntVgxkacadgJaFvQ9JLhJqzLR7Y3G,GpMMkTv9T7y8DTiizuoJUsWvnSk3GSxADjRMGyYpryxm,True,76061128,19015282,118544,59272,59272,4BnQKPLuE3DMTtxp8MjUBytgnhvxqq3ZTqZHTVZo4JJh,4741784,19315656,-14573872,623
2022-01-07 07:10:30.978874,2022-01-07 02:09:12-05:00,2552,7MSzV5yy5FmrM4j1BcYSRiTGWfit1AJahheRUaXzz349,aPSTZLxBpVr3sucjbj95emRV2J1GrUWr7wbARYqJkQZ,True,10270089,2567522,15798,7899,7899,3pStmNaV47N2sqUtHJHLAtCKiN9JZ6jzNY9h94ng8G1D,631956,3035002,-2403046,615
2022-01-07 07:10:30.978874,2022-01-07 02:09:16-05:00,2553,Gbxc51WERLLeCtiHv7rDvE52aqF541RoQWG5n5aqErq6,4ngBoHbfXijLMqGKxFMNht9sbmxy2g5eqBmn8QsBmbx1,True,2361643,590410,3632,1816,1816,4BnQKPLuE3DMTtxp8MjUBytgnhvxqq3ZTqZHTVZo4JJh,145303,939099,-793796,615
2022-01-07 07:10:30.978874,2022-01-07 02:09:16-05:00,2554,7W6ih2ZGXaE6tvuQFUPCvc7NvEJHy7UffgoVX3ZPdLXt,6uQCkeMjEXHBQxE2HD33RM1zyTsSko1fYZA1mWUggJ5B,True,59269,14817,92,46,46,DddJ7EWCmYEEZETCBNgAUSg81Ls6fZtiAaY5ekJ5sXx1,3685,22198,-18513,621
2022-01-07 07:10:30.978874,2022-01-07 02:09:16-05:00,2555,ECuu1L4QGdemZ7FjAjVAAxYN6piinweY7Fuk5csVovfT,Amd8WGcpdtB8yoA83R1BUT5uryuqoKbcBexYacbrbGVX,True,7039714,1759928,10883,5441,5442,DddJ7EWCmYEEZETCBNgAUSg81Ls6fZtiAaY5ekJ5sXx1,435357,2260773,-1825416,618
2022-01-07 07:10:30.978874,2022-01-07 02:09:16-05:00,2556,E9FFPvygPSF22u7gqFq4w6yE5kV15zbeGDXFQc349RsG,yi1REPVUwKhr5ss5YJc56crYz8LVfkqNVMpKcdSfwfY,True,3852673,963168,5943,2971,2972,3zqXX6kzhkbW3d4TwD2CNjMRwxTbREXySekvq37kfCNk,237749,885077,-647328,617
2022-01-07 07:10:30.978874,2022-01-07 02:09:16-05:00,2557,J5ttoY9YjAuVvggkCeps9sX7ivUWoqps5DzxjfgqddxT,mR1fxSNP4bX9GyzRS1UFLpHg31UAXwB8Du7dydCa7VR,True,4486077,1121519,6940,3470,3470,3zqXX6kzhkbW3d4TwD2CNjMRwxTbREXySekvq37kfCNk,277610,1649305,-1371695,618
2022-01-07 07:10:30.978874,2022-01-07 02:09:16-05:00,2558,36ByQojnxEckWdQTjqHfxKqCx9yjqWQsPsZyqaN72UWR,AZoirtS1fjX61agRM64tqThVinnJTh3BWgiHyNHPTgZP,True,1925410,481352,3008,1504,1504,3zqXX6kzhkbW3d4TwD2CNjMRwxTbREXySekvq37kfCNk,120354,948715,-828361,625
2022-01-07 07:10:30.978874,2022-01-07 02:09:17-05:00,2559,BxXXWywnC3dSyLPJHt7owfBhgSiBWzkuD3T8hGYLqCH6,4vuwEBXXbXFMPmbJJJRop4FCWGyKR1sXhBc3EWF6MiB8,True,219455128,54863782,342855,171427,171428,3zqXX6kzhkbW3d4TwD2CNjMRwxTbREXySekvq37kfCNk,13714228,110895908,-97181680,624
2022-01-07 07:10:30.978874,2022-01-07 02:09:17-05:00,2560,FLTW9fwjWqGPm5PiE3C9LFzwZxtDh8c2MnEoRq8W7MfQ,GKsfzKBP2QkmoEWvTaUN1h4nqrT3kAcwYRC9WxW9bB3h,True,28417623,7104405,44308,22154,22154,4BnQKPLuE3DMTtxp8MjUBytgnhvxqq3ZTqZHTVZo4JJh,1772346,8506723,-6734377,623
2022-01-07 07:10:30.978874,2022-01-07 02:09:17-05:00,2561,6d6HN8LWikwW2HYdy3BABWuxKHt1sgv4DcneACR133sE,4eKvzmfFvX96XbujKBhUauAvWP4yQYwZH3pd7gXzbCvJ,True,3848563,962140,5960,2980,2980,DddJ7EWCmYEEZETCBNgAUSg81Ls6fZtiAaY5ekJ5sXx1,238437,889876,-651439,619
2022-01-07 07:10:30.978874,2022-01-07 02:09:17-05:00,2562,9gYrMXAGmGSV4VFjXzYP5WwH2aFpB1TxA6CqpYsosKLv,Dh8aH6RK48wu4fkT9xKw5XL7itxnPDuw3SDwPwvL5sva,True,61076,15269,93,46,47,DddJ7EWCmYEEZETCBNgAUSg81Ls6fZtiAaY5ekJ5sXx1,3754,21961,-18207,614
2022-01-07 07:10:30.978874,2022-01-07 02:09:18-05:00,2563,7jvKp6onXyWgwsFrFWj4hYTXJsYYD6ot5mn6rPFuJriy,J7N6HiozevJVTiY9hDEUs2ud5BwT5QSE7wnMBS1w5ie2,True,101725301,25431324,158191,79095,79096,4BnQKPLuE3DMTtxp8MjUBytgnhvxqq3ZTqZHTVZo4JJh,6327673,47169902,-40842229,622
2022-01-07 07:10:30.978874,2022-01-07 02:09:18-05:00,2564,9LZ3rShLfzErXsGkh4dYfAm58GNPWhK6ohDy5RrLJhc,41tLyuvuJ5M7YctkSASD2R7RGGetD7FmKaZUdkTdgXgt,True,3336130,834032,5197,2598,2599,3zqXX6kzhkbW3d4TwD2CNjMRwxTbREXySekvq37kfCNk,207904,771775,-563871,623
2022-01-07 07:10:30.978874,2022-01-07 02:09:57-05:00,2565,7iUx7JBwqUvPVPeCqMEXQdLccZJmaFYm1DUQiu3ouHa3,3EVZzhRmJnX9ZiBZZo9tenDtMogAyuA1yf2cKzvUWiuu,True,2676036,669008,4170,2085,2085,3zqXX6kzhkbW3d4TwD2CNjMRwxTbREXySekvq37kfCNk,166837,1083270,-916433,623
2022-01-07 07:10:30.978874,2022-01-07 02:10:29-05:00,2566,GH6Q9E1jZPTTp46aDd57UNZPNS2D6PBSwyLL3EHSjGn2,2XvwZXNsrPWx4EfPvhTP933bzCC3SJHDQ8xARfrXdVY9,True,45445735,11361433,71015,35507,35508,3zqXX6kzhkbW3d4TwD2CNjMRwxTbREXySekvq37kfCNk,2840602,35528031,-32687429,625
2022-01-07 07:10:30.978874,2022-01-07 02:10:29-05:00,2567,CCHzYXr5zMXFu8MMZNkfUWGyUcF8xy7Vvhq7tNCtZg2L,AuEXkCJTTJ3HK8iP4qTWpQr4vp6HPRJZyZwfRjF8zjfp,True,337283,84320,522,261,261,3zqXX6kzhkbW3d4TwD2CNjMRwxTbREXySekvq37kfCNk,20917,101292,-80375,620
2022-01-07 07:10:30.978874,2022-01-07 02:10:29-05:00,2568,2bikYf33ZxxDmvkMNjWDGGqEpbYJPvWv5At3hzyeLEQK,5FtirUBjRAZ3k5arFFVwKz42ixWzhkEBLkaK9PraRZ78,True,337282,84320,520,260,260,DddJ7EWCmYEEZETCBNgAUSg81Ls6fZtiAaY5ekJ5sXx1,20832,101209,-80377,617
2022-01-07 07:10:30.978874,2022-01-07 02:10:29-05:00,2569,AGhvB6x3gmvAJSnr9UVtvhKqVg3Qgh1k4roHzrNHhAaa,HhhjXT6WJnz1HQfHcwKdBppuAhc8ncUcq1mkJ4EHqgpe,True,14537,3634,22,11,11,DddJ7EWCmYEEZETCBNgAUSg81Ls6fZtiAaY5ekJ5sXx1,906,5493,-4587,623
2022-01-07 07:10:30.978874,2022-01-07 02:10:29-05:00,2570,FhAt6pZW3k8StP9VLeWUfidpXfRLoKWdV7Wgxdh9cRy9,Guk93pTo3KcG8konHjJ52oi9rgexmmKhPQAkxZS1BtCG,True,567786255,141946562,881711,440855,440856,3zqXX6kzhkbW3d4TwD2CNjMRwxTbREXySekvq37kfCNk,35268457,217305548,-182037091,621
2022-01-07 07:10:30.978874,2022-01-07 02:10:29-05:00,2571,4kbcrzH6o2LvLUCNphyL52i8uGzVD8wcUNEqoQ14z3VG,5Q1atmEBs2AqaDZsiZFG5stHzj1fE6ZvypgfkEc9LYqE,True,410503513,102625878,637634,318817,318817,DddJ7EWCmYEEZETCBNgAUSg81Ls6fZtiAaY5ekJ5sXx1,25505385,204646245,-179140860,621
2022-01-07 07:27:19.076419,2022-01-07 02:10:33-05:00,2572,HhwiZPKZBGa16oVi739s4qtMDMTwzWXc7iwNfX63t2UP,5AnbMbAFKy85yHt5y2M5S38nNkA1vT4ejY5NjGbRNUqn,True,3186182,796545,4921,2460,2461,3zqXX6kzhkbW3d4TwD2CNjMRwxTbREXySekvq37kfCNk,196879,1761713,-1564834,617
2022-01-07 07:27:19.076419,2022-01-07 02:10:35-05:00,2573,921FBgLS3A1wA77uWitsnTvW737Q2jY7tzvgWtWLXNC7,E4eJ9H7cqP9zNpMH5xRBTAp9yaBCBihuJBNd6pqzteDG,True,337279,84319,522,261,261,DddJ7EWCmYEEZETCBNgAUSg81Ls6fZtiAaY5ekJ5sXx1,20911,101291,-80380,619
2022-01-07 07:27:19.076419,2022-01-07 02:10:35-05:00,2574,5Rxuqgs4CaSKbfDXqBMFXkLTQ9dxrUjThXzoy3ouYVtK,BgvbKru66ebrGUcFFymGTmsaQv6GgcGMybiWaXqzBtwX,True,500787,125196,782,391,391,3zqXX6kzhkbW3d4TwD2CNjMRwxTbREXySekvq37kfCNk,31312,265725,-234413,625
2022-01-07 07:27:19.076419,2022-01-07 02:10:35-05:00,2575,DJiXXW7sjNsAAxWupDKBUsFhXSgPoerVYaAtJqqNgVbn,2MsqvNuJw1xQhJ3UnXt9i7oNHDuZpR9w7iE1WQcGqt5m,True,337280,84320,522,261,261,3zqXX6kzhkbW3d4TwD2CNjMRwxTbREXySekvq37kfCNk,20905,101284,-80379,619
2022-01-07 07:27:19.076419,2022-01-07 02:10:48-05:00,2576,3ogBPSRcKfmwzgumVDHBkXLi1eCsEFG2xzSJgD4LQDNy,7TXyqWgJqfe71MSWFA2n7ufZbUdzf7JJoWej8FNNtMXo,True,50729211,12682302,78903,39451,39452,3zqXX6kzhkbW3d4TwD2CNjMRwxTbREXySekvq37kfCNk,3156126,16402375,-13246249,622
2022-01-07 07:27:19.076419,2022-01-07 02:10:59-05:00,2577,4D7mDXe7SdmbAx7kaD1mBNuEa7DzMi6TAwXURxtLEazk,5pSnT91PHoLdN6uhPnUtoD7cboLmndn26y1XouPx8vwW,True,3412915,853228,5335,2667,2668,3zqXX6kzhkbW3d4TwD2CNjMRwxTbREXySekvq37kfCNk,213407,1018402,-804995,625
2022-01-07 07:27:19.076419,2022-01-07 02:11:59-05:00,2578,G25vsB3sDqRhHoSK4KwR1TywfrJDtpejVbbevEG9sQ9a,5xFC3Hm13magnAA9GD1EnwC9PrPoEfQ7omEa9p9zCrB1,True,3930632,982657,6136,3068,3068,3zqXX6kzhkbW3d4TwD2CNjMRwxTbREXySekvq37kfCNk,245479,1384402,-1138923,624
2022-01-07 07:27:19.076419,2022-01-07 02:12:06-05:00,2579,2QStaRnbSnDhA891Lb1bxjVeMYpJUpNdqaVkw3rqU45V,DakRWPnttPoRcjY5V7WLwiwBx39BapCo9Atog8dL17Ku,True,5204471,1301117,8127,4063,4064,3zqXX6kzhkbW3d4TwD2CNjMRwxTbREXySekvq37kfCNk,325096,1448753,-1123657,624
2022-01-07 07:27:19.076419,2022-01-07 02:12:06-05:00,2580,AA9zFZTXqBR8Mw1fwEH59edzBiswoGasRNWsi6aLeysB,4VeitxYqqtRxyfdSVpshdJ3EDcgksRVnaHvAqWxTeujH,True,3909202,977300,6038,3019,3019,4BnQKPLuE3DMTtxp8MjUBytgnhvxqq3ZTqZHTVZo4JJh,241524,907323,-665799,617
2022-01-07 07:27:19.076419,2022-01-07 02:12:06-05:00,2581,ES1MDwRUa3hoToPKQiiZkzMYe9PDVnAQwMrEvZrzvnc1,C4wBG3xTDkmDQneB28xYnf1aBNEeq7UB8oR7NuEfLkFg,True,63281636,15820409,98280,49140,49140,4BnQKPLuE3DMTtxp8MjUBytgnhvxqq3ZTqZHTVZo4JJh,3931235,18865466,-14934231,621
2022-01-07 07:27:19.076419,2022-01-07 02:12:10-05:00,2582,5RvNKzSeJ1fvqsKpcQu25evEZGmKjyEDgwsMZkykoT3P,BRqSGfE4XHXu4HrinwetWumfVTmr82iuF6Y5oSV6eMiK,True,337170,84292,523,261,262,DddJ7EWCmYEEZETCBNgAUSg81Ls6fZtiAaY5ekJ5sXx1,20952,101441,-80489,621
2022-01-07 07:27:19.076419,2022-01-07 02:12:10-05:00,2583,GGGyesjbt7h2XHHp9u8vpiWGugFwEbrtYaKrNQSDhQd7,8tydo1ZjGHmPBSqU33tywB3f9szdsHk1ckGFe4Ay5pgs,True,116020440,29005110,180437,90218,90219,4BnQKPLuE3DMTtxp8MjUBytgnhvxqq3ZTqZHTVZo4JJh,7217480,80327546,-73110066,622
2022-01-07 07:27:19.076419,2022-01-07 02:12:10-05:00,2584,3Lv2XpiD4KBUHq7Zx6u3zNhpXoySodXHH8o8f5yaaPxG,H6TN4rhpBXkEH3mZnymYNcKfmnxRH2uzfwzeLH2q6ahP,True,429238,107309,670,335,335,DddJ7EWCmYEEZETCBNgAUSg81Ls6fZtiAaY5ekJ5sXx1,26809,164374,-137565,624
2022-01-07 07:27:19.076419,2022-01-07 02:12:10-05:00,2585,6u6bPgAmK8ufACrQV99A1Y5nhGkue3KEUHmQQkcNkxwP,7636yXT5w4DcVpc7LJdN46aiggzSq6U2GXHXL5kyy9F3,True,272619412,68154853,425245,212622,212623,3zqXX6kzhkbW3d4TwD2CNjMRwxTbREXySekvq37kfCNk,17009808,119273112,-102263304,623
2022-01-07 07:27:19.076419,2022-01-07 02:12:10-05:00,2586,5jin5wXjQQ25nGM2ECrCXcg1a95vquh6kM7rMRru6Ke7,EKM657EQ8HWWgf4cssByoYHoXGjFfTspTKXAGmygAPQG,True,86441469,21610367,134092,67046,67046,3zqXX6kzhkbW3d4TwD2CNjMRwxTbREXySekvq37kfCNk,5363680,37924109,-32560429,620
2022-01-07 07:27:19.076419,2022-01-07 02:12:12-05:00,2587,6dr65yANjSMmfBeKAuSxG3i16S9vMgF1CQ3zDyzh55Pn,EhrE5QpnshD41S4zPEBy2A5q2Gs2mwUrbHGo6WnT9zDP,True,768946,192236,1196,598,598,4BnQKPLuE3DMTtxp8MjUBytgnhvxqq3ZTqZHTVZo4JJh,47855,346785,-298930,622
2022-01-07 07:27:19.076419,2022-01-07 02:12:38-05:00,2588,6CeKxTJvFqhyNEyzySiBBKEwYVMe7j3A6nkMes4BW6o2,DzDR9XvwY1z7ygQ8YrCXrwDGHSf67JZF8BzUnuFE2fxQ,True,10049987,2512496,15528,7764,7764,3zqXX6kzhkbW3d4TwD2CNjMRwxTbREXySekvq37kfCNk,621141,3224253,-2603112,618
2022-01-07 07:27:19.076419,2022-01-07 02:12:39-05:00,2589,5PbrpM9kjzF4R2eW2UTcRVXnhqWdRQWHZJXKLN43N8WC,6ip4ocbyHusy8CsVvcrpiRCUp2nq9cY8bHpTcUU3Wztq,True,18183851,4545962,28278,14139,14139,3zqXX6kzhkbW3d4TwD2CNjMRwxTbREXySekvq37kfCNk,1131135,6972065,-5840930,622
2022-01-07 07:27:19.076419,2022-01-07 02:12:39-05:00,2590,AM5fwZR9BUW8AFkhdGWXW4PHd2cy8ora63kDf2z2eknw,E7ru6hg4MchnRG5zcr5YazwX8Snt55r5Xq9zCHCGaYZT,True,2194380,548595,3425,1712,1713,3zqXX6kzhkbW3d4TwD2CNjMRwxTbREXySekvq37kfCNk,137018,942335,-805317,624
2022-01-07 07:27:19.076419,2022-01-07 02:12:39-05:00,2591,8VnGmfop6qcUezAJ2M15jz2Nn6mPQgehDcJPvypq4XJn,6F6sqXNhgkW9ev8QNMm4ydywUUmemhwgydRQYNeqyUmi,True,24316100,6079025,37779,18889,18890,3zqXX6kzhkbW3d4TwD2CNjMRwxTbREXySekvq37kfCNk,1511184,19382637,-17871453,621
2022-01-07 07:27:19.076419,2022-01-07 02:12:39-05:00,2592,8MKNsuGVaoYpdQy6NNyxDvRzh2DAquBUtri4nDsixUxs,D7M1SDmpZAs8vdPCCCa96UbDF15YQDxHmoGWB57tHiir,True,9505362,2376340,14754,7377,7377,3zqXX6kzhkbW3d4TwD2CNjMRwxTbREXySekvq37kfCNk,590183,4427849,-3837666,620
2022-01-07 07:27:19.076419,2022-01-07 02:12:39-05:00,2593,FpqCxvTkSiwDwD5qEt6hXJxzFDLFLAQ8VevK8zwRqYun,A3p6YQisCJKpNkF7vkjZRbEfbnUt7vTZdR2zPBUSdTkk,True,942523392,235630848,1466484,733242,733242,3zqXX6kzhkbW3d4TwD2CNjMRwxTbREXySekvq37kfCNk,58659361,302788316,-244128955,622
2022-01-07 07:27:19.076419,2022-01-07 02:12:40-05:00,2594,3njiRuSRMXRzKmamyiR72Hc38PU8UDDmWdfPhgxmGxEW,5WoF3gkgygyNNbwxWgVfqGWkExcDixuzgJQQjXEZQ6J5,True,585751584,146437896,908362,454181,454181,DddJ7EWCmYEEZETCBNgAUSg81Ls6fZtiAaY5ekJ5sXx1,36334519,369193500,-332858981,620
2022-01-07 07:27:19.076419,2022-01-07 02:12:40-05:00,2595,DAku12iueL13vRoTpKLyqdGaLQ2rWF6REe8Dr8soFvNs,H2vVH3LxkhGe6x6Mdwy67BYwTKNQM6XayKx7mhrwyfJM,True,1024068,256017,1594,797,797,DddJ7EWCmYEEZETCBNgAUSg81Ls6fZtiAaY5ekJ5sXx1,63778,463541,-399763,622
2022-01-07 07:27:19.076419,2022-01-07 02:12:40-05:00,2596,4mB2DVbQVqVk535v98Cj8SPNg1tTc3DFyY2Q7VBbY645,HXo255k3RgsTGsc4hiP6ZTXUspBTqJ37duQa5eK7tqp3,True,906996398,226749099,1416552,708276,708276,3zqXX6kzhkbW3d4TwD2CNjMRwxTbREXySekvq37kfCNk,56662113,307794637,-251132524,624
2022-01-07 07:27:19.076419,2022-01-07 02:12:56-05:00,2597,Ftuj53jKP3Z8mvuTE1CEypdw2eZrCn5x8ktMWRdJo2gU,9JNUFRLrPNAh3DgKvMdaNvLCAeUtiS9FGWmDcMvcSe7J,True,247066678,61766669,384606,192303,192303,3zqXX6kzhkbW3d4TwD2CNjMRwxTbREXySekvq37kfCNk,15384265,77502587,-62118322,622
2022-01-07 07:27:19.076419,2022-01-07 02:12:56-05:00,2598,C2Dmfw4G8KKzFq38aRH2pLCRngnGZDvUUN3fHDMjFkoG,7kzJk3BTNvY3hGFNj7nDy9L5CAYus6eNiCAxWH8dSioX,True,851437,212859,1313,656,657,3zqXX6kzhkbW3d4TwD2CNjMRwxTbREXySekvq37kfCNk,52549,469179,-416630,617
2022-01-07 07:27:19.076419,2022-01-07 02:12:58-05:00,2599,6eBSLXDMVoW2nG3n7s42RXDH8byY3C6n1RsUuegBLSrG,37dYrKnTXYer7Bu9xFfpArA4ZNo2B9bycFw9HywDtTRx,True,22752343,5688085,35239,17619,17620,3zqXX6kzhkbW3d4TwD2CNjMRwxTbREXySekvq37kfCNk,1409560,9635257,-8225697,619
2022-01-07 07:27:19.076419,2022-01-07 02:12:59-05:00,2600,2FrqGFZjbiNykJyo9BZ5S9FguQJPJiTi681rJJsQ5dta,3QUncYP92NKrfpaTvuF9iQg11PXKgZAgEngwh6BbnCCj,True,1895060,473765,2956,1478,1478,DddJ7EWCmYEEZETCBNgAUSg81Ls6fZtiAaY5ekJ5sXx1,118270,694604,-576334,624
2022-01-07 07:27:19.076419,2022-01-07 02:13:01-05:00,2601,8NdcaYUC1X5CP7FMDip78uqtqmCt8GcZdCzLRTYTihmb,9Ei1K9bXWXSXcBfeX5exPSXGCAu62WSKzvnnd4wHvyVh,True,301441,75360,470,235,235,3zqXX6kzhkbW3d4TwD2CNjMRwxTbREXySekvq37kfCNk,18801,117741,-98940,623
2022-01-07 07:27:19.076419,2022-01-07 02:13:17-05:00,2602,aTkGURJptmKNNP6RSXSWsmVbfcriSAJaMuUiT2eZEfb,5qoGxL83PLhrguyk27X8xE6jGitRg5BaQpXzrcfEvCfJ,True,662018353,165504588,1032024,516012,516012,3zqXX6kzhkbW3d4TwD2CNjMRwxTbREXySekvq37kfCNk,41280970,185186837,-143905867,623
2022-01-07 07:27:19.076419,2022-01-07 02:13:18-05:00,2603,243SAnGxchCVB1LQAUF4SsozR86yDwEdg2QQpbWGsMYe,5u8sNkb2oEQjUXJAB3yGStmv3Uwz16gBgExBo5myVK4b,True,34236130,8559032,53462,26731,26731,3zqXX6kzhkbW3d4TwD2CNjMRwxTbREXySekvq37kfCNk,2138513,10101704,-7963191,624
2022-01-07 07:27:19.076419,2022-01-07 02:14:15-05:00,2604,8RmB8o4zux2sD48dEsKpsX475KRxTwdk8QULUDU9xx8R,AKSiZnb4YKVB6B86aPPqvyXquhvN9xqt45bexBCZ7nx,True,145309424,36327356,227382,113691,113691,HfEnetJ7uBSmZWCjBNxdvv9HEC5nsW4wDV7wu6WnhWan,9095316,74655030,-65559714,625
2022-01-07 07:27:19.076419,2022-01-07 02:14:15-05:00,2605,Fd2HrzBAr4JobRPARZwpQHHVoSCEoog32A6tKMWAC1sK,BYappsar5sQf8VLem4wrLuTtrDFH9y8pEx1aMxfuU4Pq,True,69064363,17266090,107794,53897,53897,4BnQKPLuE3DMTtxp8MjUBytgnhvxqq3ZTqZHTVZo4JJh,4311767,30327840,-26016073,624
2022-01-07 07:27:19.076419,2022-01-07 02:14:15-05:00,2606,EmGW2aAG69ssWqCtbfDocRaM2u3TJsczn2HHP9jdmRvD,aypkDKsp9uqAB4F6mwvm5LofpsrFBuZT2MMWtE2eHdB,True,1480981,370245,2317,1158,1159,4BnQKPLuE3DMTtxp8MjUBytgnhvxqq3ZTqZHTVZo4JJh,92688,613769,-521081,625
2022-01-07 07:27:19.076419,2022-01-07 02:14:16-05:00,2607,ANQkPUoMjLHyRtypeKzxsKW1DFauQsh9SnB3rRgRXM1Y,7RHAExWpG8Q3PXwKhJs2yXmYK9WogGydvFYpx28p6pgr,True,166529974,41632493,260562,130281,130281,4BnQKPLuE3DMTtxp8MjUBytgnhvxqq3ZTqZHTVZo4JJh,10422514,86769101,-76346587,625
2022-01-07 07:27:19.076419,2022-01-07 02:14:16-05:00,2608,F2v1YwVAwXLiUgsJ5uwn4qAAkTXitn1E75fJcPnGuAcy,5rdJ4H5GxPg4Juu77mGc7uya5LwEqLzDSRyG8mQ2mDbK,True,44228917,11057229,68900,34450,34450,3zqXX6kzhkbW3d4TwD2CNjMRwxTbREXySekvq37kfCNk,2756016,19427492,-16671476,623
2022-01-07 07:27:19.076419,2022-01-07 02:14:16-05:00,2609,AHm7zF4rpaxaayBLn5QDHgJSp8KAr647s4cNvQ9wLgd7,FDM33WngED24pukBvSDpPAzinW6afVAeGReum5nyLRiC,True,1899466,474866,2958,1479,1479,4BnQKPLuE3DMTtxp8MjUBytgnhvxqq3ZTqZHTVZo4JJh,118335,865361,-747026,622
2022-01-07 07:27:19.076419,2022-01-07 02:14:16-05:00,2610,6yw4GPvkqUbakcEWtqSCfjVLukty11xqjDpGxtEN9Km2,5ppEx7wkpqbG5nApCWMdRja3oRSheFmAAsNHUX7h2w2Y,True,3787970,946992,5923,2961,2962,4BnQKPLuE3DMTtxp8MjUBytgnhvxqq3ZTqZHTVZo4JJh,236928,3084952,-2848024,625
2022-01-07 07:27:19.076419,2022-01-07 02:14:16-05:00,2611,6tFQaTqqffino9kwMZTL2xVNBG8k9VREFhXqVi2si3A3,3w3wGxBbS4bmXeqmvd595SAWFeXekVpnH4UdbeEs8Sx5,True,10053253,2513313,15716,7858,7858,DddJ7EWCmYEEZETCBNgAUSg81Ls6fZtiAaY5ekJ5sXx1,628648,3228494,-2599846,625
2022-01-07 07:27:19.076419,2022-01-07 02:15:26-05:00,2612,2VyFcgZDH1HTEvD1XaWhwqBCMmZ1k6TmZ3fEpPcBZR9E,G1wFJETTpdoc7CfypGCzkq1jssXPfUkiuLjK2cwVZ9dJ,True,184630,46157,288,144,144,4BnQKPLuE3DMTtxp8MjUBytgnhvxqq3ZTqZHTVZo4JJh,11538,84021,-72483,624
2022-01-07 15:56:29.087703,2022-01-07 10:51:41-05:00,2613,5BJnMHFSiQjHRGFJDW1jnqCfkHHYWnQzmmccy9eA4jNj,9517JGYsPmvgPUM9pFRD2vipHmdgE578F7jA7Qq6jorm,True,1258412881,314603220,1917861,958930,958931,3zqXX6kzhkbW3d4TwD2CNjMRwxTbREXySekvq37kfCNk,76714444,447432532,-370718088,609
2022-01-07 15:56:29.087703,2022-01-07 10:51:41-05:00,2614,8xvLGVeDmhVYQhN2ZpWkVG9jCrukRsNQ4926a4TMiZqa,9ciBySSjvADwp47WkETiFWZKVTFL8Hf1XvK7aSxhcgQS,True,59937279,14984319,91940,45970,45970,3zqXX6kzhkbW3d4TwD2CNjMRwxTbREXySekvq37kfCNk,3677635,21417896,-17740261,613
2022-01-07 15:56:29.087703,2022-01-07 10:51:43-05:00,2615,BgnsCfJ54ReunUtwPJLzkW4PWnqpBDWGNYxsW5PvDrbK,KpMqEkQ9dKMgCevsEK895wHd3fCLRPSzDmJSv3tKU4u,True,34627654487,8656913621,53315664,26657832,26657832,GAUsoe8ZTCiGPm2hYxRPGxcPe5ShNzHK9eE3G2zgRjxd,2132626569,11084221735,-8951595166,615
2022-01-07 15:56:29.087703,2022-01-07 10:51:43-05:00,2616,A1j2G5FZRyWSjFt6dK87WHhLkQrPUVqHaM3KhSzhAKDT,2fMiHLYm4pL3YCd8aveTR4mT9uVxztQeMwb5eRZb4wUW,True,1677994,419498,2468,1234,1234,DddJ7EWCmYEEZETCBNgAUSg81Ls6fZtiAaY5ekJ5sXx1,98729,670509,-571780,588
2022-01-07 15:56:29.087703,2022-01-07 10:51:46-05:00,2617,DYCYiQFH9QHzCo3eAw1pFoDu7pzwFMo1E2WDZjVFRz5w,CPh4FWsGak1kd1WFEH9qBjNhnun3R2tHtZA57zW8ugn5,True,119370845,29842711,185876,92938,92938,GAUsoe8ZTCiGPm2hYxRPGxcPe5ShNzHK9eE3G2zgRjxd,7435047,55536800,-48101753,622
2022-01-07 15:56:29.087703,2022-01-07 10:51:58-05:00,2618,5eMLdQ4gYA5iqvTXSNdGvctHp7s5VpyFuwtJKqx6chBc,Ckxc5K39nkBNXBTmFTM8J48R7wGqNm3vHKZu4G5baumZ,True,785529799,196382449,1221999,610999,611000,GAUsoe8ZTCiGPm2hYxRPGxcPe5ShNzHK9eE3G2zgRjxd,48879977,228954214,-180074237,622
2022-01-07 15:56:29.087703,2022-01-07 10:51:58-05:00,2619,JDeYjCLpfnzcfxDFgHf4aBcHsajwdR14GUaKAA9euzVf,EJbvKoyMZcoCx4vWa61uMbW2vr6mUhrgEuECdteVBuZZ,True,18665021,4666255,28789,14394,14395,GAUsoe8ZTCiGPm2hYxRPGxcPe5ShNzHK9eE3G2zgRjxd,1151598,9796352,-8644754,616
2022-01-07 15:56:29.087703,2022-01-07 10:52:33-05:00,2620,D58t4uTjFumsUeYFaKnpV8BRTEQEqKXBreFTdwGrott7,67p6kHDfVqQijfcwugvZK59c3aRRH9x3eHxruqH8WEqF,True,2359646,589911,3688,1844,1844,GAUsoe8ZTCiGPm2hYxRPGxcPe5ShNzHK9eE3G2zgRjxd,147526,932238,-784712,625
2022-01-07 15:56:29.087703,2022-01-07 10:53:03-05:00,2621,Bsr6kx1B6BSEd5UnJ7Z61M49iUb3bFrDVhiEtMVtPDF2,3CFd1pUJAJPA9fobwn4Jj2mRju1CWmoop4Mh4znypNWT,True,70058580,17514645,108477,54238,54239,GAUsoe8ZTCiGPm2hYxRPGxcPe5ShNzHK9eE3G2zgRjxd,4339085,22505367,-18166282,619
2022-01-07 15:56:29.087703,2022-01-07 10:54:41-05:00,2622,E8ifvhmyJGBGVQomo3AnZw2UcaLHcpGsTtuoCid8voU3,FMQUWTbTAfSLfrc6GTrz4DM2ZSgoxF3KtqGn8AyjVtsf,True,16326807,4081701,25377,12688,12689,DddJ7EWCmYEEZETCBNgAUSg81Ls6fZtiAaY5ekJ5sXx1,1015116,5138876,-4123760,621
2022-01-07 15:56:29.087703,2022-01-07 10:54:41-05:00,2623,Dn916KSmX3HqxT53hrxrbCrV3tdRMCPdaoiRLqetMrth,ATCXRiXgnjRRUbSTPBvtBXMENCqsViexSZbZ6aDaXXWA,True,2994256,748563,4667,2333,2334,3zqXX6kzhkbW3d4TwD2CNjMRwxTbREXySekvq37kfCNk,186711,1194632,-1007921,623
2022-01-07 15:56:29.087703,2022-01-07 10:54:41-05:00,2624,9UyQC8vc6zJJaSdnjvTAzgmcsw4fC3xFBBiCC1w9Sbjx,3ppBfboe6FPmt7f6WrivspMUoAznZKWQMeh3rCgw7vjQ,True,20560699,5140174,32109,16054,16055,DddJ7EWCmYEEZETCBNgAUSg81Ls6fZtiAaY5ekJ5sXx1,1284379,6033667,-4749288,624
2022-01-07 15:56:29.087703,2022-01-07 10:54:45-05:00,2625,9zpPiboHF5HW7NfCx7hYdmJGwUomVMTiUFc4Um5KrDi3,8q3eBpuwV6dMNkib9N8XQAq2tBUcjSANRe5SXpd4dFhZ,True,18835021,4708755,29295,14647,14648,DddJ7EWCmYEEZETCBNgAUSg81Ls6fZtiAaY5ekJ5sXx1,1171839,5535748,-4363909,622
2022-01-07 16:50:30.519190,2022-01-07 11:12:40-05:00,2626,2F45BX9mRmtNCHPejKFknN5aNgGvR4vVLFjMaY1a7dR8,ALdSutsvEFRUEQGGBbi31QywTL1pdXSDWrNJzvNTaoXL,True,57502719,14375679,89332,44666,44666,DddJ7EWCmYEEZETCBNgAUSg81Ls6fZtiAaY5ekJ5sXx1,3573307,24186190,-20612883,621
2022-01-07 16:50:30.519190,2022-01-07 11:12:49-05:00,2627,67Z7ZGhNu5xxEh9BYKWcXp9m1T4tFiE1o1M16hCzUWQA,CT7YKWixz7BhTbvg5F6M5HCyPGnHoFLNFuDV9GhoLTo3,True,7491748,1872937,11718,5859,5859,4BnQKPLuE3DMTtxp8MjUBytgnhvxqq3ZTqZHTVZo4JJh,468727,3904340,-3435613,625
2022-01-07 16:50:30.519190,2022-01-07 11:12:49-05:00,2628,J4krKPBBTMVLZRgrSeYJAMyHQs2FkNm5TXk7nQWwDB43,ASmLbfNbhTD2HHeV7qzAqiHjUx5a8Traj8oPDwbkMdFg,True,65202235,16300558,101690,50845,50845,3zqXX6kzhkbW3d4TwD2CNjMRwxTbREXySekvq37kfCNk,4067623,21350388,-17282765,623
2022-01-07 16:50:30.519190,2022-01-07 11:12:51-05:00,2629,CvZssqscu2dm35mwcE3zg9zedavbRjVJjWD59Py5ExUK,7pXaoR6aHKYofCmg1eHipygNYDteEaf8rbbS8BDYGQK6,True,1613684,403421,2521,1260,1261,DddJ7EWCmYEEZETCBNgAUSg81Ls6fZtiAaY5ekJ5sXx1,100853,516555,-415702,624
2022-01-07 16:50:30.519190,2022-01-07 11:16:39-05:00,2630,Gs3WP18hbzNpbBgiU39e6tfkggfCKRyNqPqJQcthuHFD,4XAY25YUma6gUdG2GdbXeivum3t21g93ZagfWGTZYkWZ,True,23070398,5767599,36094,18047,18047,DddJ7EWCmYEEZETCBNgAUSg81Ls6fZtiAaY5ekJ5sXx1,1443768,10386114,-8942346,625
2022-01-07 16:50:30.519190,2022-01-07 11:18:49-05:00,2631,8xQ3tsWVUe75EG1HmocULJ3kh52utveoFMEPotTGrKno,i3SKW3ywrwYucX9ySEx1C4zaUKGnzLerP3V38437NyV,True,141533772,35383442,220547,110273,110274,4BnQKPLuE3DMTtxp8MjUBytgnhvxqq3ZTqZHTVZo4JJh,8821887,58219481,-49397594,623
2022-01-07 16:50:30.519190,2022-01-07 11:18:49-05:00,2632,J2gTwrYpzezkRupgBtgudQn5D33x6WjeBhTHnrA1qgqa,FBzoHRwqGRjnMvPEpiZVjtGZYJmAbneE4dpToXPzy8bv,True,79534553463,19883638365,124285377,62142688,62142689,DddJ7EWCmYEEZETCBNgAUSg81Ls6fZtiAaY5ekJ5sXx1,4971415111,26163484666,-21192069555,625
2022-01-07 16:50:30.519190,2022-01-07 11:18:55-05:00,2633,A2ZUT3A9EjtCkzcZveEvWF3pPwNVqdXkHK3fsNRAg8VX,4137TfTDDzK71KN2ZzJaoRPJDQDKQewSPdmZfKrxdVPD,True,146337832,36584458,226573,113286,113287,DddJ7EWCmYEEZETCBNgAUSg81Ls6fZtiAaY5ekJ5sXx1,9062944,44235773,-35172829,619
2022-01-07 16:50:30.519190,2022-01-07 11:18:55-05:00,2634,9vcKW1GfrDZ3KLPh2pEVFF8ZyKqD1pJW1hiE8H98Av7S,C6Ki27mo4sCHu6u8UnR1p7WSgsTjFQxGGR9Lk9n5Rhjq,True,6397950,1599487,9961,4980,4981,4BnQKPLuE3DMTtxp8MjUBytgnhvxqq3ZTqZHTVZo4JJh,398479,2765501,-2367022,622
2022-01-07 16:50:30.519190,2022-01-07 11:18:55-05:00,2635,6oroGB3mvzK3tDfiB9X2NJuL3x476pxhgRnt7VxqhdLo,2SoK8tKkLn2ppKURpTVazKsCEis4uahkHMsac1m85J4r,True,4125764,1031441,6453,3226,3227,4BnQKPLuE3DMTtxp8MjUBytgnhvxqq3ZTqZHTVZo4JJh,258154,3250817,-2992663,625
2022-01-07 16:50:30.519190,2022-01-07 11:18:55-05:00,2636,CRaKcudjkQiSw5YPVjTLVdXvJskeGiHSYtq5ZcMPJhgQ,AgqTg3b3bAcaBmRidhNC4Uf9ZwNbeH52RQEqumWyuUs7,True,1993944,498486,3084,1542,1542,DddJ7EWCmYEEZETCBNgAUSg81Ls6fZtiAaY5ekJ5sXx1,123369,1098808,-975439,618
2022-01-07 16:50:30.519190,2022-01-07 11:18:55-05:00,2637,DdYgcyV1T2CDYiQVr4VL9Ym8RdKm93a7SKy8HxuyaoMW,GPdAeqeXb1UJ56AttcwwY1CyFhRyfptDC4BAX2Tc8MpE,True,1210468,302617,1869,934,935,DddJ7EWCmYEEZETCBNgAUSg81Ls6fZtiAaY5ekJ5sXx1,74773,551637,-476864,617
2022-01-07 16:50:30.519190,2022-01-07 11:18:55-05:00,2638,Ckqos6cdncPKj13DnCmDVZsZTqp6eS7277CRrT9WhcEr,AtUV8m7VQJvZq7GLCAHMf3jV7iamKEPnWVZHWuuVZQp1,True,2858736,714684,4444,2222,2222,3zqXX6kzhkbW3d4TwD2CNjMRwxTbREXySekvq37kfCNk,177767,1575497,-1397730,621
2022-01-07 16:50:30.519190,2022-01-07 11:18:55-05:00,2639,DGAQzgZhS2yioeZmG3cbacM3hdz4F1aZn1PWRwgiFukc,48KUtJaNCPNxkLXJBtWAdDxY4b9vZzLgbGxTNdwMqmjz,True,1203217067,300804266,1851326,925663,925663,3zqXX6kzhkbW3d4TwD2CNjMRwxTbREXySekvq37kfCNk,74053041,495217627,-421164586,615
2022-01-07 16:50:30.519190,2022-01-07 11:18:55-05:00,2640,6nJyqvFKprwaVCE1gAa2P4RHKc6Pa6XFSJymx654zZ9K,4e7iJmdwzAPxp1Zi8Azo38YyPQdPKqqY4VLJyQ5rpdYP,True,5735839,1433959,8826,4413,4413,4BnQKPLuE3DMTtxp8MjUBytgnhvxqq3ZTqZHTVZo4JJh,353042,2636842,-2283800,615
2022-01-07 16:50:30.519190,2022-01-07 11:18:59-05:00,2641,pgzvXpnUYiY7hLrfjmwScqLd8oj9vYcXpFvpm4y4JvG,GdqdQgoyBAFuXdbvoZyDhB3jyqJzVo4nkGh7EPFxkBF2,True,4851545,1212886,7409,3704,3705,3zqXX6kzhkbW3d4TwD2CNjMRwxTbREXySekvq37kfCNk,296360,3978557,-3682197,610
2022-01-07 16:50:30.519190,2022-01-07 11:19:00-05:00,2642,M69XSefqeum2arinvHEqmA3L2XHWNFN17p4msRhRZXf,2vK15yYUANLSbAoiBfgJ9VLyqsmtEpd2iNytQjms8GaQ,True,623873753,155968438,971112,485556,485556,GAUsoe8ZTCiGPm2hYxRPGxcPe5ShNzHK9eE3G2zgRjxd,38844506,361387376,-322542870,622
2022-01-07 16:50:30.519190,2022-01-07 11:19:00-05:00,2643,o2aCmkxsxSiyUX8soTEjwUCbJeXmCZsEaf8CWwxDT5n,3pvS2bTsUuiQyqZp5rdnTpq4cqWGgtv4E5rN9HsBxpRt,True,55006,13751,84,42,42,GAUsoe8ZTCiGPm2hYxRPGxcPe5ShNzHK9eE3G2zgRjxd,3387,13488,-10101,615
2022-01-07 16:50:30.519190,2022-01-07 11:19:00-05:00,2644,HVZkXeDR3mc8oB9qFFwCK4RXpPojdcHk9tRGep6xtKGK,Bh3py7awPejWqeTMxtAgF7mPotL2Asxf8YrYJykq9nBt,True,15183664,3795916,23720,11860,11860,3zqXX6kzhkbW3d4TwD2CNjMRwxTbREXySekvq37kfCNk,948805,5789231,-4840426,624
2022-01-07 16:50:30.519190,2022-01-07 11:19:00-05:00,2645,CBL2NbekJrXvBiAcoj4fzQ4PfLDwTntW7Zt4nruHFYEw,59EvfgYTdKkfjUJz5LddLUAqbEdLaihcMzjcrTZsyzyS,True,21542,5385,33,16,17,3zqXX6kzhkbW3d4TwD2CNjMRwxTbREXySekvq37kfCNk,1343,8038,-6695,623
2022-01-07 16:50:30.519190,2022-01-07 11:19:11-05:00,2646,2jPxG5FL6D6XEJsRszJ9cmQ54AWSpZyPFSbn3DpWBSuM,3toQou4UVNvyWYvMvkuv379RVEF2aN2TzCpKKBUqeQV6,True,444644936,111161234,695860,347930,347930,4BnQKPLuE3DMTtxp8MjUBytgnhvxqq3ZTqZHTVZo4JJh,27834430,166375452,-138541022,625
2022-01-07 16:50:30.519190,2022-01-07 11:19:25-05:00,2647,6NJFN855M3Q3RLTDNo57gTgAmwPD6G2E3WvMb1m5eNCN,3YpqNnonsvXaRT4nCC3G5FZx1jjVtbDPc36LiR6WK5jR,True,181976875,45494218,283441,141720,141721,3zqXX6kzhkbW3d4TwD2CNjMRwxTbREXySekvq37kfCNk,11337652,93770079,-82432427,623
2022-01-07 16:50:30.519190,2022-01-07 11:19:26-05:00,2648,zLTuMVfVswjMkhyvjaXnvjcKXv5xNk3iSWSjRGpVqXf,J3D8NHUJCiSjvFYfJ5Es4YDhF1KcPZWRUmCQ5L92t8eB,True,280250473,70062618,438220,219110,219110,DddJ7EWCmYEEZETCBNgAUSg81Ls6fZtiAaY5ekJ5sXx1,17528836,100704370,-83175534,625
2022-01-07 16:50:30.519190,2022-01-07 11:19:47-05:00,2649,CagSUfZLwXuCdypC4KzU6FSNdmCj9dKDroPcNeaRtsyt,yxw5d1ztZuEUY2QjL7eLpr72QJAj5rJd6ERvg91cy1m,True,3724094,931023,5813,2906,2907,3zqXX6kzhkbW3d4TwD2CNjMRwxTbREXySekvq37kfCNk,232552,1252159,-1019607,624
2022-01-07 16:50:30.519190,2022-01-07 11:19:47-05:00,2650,5rW9kqXB9feGSKSvSMNJF1FCsBYV3vGmTmc8MvzaZ3pi,7AjnjcfPJevW5521hXw4VtgRCfHSsAqyzyArukKfNcHo,True,25319608,6329902,39584,19792,19792,DddJ7EWCmYEEZETCBNgAUSg81Ls6fZtiAaY5ekJ5sXx1,1583373,11697712,-10114339,625
2022-01-07 16:50:30.519190,2022-01-07 11:19:48-05:00,2651,8swGZMrPrLAxZd7MxTbkCL13k3DmAJUw41jCp6Xo6awW,3fKnX7yTNXAT4uMmXVdTy47ALJT8h8YSD3WiBb4BGuzH,True,554798965,138699741,863986,431993,431993,DddJ7EWCmYEEZETCBNgAUSg81Ls6fZtiAaY5ekJ5sXx1,34559474,214591618,-180032144,622
2022-01-07 16:50:30.519190,2022-01-07 11:19:50-05:00,2652,D64rDiWT3YG28fCgXCmbNjYa2JakZbpKQ1D2XuLChUfV,8WmMWq8cTsGQym5pUbHm9dPCpJugBeWUMVERYFGLxWHj,True,85294584,21323646,131139,65569,65570,DddJ7EWCmYEEZETCBNgAUSg81Ls6fZtiAaY5ekJ5sXx1,5245589,25409427,-20163838,614
2022-01-07 16:50:30.519190,2022-01-07 11:19:50-05:00,2653,3qnPsgqW11AcDEmyjmJquPcPLyE3EdJQuVLJ5kinDrd3,86rZadBB7emKio76aFTahpbrFtxd9tqZ4Mxgzaavq2xU,True,363727,90931,569,284,285,DddJ7EWCmYEEZETCBNgAUSg81Ls6fZtiAaY5ekJ5sXx1,22761,139580,-116819,625
2022-01-07 16:50:30.519190,2022-01-07 11:21:00-05:00,2654,BrHRMouGRz3LBNzd9anfdYMhWfg8yUPHL4PqJ8WdEDFS,4uzoLa3mC2VYHAPBoHLX4gTjPTC28rPf2fvEGtJWPYc,True,140097043,35024260,219227,109613,109614,GAUsoe8ZTCiGPm2hYxRPGxcPe5ShNzHK9eE3G2zgRjxd,8769118,104392453,-95623335,625
2022-01-07 16:50:30.519190,2022-01-07 11:21:53-05:00,2655,3C2MZQKh9x4zNTCMbhhvoafGaFMwUooqfy9MCgPyXs6E,AHjgWKpYPWe6ketjDHDKFBFsKQiRJ41jnkuo39MVYxZo,True,487230716,121807679,761865,380932,380933,3zqXX6kzhkbW3d4TwD2CNjMRwxTbREXySekvq37kfCNk,30474602,253365642,-222891040,625
2022-01-07 16:50:30.519190,2022-01-07 11:21:55-05:00,2656,HGJoZvLakWfSDFwuvShNBc4kCf7nP7VqzyM3mELpbFEf,12Qn5jin7QvsBngXqYAv4UstyG3b6nRf1jsLp9Dp8G7k,True,37325404,9331351,58297,29148,29149,GAUsoe8ZTCiGPm2hYxRPGxcPe5ShNzHK9eE3G2zgRjxd,2331894,15058513,-12726619,624
2022-01-07 16:50:30.519190,2022-01-07 11:21:55-05:00,2657,7PzGZgzieFyyFs1dbajkNQgVxooFUNZrj1bUsQvrSwbp,A2gDREmSmJTBPPw3sbKVY3smC9wbHMDdv87gr4Tr2ES7,True,6544569,1636142,10210,5105,5105,72FwbpFGoLEazJEdpqNtPNefsadUrimUqma9wSoy4qiS,408421,2514506,-2106085,624
2022-01-07 16:50:30.519190,2022-01-07 11:21:56-05:00,2658,GqAS41YJssg9aaEp3hs3sG98APCsXhiQBQszXaSjZ2bN,2wodJ3AhrXdE1T4oVL95KvoBND7PubG5Wd5GWiLCMZJU,True,437137639,109284409,682221,341110,341111,4BnQKPLuE3DMTtxp8MjUBytgnhvxqq3ZTqZHTVZo4JJh,27288840,328093806,-300804966,624
2022-01-07 16:50:30.519190,2022-01-07 11:22:04-05:00,2659,8Xt3qHjZG3zLxozgM5vPHMVxp8eYFMg89kaVW7vdHKoA,2i8riSsQpfADD9LUVpiBJBfX5qjVAgmZegzfKx6RG9dW,True,98030539,24507634,153312,76656,76656,GAUsoe8ZTCiGPm2hYxRPGxcPe5ShNzHK9eE3G2zgRjxd,6132487,28874213,-22741726,625
2022-01-07 16:50:30.519190,2022-01-07 11:22:04-05:00,2660,2FEbsetZMkRqLjSC8GBbgecKgX5T1T1fci2sLQux29p8,H722Fcd6DkTFRZxqQWbPDufBfXEgmFfhiEpQZWhxwYv1,True,11118901,2779725,17398,8699,8699,GAUsoe8ZTCiGPm2hYxRPGxcPe5ShNzHK9eE3G2zgRjxd,695941,3812970,-3117029,625
2022-01-07 16:50:30.519190,2022-01-07 11:22:04-05:00,2661,DDsY5V3F9wnEGBoQFCEf1hvEYuKUaJdysbc7TxhNqe9G,5oBCGzvy8odB8MCxCUvPDqYCnTyteZ4Yy1JDroroygbi,True,128934147,32233536,201630,100815,100815,3zqXX6kzhkbW3d4TwD2CNjMRwxTbREXySekvq37kfCNk,8065217,29018943,-20953726,625
2022-01-07 16:50:30.519190,2022-01-07 11:22:05-05:00,2662,7oxuCEhooUZ5z2nnZRD226rcqdZgAR75SamX9DD7ejUf,CPqBb5ptWUPUJhVjshxNZCHd5RDF3fve29z4vz72JhvM,True,423301,105823,660,330,330,4BnQKPLuE3DMTtxp8MjUBytgnhvxqq3ZTqZHTVZo4JJh,26438,127475,-101037,624
2022-01-07 16:50:30.519190,2022-01-07 11:22:46-05:00,2663,U3vvMQ4X4aKzVYfhMw1V1p58HRqaLnuXozqmmefYeD9,7JA94MArkNCFRhBq8f5a32DgMF6aPdFsoC5HvXDQ6NuR,True,722765495,180691373,1130911,565455,565456,DddJ7EWCmYEEZETCBNgAUSg81Ls6fZtiAaY5ekJ5sXx1,45236454,339905736,-294669282,625
2022-01-07 16:50:30.519190,2022-01-07 11:35:21-05:00,2664,cQqH5PtXgtCk1Vs96PgxDxzUZf2Cfx5F63j1Nkz19cs,2VVizb2qVtj8ZEpLSmJXz9hXnAiGD7GdhBxT32PbFjAY,True,55028,13756,80,40,40,3zqXX6kzhkbW3d4TwD2CNjMRwxTbREXySekvq37kfCNk,3225,17813,-14588,586
2022-01-07 23:24:46.628780,2022-01-07 18:09:15-05:00,2665,BAzH5niE2GX9CHGn3jK6Wv8Dd59PT95dX4dgfZXWoLPT,YNRnuEoNBPFsr7W91gc85TXAdA4ZnXfF2x951zbeRKF,False,69532,69532,3416,170,3246,DddJ7EWCmYEEZETCBNgAUSg81Ls6fZtiAaY5ekJ5sXx1,3416,29007,-25591,491
2022-01-07 23:24:46.628780,2022-01-07 18:13:03-05:00,2666,HAk9c831TRUhvpoK4d7PTqfJuJhSjnJUXWpnYsH85bDJ,DVSa3CJrVLTHAeFYjEF89ZjWRm86QwruUk2Y8RvGpjsr,False,74374,74374,3398,169,3229,GAUsoe8ZTCiGPm2hYxRPGxcPe5ShNzHK9eE3G2zgRjxd,3398,30630,-27232,456
2022-01-08 15:15:53.739436,2022-01-08 10:05:08-05:00,2667,EanSXRkJu91FKUhPCzYxWkmM3PQUWcovEnoZXcd6vQ9E,Fg4EzAzHStoLRDPmoBUczdWnWrhAb7jKEujqAujLFT8,True,636974719,159243679,995312,497656,497656,DddJ7EWCmYEEZETCBNgAUSg81Ls6fZtiAaY5ekJ5sXx1,39812493,223513002,-183700509,625
2022-01-08 15:15:53.739436,2022-01-08 10:05:18-05:00,2668,Dc11Q7yj9HoSfndRUB8Ffaz5BcYNFnvbVWuRn8v7Zs7C,BC35JUb1znJxJhcaivpyUPt8Ydojec2ohC1TrFv7TntJ,True,811494191,202873547,1269787,634893,634894,GAUsoe8ZTCiGPm2hYxRPGxcPe5ShNzHK9eE3G2zgRjxd,50791487,330347600,-279556113,625
2022-01-08 15:15:53.739436,2022-01-08 10:05:25-05:00,2669,AvwHizRhHUSahmvSg4jmTUErc7vAFSmkRAEsiKhXfW1m,3UrWYx8y9N5o9GYneSe6zyyHRTZzxwvcipQfHHYh7tEs,True,8498569,2124642,12868,6434,6434,3zqXX6kzhkbW3d4TwD2CNjMRwxTbREXySekvq37kfCNk,514741,2558807,-2044066,605
2022-01-08 15:15:53.739436,2022-01-08 10:05:28-05:00,2670,GjQQ2fQ7mrGjWZwjVYFUKp9NM1LmfkhEo675ovU5SPa8,ECgVUMRY5nB4MALs5drDyipF7YohCPuJpj2UegCs7HMn,True,52362254,13090563,81634,40817,40817,4BnQKPLuE3DMTtxp8MjUBytgnhvxqq3ZTqZHTVZo4JJh,3265381,18510477,-15245096,623
2022-01-08 15:15:53.739436,2022-01-08 10:06:56-05:00,2671,F9s8a7Cpiw5dw3a2aNFMofqwyDWNXvDLnSdJzoj1gRiV,GpKsQKJD79KBRWdCTkyi4zX7NaoCWsLUjrKxAwJB6o6s,True,69103449,17275862,107267,53633,53634,GAUsoe8ZTCiGPm2hYxRPGxcPe5ShNzHK9eE3G2zgRjxd,4290687,11486029,-7195342,620
2022-01-08 15:15:53.739436,2022-01-08 10:07:16-05:00,2672,GxFxvEUdWofneMmVvhCSScH9V6Zia5WJ2J9q6CpPnaq3,ATLykiHDii3Lw53MoZXwqu1FbBNPJbVNVGe2SoQMjVmY,True,10513016,2628254,16387,8193,8194,DddJ7EWCmYEEZETCBNgAUSg81Ls6fZtiAaY5ekJ5sXx1,655519,4377656,-3722137,623
2022-01-08 15:33:59.783523,2022-01-08 10:24:45-05:00,2673,864zY9zuCktUurPTtdGeLvUATnDqHZpT1GeWUApsXh2m,CzatBrNJUi7MeyfbNhszRaPMidgt8Xkcmy5ZwFMP9RCs,True,47397592,11849398,71368,35684,35684,3zqXX6kzhkbW3d4TwD2CNjMRwxTbREXySekvq37kfCNk,2854730,19813372,-16958642,602
2022-01-08 15:33:59.783523,2022-01-08 10:24:49-05:00,2674,BWtXpiXn1bomr28mGfQFTx1Kd58CQipEnKmeweYowDEC,9jws1qkXvWAdEtBvURVEeGcGJzt4zG2gh8AJESvjKKrx,True,247490226,61872556,384627,192313,192314,3zqXX6kzhkbW3d4TwD2CNjMRwxTbREXySekvq37kfCNk,15385084,123947737,-108562653,621
2022-01-08 15:33:59.783523,2022-01-08 10:25:06-05:00,2675,5SwL5U5hhQXPW1HXFf4GuU4xkmXoAKx58pjY53NPHqWS,7zB7JvYFzEEwawJy7k7NXvBSG3UsbQte7JxgwvBNbS7U,True,453102194,113275548,709003,354501,354502,3zqXX6kzhkbW3d4TwD2CNjMRwxTbREXySekvq37kfCNk,28360146,225423156,-197063010,625
2022-01-08 15:33:59.783523,2022-01-08 10:25:23-05:00,2676,D7XummfEc3NTK4qMvZegV3FrYuqc8mNgnQu3ujwemZtg,HHiRcecqzW7sGFTio7Ph6TYv3dGt64KWv4DEKgKm84fQ,True,18198439,4549609,27134,13567,13567,4BnQKPLuE3DMTtxp8MjUBytgnhvxqq3ZTqZHTVZo4JJh,1085385,7781946,-6696561,596
2022-01-08 15:33:59.783523,2022-01-08 10:25:24-05:00,2677,6cnA7PeqQgpZdA7jBg4yMzTusm8JJHRWBMup84ywJfYo,FLqcukY7RehqY6ACrwVJnGH3eRgRDe93K1jLYCQN2F3U,True,184931998,46232999,279526,139763,139763,DddJ7EWCmYEEZETCBNgAUSg81Ls6fZtiAaY5ekJ5sXx1,11181068,93880006,-82698938,604
2022-01-08 15:33:59.783523,2022-01-08 10:25:24-05:00,2678,7ptPfZnqDCvTWotn8wPGyzERTJYLBgk47j7qf8Ciq941,AfAGcFqFFPi6LCQXydgsPWidN35c7NbhBa7RLEaDQQCu,True,10364245,2591059,16091,8045,8046,DddJ7EWCmYEEZETCBNgAUSg81Ls6fZtiAaY5ekJ5sXx1,643665,2964369,-2320704,621
2022-01-08 15:33:59.783523,2022-01-08 10:25:26-05:00,2679,DvuRmJkfn6FQczUKgYeaSCqwy2NTMunuAKNrnmxMvnzS,7LpWTX9dgBtW75kfEoB5WuNsDwEdw5s8CYSHh3J4qagM,True,206390940,51597735,316182,158091,158091,4BnQKPLuE3DMTtxp8MjUBytgnhvxqq3ZTqZHTVZo4JJh,12647312,89278587,-76631275,612
2022-01-08 15:33:59.783523,2022-01-08 10:25:27-05:00,2680,DmEVzPyCKnm89v481V2ic57vyikwwMja75uVZ2rjvjfp,38fPZzP4NwTtx7Qu6DLSqx9Sv8e5CQbSrr2BMvVmSy4J,True,54416337,13604084,83098,41549,41549,3zqXX6kzhkbW3d4TwD2CNjMRwxTbREXySekvq37kfCNk,3323926,28083954,-24760028,610
2022-01-08 15:33:59.783523,2022-01-08 10:33:20-05:00,2681,DC4UVUDFWL3gVtgkX9hPtFgtxaA8DH5p94i4k9U3wyWv,3HCWqVvQQfRgSKitsTjGTduJ82ointZUSNtj13uea4kD,True,4259870217,1064967554,6651151,3325575,3325576,3zqXX6kzhkbW3d4TwD2CNjMRwxTbREXySekvq37kfCNk,266046063,1323518616,-1057472553,624
2022-01-08 15:47:49.144612,2022-01-08 10:34:06-05:00,2682,AvwHizRhHUSahmvSg4jmTUErc7vAFSmkRAEsiKhXfW1m,3UrWYx8y9N5o9GYneSe6zyyHRTZzxwvcipQfHHYh7tEs,True,6262376,1565594,9758,4879,4879,GAUsoe8ZTCiGPm2hYxRPGxcPe5ShNzHK9eE3G2zgRjxd,390322,2034925,-1644603,623
2022-01-08 15:47:49.144612,2022-01-08 10:34:06-05:00,2683,Dc11Q7yj9HoSfndRUB8Ffaz5BcYNFnvbVWuRn8v7Zs7C,BC35JUb1znJxJhcaivpyUPt8Ydojec2ohC1TrFv7TntJ,True,596093494,149023373,924863,462431,462432,3zqXX6kzhkbW3d4TwD2CNjMRwxTbREXySekvq37kfCNk,36994550,259204248,-222209698,620
2022-01-08 15:47:49.144612,2022-01-08 10:34:06-05:00,2684,EanSXRkJu91FKUhPCzYxWkmM3PQUWcovEnoZXcd6vQ9E,Fg4EzAzHStoLRDPmoBUczdWnWrhAb7jKEujqAujLFT8,True,467867106,116966776,723831,361915,361916,4BnQKPLuE3DMTtxp8MjUBytgnhvxqq3ZTqZHTVZo4JJh,28953247,176601693,-147648446,618
2022-01-08 15:47:49.144612,2022-01-08 10:34:51-05:00,2685,GjQQ2fQ7mrGjWZwjVYFUKp9NM1LmfkhEo675ovU5SPa8,ECgVUMRY5nB4MALs5drDyipF7YohCPuJpj2UegCs7HMn,True,38471101,9617775,59578,29789,29789,GAUsoe8ZTCiGPm2hYxRPGxcPe5ShNzHK9eE3G2zgRjxd,2383157,14617632,-12234475,619
2022-01-08 15:47:49.144612,2022-01-08 10:34:51-05:00,2686,DmrkajG3SrTXnYSYxGRfkzfvhkevD6RdtFk4SdLC2G6Q,5r7vkWH985E2mGSDBtznduhuu5PbZJ7d4zxjzhzEEZG1,True,75346971704,18836742926,117146010,58573005,58573005,3zqXX6kzhkbW3d4TwD2CNjMRwxTbREXySekvq37kfCNk,4685840421,33527367395,-28841526974,621
2022-01-08 15:47:49.144612,2022-01-08 10:34:56-05:00,2687,8WHDaiE6LqFFmCVMnPeLEQ99R6ft8b74UfmP9BqzjcE8,CGmoDGsdnjo3zMNrW78n2xxQr1aDPAiBYiXbyciLXYMu,True,463776521,115944129,721807,360903,360904,DddJ7EWCmYEEZETCBNgAUSg81Ls6fZtiAaY5ekJ5sXx1,28872290,176582353,-147710063,622
2022-01-08 15:47:49.144612,2022-01-08 10:34:56-05:00,2688,CCP5P6U4xBjea3snWgwBb5rtaounEAsNHpWzTUeNtVf9,GE2Bxc837ybP7sNR487U4bVbx68qyX2HtwPBLfEd4BDj,True,1324808492,331202123,2044349,1022174,1022175,DddJ7EWCmYEEZETCBNgAUSg81Ls6fZtiAaY5ekJ5sXx1,81773969,290995477,-209221508,617
2022-01-08 15:47:49.144612,2022-01-08 10:34:56-05:00,2689,EF6H6aW1p3qcAtiLFU9rbFYfsKfD683meHXDw8hLdaZK,8vfJbpnK7SQcjpEBCzZJRW8JosNbsmTeJ2YXZCbM225c,True,226313285,56578321,351898,175949,175949,DddJ7EWCmYEEZETCBNgAUSg81Ls6fZtiAaY5ekJ5sXx1,14075956,74481355,-60405399,621
2022-01-08 15:47:49.144612,2022-01-08 10:34:56-05:00,2690,GXfjQr2ihTfLRys1DMetVGocd1sU97KdoCJ6x4HxdW1U,9GHvjJJXjbVz5D3RBfP3njcdRRXnFsXZ68jFa2LiGwsy,True,337901651,84475412,525396,262698,262698,3zqXX6kzhkbW3d4TwD2CNjMRwxTbREXySekvq37kfCNk,21015861,131713535,-110697674,621
2022-01-08 15:47:49.144612,2022-01-08 10:34:56-05:00,2691,BHpLpoGQ27T6Q4CT8H4dzqS8KF8Vj5rqmqfcodoBzpgR,Akn3tG2hQBfBVtNYCeXchfzfcsyCuSpkGpFoMLEKwcBF,True,21368999,5342249,33271,16635,16636,3zqXX6kzhkbW3d4TwD2CNjMRwxTbREXySekvq37kfCNk,1330875,8830276,-7499401,622
2022-01-08 15:47:49.144612,2022-01-08 10:34:56-05:00,2692,F9s8a7Cpiw5dw3a2aNFMofqwyDWNXvDLnSdJzoj1gRiV,GpKsQKJD79KBRWdCTkyi4zX7NaoCWsLUjrKxAwJB6o6s,True,50666520,12666630,75558,37779,37779,72FwbpFGoLEazJEdpqNtPNefsadUrimUqma9wSoy4qiS,3022353,9580019,-6557666,596
2022-01-08 15:47:49.144612,2022-01-08 10:34:56-05:00,2693,GxFxvEUdWofneMmVvhCSScH9V6Zia5WJ2J9q6CpPnaq3,ATLykiHDii3Lw53MoZXwqu1FbBNPJbVNVGe2SoQMjVmY,True,7715829,1928957,11754,5877,5877,3zqXX6kzhkbW3d4TwD2CNjMRwxTbREXySekvq37kfCNk,470199,3430738,-2960539,609
2022-01-08 16:04:06.780929,2022-01-08 10:55:21-05:00,2694,GXSysysoV8Z4xBrQsaKUsSrpoWeTTUsbFmgfZDaQu4ZM,6FJyraiLgG3tb9B7pi4YFsJNtRVBNaghnm1ajzneVv7b,True,2128910983,532227745,3324767,1662383,1662384,HfEnetJ7uBSmZWCjBNxdvv9HEC5nsW4wDV7wu6WnhWan,132990681,513729698,-380739017,624
2022-01-08 16:37:38.307281,2022-01-08 11:32:06-05:00,2695,56488NdcUy6Hi6X5SLs2GFtW5pG4u5wJpH7vHdxTCx4z,tGgXjJeVr3W2m3T2NXPCqpBEd6HJKE2cRsgCyiDZQy4,True,68458286,17114571,107128,53564,53564,DddJ7EWCmYEEZETCBNgAUSg81Ls6fZtiAaY5ekJ5sXx1,4285149,30749738,-26464589,625
2022-01-08 16:37:38.307281,2022-01-08 11:32:52-05:00,2696,864zY9zuCktUurPTtdGeLvUATnDqHZpT1GeWUApsXh2m,CzatBrNJUi7MeyfbNhszRaPMidgt8Xkcmy5ZwFMP9RCs,True,34927456,8731864,53946,26973,26973,DddJ7EWCmYEEZETCBNgAUSg81Ls6fZtiAaY5ekJ5sXx1,2157840,15497614,-13339774,617
2022-01-08 16:37:38.307281,2022-01-08 11:32:52-05:00,2697,9RtNbEZ4ZR8T1HFF4cujPVy2kejVBKFo3CPQi8psSa1q,7zwaGb71jKc9y2HKCKy5q2XV2YUphkyU1hkDaab1GBas,True,219225628,54806406,339202,169601,169601,4BnQKPLuE3DMTtxp8MjUBytgnhvxqq3ZTqZHTVZo4JJh,13568086,49329833,-35761747,618
2022-01-08 16:37:38.307281,2022-01-08 11:33:17-05:00,2698,9psSuFHBGqCvcgNMc7aTMhKMMFwBDmW7v5Wkn22KtTHj,7zi9LSfuEhXccQXSRukRRwgQUaiQVVgfsGaRYLP2JvwB,True,3768999217,942249804,5896708,2948354,2948354,3zqXX6kzhkbW3d4TwD2CNjMRwxTbREXySekvq37kfCNk,235868347,909359130,-673490783,625
2022-01-08 16:37:38.307281,2022-01-08 11:33:31-05:00,2699,5SwL5U5hhQXPW1HXFf4GuU4xkmXoAKx58pjY53NPHqWS,7zB7JvYFzEEwawJy7k7NXvBSG3UsbQte7JxgwvBNbS7U,True,332385955,83096488,504117,252058,252059,DddJ7EWCmYEEZETCBNgAUSg81Ls6fZtiAaY5ekJ5sXx1,20164708,175407840,-155243132,606
2022-01-08 16:37:38.307281,2022-01-08 11:33:31-05:00,2700,DmEVzPyCKnm89v481V2ic57vyikwwMja75uVZ2rjvjfp,38fPZzP4NwTtx7Qu6DLSqx9Sv8e5CQbSrr2BMvVmSy4J,True,40059273,10014818,62058,31029,31029,4BnQKPLuE3DMTtxp8MjUBytgnhvxqq3ZTqZHTVZo4JJh,2482335,21805413,-19323078,619
2022-01-08 16:37:38.307281,2022-01-08 11:33:31-05:00,2701,BWtXpiXn1bomr28mGfQFTx1Kd58CQipEnKmeweYowDEC,9jws1qkXvWAdEtBvURVEeGcGJzt4zG2gh8AJESvjKKrx,True,181513376,45378344,271779,135889,135890,4BnQKPLuE3DMTtxp8MjUBytgnhvxqq3ZTqZHTVZo4JJh,10871183,96399018,-85527835,598
2022-01-08 16:37:38.307281,2022-01-08 11:33:31-05:00,2702,D7XummfEc3NTK4qMvZegV3FrYuqc8mNgnQu3ujwemZtg,HHiRcecqzW7sGFTio7Ph6TYv3dGt64KWv4DEKgKm84fQ,True,13396588,3349147,20104,10052,10052,3zqXX6kzhkbW3d4TwD2CNjMRwxTbREXySekvq37kfCNk,804166,6078838,-5274672,600
2022-01-08 16:37:38.307281,2022-01-08 11:33:31-05:00,2703,6cnA7PeqQgpZdA7jBg4yMzTusm8JJHRWBMup84ywJfYo,FLqcukY7RehqY6ACrwVJnGH3eRgRDe93K1jLYCQN2F3U,True,136136834,34034208,208016,104008,104008,4BnQKPLuE3DMTtxp8MjUBytgnhvxqq3ZTqZHTVZo4JJh,8320642,72907883,-64587241,611
2022-01-08 16:37:38.307281,2022-01-08 11:33:31-05:00,2704,DvuRmJkfn6FQczUKgYeaSCqwy2NTMunuAKNrnmxMvnzS,7LpWTX9dgBtW75kfEoB5WuNsDwEdw5s8CYSHh3J4qagM,True,151791562,37947890,232714,116357,116357,3zqXX6kzhkbW3d4TwD2CNjMRwxTbREXySekvq37kfCNk,9308577,69784706,-60476129,613
2022-01-08 17:05:20.863064,2022-01-08 11:39:48-05:00,2705,4ytoBUwuhAL4YYSCa6AgwrpeVF4eeU8H9NfDxMPZKxPo,Pby2szzsxDrXt4gnbmmaMccXxctZALr8miRtKhGKjsD,True,12669791,3167447,19718,9859,9859,3zqXX6kzhkbW3d4TwD2CNjMRwxTbREXySekvq37kfCNk,788756,5517232,-4728476,622
2022-01-08 17:05:20.863064,2022-01-08 11:44:30-05:00,2706,FuoFPNTdYVDkSHaBac6UC1aNJXafSNTvFJuBCdrgQQrH,ApBS1Fx83tcECMzDV6wEzEzEdg4e2hgj3djtjRUoSKK5,True,2883294704,720823675,4464123,2232061,2232062,3zqXX6kzhkbW3d4TwD2CNjMRwxTbREXySekvq37kfCNk,178564923,944871810,-766306887,619
2022-01-08 17:05:20.863064,2022-01-08 11:44:37-05:00,2707,DC4UVUDFWL3gVtgkX9hPtFgtxaA8DH5p94i4k9U3wyWv,3HCWqVvQQfRgSKitsTjGTduJ82ointZUSNtj13uea4kD,True,3131971447,782992861,4900787,2450393,2450394,HfEnetJ7uBSmZWCjBNxdvv9HEC5nsW4wDV7wu6WnhWan,196031495,1052466546,-856435051,625
2022-01-08 17:05:20.863064,2022-01-08 11:58:50-05:00,2708,EanSXRkJu91FKUhPCzYxWkmM3PQUWcovEnoZXcd6vQ9E,Fg4EzAzHStoLRDPmoBUczdWnWrhAb7jKEujqAujLFT8,True,344257155,86064288,538467,269233,269234,HfEnetJ7uBSmZWCjBNxdvv9HEC5nsW4wDV7wu6WnhWan,21538712,138923304,-117384592,625
2022-01-08 17:05:20.863064,2022-01-08 12:02:20-05:00,2709,Dc11Q7yj9HoSfndRUB8Ffaz5BcYNFnvbVWuRn8v7Zs7C,BC35JUb1znJxJhcaivpyUPt8Ydojec2ohC1TrFv7TntJ,True,438491685,109622921,684311,342155,342156,3zqXX6kzhkbW3d4TwD2CNjMRwxTbREXySekvq37kfCNk,27372449,202616767,-175244318,624
2022-01-08 17:05:20.863064,2022-01-08 12:02:46-05:00,2710,AvwHizRhHUSahmvSg4jmTUErc7vAFSmkRAEsiKhXfW1m,3UrWYx8y9N5o9GYneSe6zyyHRTZzxwvcipQfHHYh7tEs,True,4605547,1151386,7202,3601,3601,3zqXX6kzhkbW3d4TwD2CNjMRwxTbREXySekvq37kfCNk,288081,1612770,-1324689,625
2022-01-08 17:05:20.863064,2022-01-08 12:04:36-05:00,2711,Br1j5Ftafei7ysu5SmqVZSoRe4uS4qCPeKSPHg55pyiE,G8fc7QvXjfkgBFvAVUgJFQS3VaF1biL9rktBExGa87Ks,True,6374992926,1593748230,9939929,4969964,4969965,3zqXX6kzhkbW3d4TwD2CNjMRwxTbREXySekvq37kfCNk,397597168,2411955827,-2014358659,623
2022-01-08 17:05:20.863064,2022-01-08 12:04:51-05:00,2712,7oxuCEhooUZ5z2nnZRD226rcqdZgAR75SamX9DD7ejUf,CPqBb5ptWUPUJhVjshxNZCHd5RDF3fve29z4vz72JhvM,True,314248,78560,491,245,246,DddJ7EWCmYEEZETCBNgAUSg81Ls6fZtiAaY5ekJ5sXx1,19663,101191,-81528,625
2022-01-08 17:05:20.863064,2022-01-08 12:05:16-05:00,2713,CCP5P6U4xBjea3snWgwBb5rtaounEAsNHpWzTUeNtVf9,GE2Bxc837ybP7sNR487U4bVbx68qyX2HtwPBLfEd4BDj,True,974759525,243689881,1520385,760192,760193,HfEnetJ7uBSmZWCjBNxdvv9HEC5nsW4wDV7wu6WnhWan,60815416,236630464,-175815048,623
2022-01-08 17:31:20.519146,2022-01-08 12:07:56-05:00,2714,BHpLpoGQ27T6Q4CT8H4dzqS8KF8Vj5rqmqfcodoBzpgR,Akn3tG2hQBfBVtNYCeXchfzfcsyCuSpkGpFoMLEKwcBF,True,15700147,3925036,24247,12123,12124,4BnQKPLuE3DMTtxp8MjUBytgnhvxqq3ZTqZHTVZo4JJh,969915,6921085,-5951170,617
2022-01-08 17:31:20.519146,2022-01-08 12:07:57-05:00,2715,GXfjQr2ihTfLRys1DMetVGocd1sU97KdoCJ6x4HxdW1U,9GHvjJJXjbVz5D3RBfP3njcdRRXnFsXZ68jFa2LiGwsy,True,248261991,62065497,382725,191362,191363,3zqXX6kzhkbW3d4TwD2CNjMRwxTbREXySekvq37kfCNk,15309038,103500426,-88191388,616
2022-01-08 17:31:20.519146,2022-01-08 12:11:01-05:00,2716,cQqH5PtXgtCk1Vs96PgxDxzUZf2Cfx5F63j1Nkz19cs,2VVizb2qVtj8ZEpLSmJXz9hXnAiGD7GdhBxT32PbFjAY,False,40212,40212,2005,100,1905,4BnQKPLuE3DMTtxp8MjUBytgnhvxqq3ZTqZHTVZo4JJh,2005,12196,-10191,498
2022-01-08 17:31:20.519146,2022-01-08 12:12:08-05:00,2717,46TNhGwBVzedW8xSb9UY94HNeSom9iGiZzAjrKHiRM2G,7JVTiqNYeKHbyzRkKtvSEpqLPKykZso8cGUr3sX1j7QF,True,101965442,25491359,158825,79412,79413,DddJ7EWCmYEEZETCBNgAUSg81Ls6fZtiAaY5ekJ5sXx1,6353010,34431983,-28078973,623
2022-01-08 17:31:20.519146,2022-01-08 12:13:47-05:00,2718,8WHDaiE6LqFFmCVMnPeLEQ99R6ft8b74UfmP9BqzjcE8,CGmoDGsdnjo3zMNrW78n2xxQr1aDPAiBYiXbyciLXYMu,True,341078697,85269674,533751,266875,266876,3pStmNaV47N2sqUtHJHLAtCKiN9JZ6jzNY9h94ng8G1D,21350052,138889411,-117539359,625
2022-01-08 17:31:20.519146,2022-01-08 12:13:59-05:00,2719,GXSysysoV8Z4xBrQsaKUsSrpoWeTTUsbFmgfZDaQu4ZM,6FJyraiLgG3tb9B7pi4YFsJNtRVBNaghnm1ajzneVv7b,True,1564004939,391001234,2421966,1210983,1210983,HfEnetJ7uBSmZWCjBNxdvv9HEC5nsW4wDV7wu6WnhWan,96878644,415235657,-318357013,619
2022-01-08 17:31:20.519146,2022-01-08 12:14:01-05:00,2720,EF6H6aW1p3qcAtiLFU9rbFYfsKfD683meHXDw8hLdaZK,8vfJbpnK7SQcjpEBCzZJRW8JosNbsmTeJ2YXZCbM225c,True,166414255,41603563,259581,129790,129791,HfEnetJ7uBSmZWCjBNxdvv9HEC5nsW4wDV7wu6WnhWan,10383268,59008979,-48625711,623
2022-01-08 17:31:20.519146,2022-01-08 12:15:04-05:00,2721,DmrkajG3SrTXnYSYxGRfkzfvhkevD6RdtFk4SdLC2G6Q,5r7vkWH985E2mGSDBtznduhuu5PbZJ7d4zxjzhzEEZG1,True,55403058001,13850764500,86241253,43120626,43120627,DddJ7EWCmYEEZETCBNgAUSg81Ls6fZtiAaY5ekJ5sXx1,3449650154,26275303786,-22825653632,622
2022-01-08 17:31:20.519146,2022-01-08 12:15:04-05:00,2722,GjQQ2fQ7mrGjWZwjVYFUKp9NM1LmfkhEo675ovU5SPa8,ECgVUMRY5nB4MALs5drDyipF7YohCPuJpj2UegCs7HMn,True,28249271,7062317,42795,21397,21398,DddJ7EWCmYEEZETCBNgAUSg81Ls6fZtiAaY5ekJ5sXx1,1711835,11491782,-9779947,605
2022-01-08 17:31:20.519146,2022-01-08 12:15:08-05:00,2723,F9s8a7Cpiw5dw3a2aNFMofqwyDWNXvDLnSdJzoj1gRiV,GpKsQKJD79KBRWdCTkyi4zX7NaoCWsLUjrKxAwJB6o6s,True,37330250,9332562,56674,28337,28337,3zqXX6kzhkbW3d4TwD2CNjMRwxTbREXySekvq37kfCNk,2266993,7854934,-5587941,607
2022-01-08 17:31:20.519146,2022-01-08 12:15:14-05:00,2724,DRVtEzZs9u9ysrcANZLEjrvbuuGqYn77v2h4cDFKuNUx,Fv9qiMZhuSBL2cs9AWUYbDLQjB46W2ZwrhxaNXtPLDpC,True,43088611,10772152,66877,33438,33439,3zqXX6kzhkbW3d4TwD2CNjMRwxTbREXySekvq37kfCNk,2675109,9960498,-7285389,620
2022-01-08 17:31:20.519146,2022-01-08 12:15:17-05:00,2725,GxFxvEUdWofneMmVvhCSScH9V6Zia5WJ2J9q6CpPnaq3,ATLykiHDii3Lw53MoZXwqu1FbBNPJbVNVGe2SoQMjVmY,True,5684887,1421221,8872,4436,4436,3zqXX6kzhkbW3d4TwD2CNjMRwxTbREXySekvq37kfCNk,354913,2677305,-2322392,624
2022-01-08 17:47:02.035883,2022-01-08 12:33:17-05:00,2726,9psSuFHBGqCvcgNMc7aTMhKMMFwBDmW7v5Wkn22KtTHj,7zi9LSfuEhXccQXSRukRRwgQUaiQVVgfsGaRYLP2JvwB,True,2769550829,692387707,4316263,2158131,2158132,3zqXX6kzhkbW3d4TwD2CNjMRwxTbREXySekvq37kfCNk,172650528,735357697,-562707169,623
2022-01-08 17:47:02.035883,2022-01-08 12:33:31-05:00,2727,4ytoBUwuhAL4YYSCa6AgwrpeVF4eeU8H9NfDxMPZKxPo,Pby2szzsxDrXt4gnbmmaMccXxctZALr8miRtKhGKjsD,True,9312578,2328144,14471,7235,7236,DddJ7EWCmYEEZETCBNgAUSg81Ls6fZtiAaY5ekJ5sXx1,578860,4314989,-3736129,621
2022-01-08 17:47:02.035883,2022-01-08 12:35:26-05:00,2728,4miF1JWfTjjFHkrpffjGFGVfkkWFME4smk47dEcxpH4y,c4QGrEkmzRKVDbYJe3FuQfrzqBqajt8mnaKJYF2Fy3t,True,470950481,117737620,733641,366820,366821,DddJ7EWCmYEEZETCBNgAUSg81Ls6fZtiAaY5ekJ5sXx1,29345660,111065179,-81719519,623
2022-01-08 17:47:02.035883,2022-01-08 12:35:38-05:00,2729,DY6k3Dkwe18iLneaT8Xo3VpJWB6V4jWwQQjoDvEzdg2j,3GGV7S9FpRQGbARBXkvGFVqLrmw8JvYAcpnR1aKVUY2f,True,29659425,7414856,46322,23161,23161,3zqXX6kzhkbW3d4TwD2CNjMRwxTbREXySekvq37kfCNk,1852893,15314193,-13461300,624
2022-01-08 17:47:02.035883,2022-01-08 12:35:45-05:00,2730,DkvR2xUPMyXWGGkUSmDSfhp7RtvMkfbT1ThKCS3TwrXd,F7jYV6TtT1LZ5XCNn1zkbUfNMo4gGcQUczAQy1jLHpaW,True,1457359095,364339773,2275715,1137857,1137858,DddJ7EWCmYEEZETCBNgAUSg81Ls6fZtiAaY5ekJ5sXx1,91028630,546635756,-455607126,624
2022-01-08 17:47:02.035883,2022-01-08 12:35:46-05:00,2731,8T4WK27RvWVGqPuNqY6whk1fmU4vd5qaUQPZG1GJ79bh,DvSz7knS8N3K7L6JhQf1s4mJSyxB8uJXNQXtyjJn8QRL,True,162132405,40533100,251750,125875,125875,3zqXX6kzhkbW3d4TwD2CNjMRwxTbREXySekvq37kfCNk,10070008,69027901,-58957893,621
2022-01-08 17:47:02.035883,2022-01-08 12:36:31-05:00,2732,7CSCMFa9W52tBDVUbXbc3woAy3GByeA1wPJdp3MgznPa,3447ptuVFu6G8B6N63RmS8mRv4n9PfHneypHLvbeaGLn,True,254907988,63726996,397044,198522,198522,3zqXX6kzhkbW3d4TwD2CNjMRwxTbREXySekvq37kfCNk,15881799,103757458,-87875659,623
2022-01-08 17:47:02.035883,2022-01-08 12:36:34-05:00,2733,9WJBnVi84E926j7xEd566WzrZJkPJWRgmEnYj9vyjuad,4dLaFS5F7TGyLdwuJLMGkz3bSL53aHzd9ZfpNmhHxXeF,True,36753727,9188431,57268,28634,28634,4BnQKPLuE3DMTtxp8MjUBytgnhvxqq3ZTqZHTVZo4JJh,2290756,16720874,-14430118,623
2022-01-08 17:47:02.035883,2022-01-08 12:36:34-05:00,2734,8E3K7vCHJ2xjdFofPRGLbMxrkm8UYEi926QmXPAFwsqe,4qHUDA1c43Dg4qi1ZPKqmpGYiEMUZ6r4UuzB5ftHCEhW,True,3393014031,848253507,5281037,2640518,2640519,DddJ7EWCmYEEZETCBNgAUSg81Ls6fZtiAaY5ekJ5sXx1,211241490,1561889250,-1350647760,622
2022-01-08 17:47:02.035883,2022-01-08 12:38:04-05:00,2735,864zY9zuCktUurPTtdGeLvUATnDqHZpT1GeWUApsXh2m,CzatBrNJUi7MeyfbNhszRaPMidgt8Xkcmy5ZwFMP9RCs,True,25699595,6424898,40111,20055,20056,HfEnetJ7uBSmZWCjBNxdvv9HEC5nsW4wDV7wu6WnhWan,1604446,12105304,-10500858,624
2022-01-08 17:47:02.035883,2022-01-08 12:38:40-05:00,2736,FuoFPNTdYVDkSHaBac6UC1aNJXafSNTvFJuBCdrgQQrH,ApBS1Fx83tcECMzDV6wEzEzEdg4e2hgj3djtjRUoSKK5,True,2121039613,530259903,3311981,1655990,1655991,3zqXX6kzhkbW3d4TwD2CNjMRwxTbREXySekvq37kfCNk,132479262,748698003,-616218741,624
2022-01-08 17:47:02.035883,2022-01-08 12:38:48-05:00,2737,7YkgzZSgiNgRpWbreoG88UHQPCqDDwwo3XvHuj2xC3Q7,5vFivT8iffaeJgVMHaXsh7RNJhWPD9VSeecBxcezVdkq,True,1473429300,368357325,2270191,1135095,1135096,3pStmNaV47N2sqUtHJHLAtCKiN9JZ6jzNY9h94ng8G1D,90807656,350578356,-259770700,616
2022-01-08 17:47:02.035883,2022-01-08 12:38:48-05:00,2738,5vzh7WqULESYt69G7cERe6m6CUBFTghs6PsmfwUazeDL,B7wXVicmbid4cYuQJQSx7m8QrVxn7oWMZHHRdCsF15kT,True,4119056225,1029764056,6334764,3167382,3167382,DddJ7EWCmYEEZETCBNgAUSg81Ls6fZtiAaY5ekJ5sXx1,253390570,978844345,-725453775,615
2022-01-08 17:47:02.035883,2022-01-08 12:38:48-05:00,2739,9GZvAP3pWvG1R2iX6gGh1Y98uQfWNzx7A4JR8wh2pMB6,EbP9gS23sGYk2TfSy3So3KGtqJQs16zWfbsEoGUkyo5D,True,1249548662,312387165,1931441,965720,965721,4BnQKPLuE3DMTtxp8MjUBytgnhvxqq3ZTqZHTVZo4JJh,77257652,297248990,-219991338,618
2022-01-08 17:47:02.035883,2022-01-08 12:38:48-05:00,2740,G9JU2qGFe91CYZcUqdor4VEZJS5Qap8ieaiKebtQmhA6,Ej7hesFJfAJeiGtEPnmRKiETTPptxDRNjSiKaAAbfFh5,True,1287580732,321895183,1967965,983982,983983,3zqXX6kzhkbW3d4TwD2CNjMRwxTbREXySekvq37kfCNk,78718605,306517873,-227799268,611
2022-01-08 17:47:02.035883,2022-01-08 12:38:58-05:00,2741,9jeqT7xKb8hr5VRuQEFxnf93Y3zHsvmYDHz64nyE7Wte,9NqYMu528mFG2M7RYL1NuEvR9aiNAW13WwXDKuprQa7h,True,88501921,22125479,138125,69062,69063,3zqXX6kzhkbW3d4TwD2CNjMRwxTbREXySekvq37kfCNk,5525017,41068296,-35543279,624
2022-01-08 17:47:02.035883,2022-01-08 12:38:58-05:00,2742,7M96qouCsH6each8J6PbcCaciyWmC7fgSASimc2NdGVD,5FBFPgjq699BCLRb1Ec9ksU5CtxHvtdrwjDh4D3R8pDY,True,1356955557,339238889,2111048,1055524,1055524,3zqXX6kzhkbW3d4TwD2CNjMRwxTbREXySekvq37kfCNk,84441959,322666402,-238224443,622
2022-01-08 17:47:02.035883,2022-01-08 12:38:58-05:00,2743,HbgbyziAskLHFgBBKwpjDQLESabiAtcJHqtHi6KXozrJ,6nZzZCdFAo4J5nWPzkid1JtgtTe1xE8xttxQy1hrzEWM,True,1172080689,293020172,1816369,908184,908185,DddJ7EWCmYEEZETCBNgAUSg81Ls6fZtiAaY5ekJ5sXx1,72654778,278954089,-206299311,619
2022-01-08 17:47:02.035883,2022-01-08 12:38:58-05:00,2744,Dv1BABsN7amhjmGBpMQsnMkRLx7MuCVwsnuyTQeZ6uum,BCjscxVo1h16teND6KKiAUy1ftNGTMy1vEEEyAW4ttVG,True,15437393,3859348,23979,11989,11990,DddJ7EWCmYEEZETCBNgAUSg81Ls6fZtiAaY5ekJ5sXx1,959181,3671788,-2712607,621
2022-01-08 17:47:02.035883,2022-01-08 12:39:07-05:00,2745,661MsJKGwSvjunXGBBckSi1F2dpuJCn3T5FPKcyLzqAv,G2Hyuva8oKaV3PPMp4EPmanfbW8r55bTnQYAs7PXdmti,True,1593873033,398468258,2488868,1244434,1244434,3zqXX6kzhkbW3d4TwD2CNjMRwxTbREXySekvq37kfCNk,99554720,378911687,-279356967,624
2022-01-08 17:47:02.035883,2022-01-08 12:39:11-05:00,2746,AVJuLzRoU8fs1DYguypkgjAHw2qozpXZehvhmn24p7MJ,BewpttKJGCFzhe8HaBSgmoH9WrqXuafdb8zW8NTfsYV9,True,1483866444,370966611,2320186,1160093,1160093,3zqXX6kzhkbW3d4TwD2CNjMRwxTbREXySekvq37kfCNk,92807442,352730998,-259923556,625
2022-01-08 17:47:02.035883,2022-01-08 12:39:23-05:00,2747,AqEgQKT6MqEvmUTX144W3jfGh4jx8kvsnQojtC7aKg8s,H4UiVvRhub2jVEtgHe5VP43wyqiLGS3ZsSHWSdcmCRr7,True,1493647858,373411964,2336026,1168013,1168013,4BnQKPLuE3DMTtxp8MjUBytgnhvxqq3ZTqZHTVZo4JJh,93441045,355053187,-261612142,625
2022-01-08 17:47:02.035883,2022-01-08 12:39:25-05:00,2748,4uygLJDk9DFCifJ56YwMrEsvd3oQNq8tYSLnMCyWorS6,GimL4uKGvg3FFmFQSWzAcjstv3Vmk5NMgDGMKTuXYVpB,True,1239485180,309871295,1904343,952171,952172,DddJ7EWCmYEEZETCBNgAUSg81Ls6fZtiAaY5ekJ5sXx1,76173742,451514435,-375340693,614
2022-01-08 17:47:02.035883,2022-01-08 12:39:25-05:00,2749,399591e8XgY52yCMorCQ2WL6dQZTC485ZooHtmGuirhZ,JCiXAooFmKmEPQ2S7C8iSk6CLcTyrPEe1SsPSLyUGySe,True,2558314,639578,3931,1965,1966,DddJ7EWCmYEEZETCBNgAUSg81Ls6fZtiAaY5ekJ5sXx1,157276,1336146,-1178870,614
2022-01-08 17:47:02.035883,2022-01-08 12:39:25-05:00,2750,D9VKhnfLLCrntDGFYSfoxFaY76VnHmYZ1ZbyFXdKdibz,2hRCRH2pMDyQGYcXHa8Y6BZo6FbcGZf5VJC1v8Bp6tGa,True,219803656,54950914,338545,169272,169273,DddJ7EWCmYEEZETCBNgAUSg81Ls6fZtiAaY5ekJ5sXx1,13541819,72977767,-59435948,616
2022-01-08 17:47:02.035883,2022-01-08 12:39:27-05:00,2751,FhAt6pZW3k8StP9VLeWUfidpXfRLoKWdV7Wgxdh9cRy9,Guk93pTo3KcG8konHjJ52oi9rgexmmKhPQAkxZS1BtCG,True,418835128,104708780,653379,326689,326690,HfEnetJ7uBSmZWCjBNxdvv9HEC5nsW4wDV7wu6WnhWan,26135196,169669614,-143534418,623
2022-01-08 17:47:02.035883,2022-01-08 12:39:32-05:00,2752,FnAT8HKGgisYfeAbxKU2gSbCp8KbZHULRpaJX1NVijHy,2u637Crc2QzfSJmCnRNqeib3aZQVn4NGncpgM3Ph6jvm,True,81969703,20492425,127184,63592,63592,4BnQKPLuE3DMTtxp8MjUBytgnhvxqq3ZTqZHTVZo4JJh,5087377,23614648,-18527271,620
2022-01-08 17:47:02.035883,2022-01-08 12:39:32-05:00,2753,8kJu5aqVSmW8FSZR9h6F75ftn9V2U9uMLBEKeqRaC855,FhVHByujkvwwtjTVpZ4mqSUqoMoBgeLUc5H7rbz3FgAt,True,211225778,52806444,325800,162900,162900,4BnQKPLuE3DMTtxp8MjUBytgnhvxqq3ZTqZHTVZo4JJh,13032010,110342402,-97310392,616
2022-01-08 17:47:02.035883,2022-01-08 12:39:34-05:00,2754,A4tDE948CPFPh1UwHb8sXryfKktbxZ8BCkqXgA5DJHA8,3zXeKMrsEpCe5fQumLNzCgpxcG1kLJFEAtJuqxLsC6ZG,True,207054476,51763619,318388,159194,159194,4BnQKPLuE3DMTtxp8MjUBytgnhvxqq3ZTqZHTVZo4JJh,12735539,81133352,-68397813,615
2022-01-08 17:47:02.035883,2022-01-08 12:39:54-05:00,2755,9RtNbEZ4ZR8T1HFF4cujPVy2kejVBKFo3CPQi8psSa1q,7zwaGb71jKc9y2HKCKy5q2XV2YUphkyU1hkDaab1GBas,True,161299558,40324889,252240,126120,126120,DddJ7EWCmYEEZETCBNgAUSg81Ls6fZtiAaY5ekJ5sXx1,10089628,40031302,-29941674,625
2022-01-08 17:47:02.035883,2022-01-08 12:40:51-05:00,2756,2mfcg17QocKKvDcqDH88TwxHRiS8dAQiJAGoAh1brns9,8aQLELBgaA9eXsxSciMjxWv8B1hpbUPfLwqVjEnasZbe,True,287473172,71868293,447368,223684,223684,4BnQKPLuE3DMTtxp8MjUBytgnhvxqq3ZTqZHTVZo4JJh,17894728,67889562,-49994834,622
2022-01-08 17:47:02.035883,2022-01-08 12:42:14-05:00,2757,FsMiJiJZibohKoV5QRisWCjzuFd86xSxFb4m73AQmu93,7p3TSKBaG9SV2YNDnhutQKacPKpTTmgsEfzmK51t6sYb,True,498971368,124742842,779219,389609,389610,3zqXX6kzhkbW3d4TwD2CNjMRwxTbREXySekvq37kfCNk,31168794,143944416,-112775622,624
2022-01-08 17:47:02.035883,2022-01-08 12:42:27-05:00,2758,AUH6YGBV8tDVX1E1WTo92Mubfx1DGsqfGeyUBqxo4fSr,33QZgMwmW32WuvmxD8XNbmF9ea88bLe3YTtNwHV73Wwu,True,499339632,124834908,780317,390158,390159,3zqXX6kzhkbW3d4TwD2CNjMRwxTbREXySekvq37kfCNk,31212699,147826834,-116614135,625
2022-01-08 17:47:02.035883,2022-01-08 12:42:29-05:00,2759,9KD2AifD5wFD4QkHYuawXbJgLWHrfj2QPF3fT8jhGVA5,Ga9gAqmkuHbqrr31sUFPqa1xa5WNxLWJWGPUaMxQqLdj,True,2322191,580547,3527,1763,1764,DddJ7EWCmYEEZETCBNgAUSg81Ls6fZtiAaY5ekJ5sXx1,141089,1234737,-1093648,607
2022-01-08 17:47:02.035883,2022-01-08 12:42:29-05:00,2760,8sneA6wAg6geVDJ1g7YWg4R1PfjuRVzeHp1nUBJinhZa,14i1uWtmcTjrdbg3DSr9vzd5NBnxqsn1A4QdgFBZqeYM,True,278756,69687,435,217,218,4BnQKPLuE3DMTtxp8MjUBytgnhvxqq3ZTqZHTVZo4JJh,17424,108613,-91189,625
2022-01-08 17:47:02.035883,2022-01-08 12:42:30-05:00,2761,3VdSA9CED9f5swRwHX2U15U7J6Muaq8VPnCNy9CaGDHe,2YYstfnfdYic5NWmEbcUEHpccNUVd1EhuCkExvMsoMk8,True,11963542,2990885,18421,9210,9211,DddJ7EWCmYEEZETCBNgAUSg81Ls6fZtiAaY5ekJ5sXx1,736850,6281762,-5544912,615
2022-01-08 17:47:02.035883,2022-01-08 12:42:31-05:00,2762,6VJcr3VAEcEZaHEpt48QL8QxHKABufVp8n2JSEVTLh9U,8naR6kiySKj3vai9dCetdgCnCHgf2oyLjGqKTJ3Lz64Y,True,2778495107,694623776,4269812,2134906,2134906,DddJ7EWCmYEEZETCBNgAUSg81Ls6fZtiAaY5ekJ5sXx1,170792500,1090739228,-919946728,614
2022-01-08 17:47:02.035883,2022-01-08 12:42:36-05:00,2763,A36aouot1oFLUtswuBUM4EVcis9chKaSJu53MRoPDjab,33U9gpq1RRFMGWDrWa3ezXXkwgBewdAS6QGgGVPtGvqb,True,642487060,160621765,987762,493881,493881,DddJ7EWCmYEEZETCBNgAUSg81Ls6fZtiAaY5ekJ5sXx1,39510502,184597288,-145086786,614
2022-01-08 17:53:16.525005,2022-01-08 12:49:09-05:00,2764,CCP5P6U4xBjea3snWgwBb5rtaounEAsNHpWzTUeNtVf9,GE2Bxc837ybP7sNR487U4bVbx68qyX2HtwPBLfEd4BDj,True,715817360,178954340,1101068,550534,550534,HfEnetJ7uBSmZWCjBNxdvv9HEC5nsW4wDV7wu6WnhWan,44042747,191182607,-147139860,615
2022-01-08 17:53:16.525005,2022-01-08 12:49:14-05:00,2765,GXfjQr2ihTfLRys1DMetVGocd1sU97KdoCJ6x4HxdW1U,9GHvjJJXjbVz5D3RBfP3njcdRRXnFsXZ68jFa2LiGwsy,True,182262307,45565576,274803,137401,137402,3zqXX6kzhkbW3d4TwD2CNjMRwxTbREXySekvq37kfCNk,10992126,81071814,-70079688,603
2022-01-08 17:53:16.525005,2022-01-08 12:49:14-05:00,2766,BHpLpoGQ27T6Q4CT8H4dzqS8KF8Vj5rqmqfcodoBzpgR,Akn3tG2hQBfBVtNYCeXchfzfcsyCuSpkGpFoMLEKwcBF,True,11525997,2881499,17413,8706,8707,3zqXX6kzhkbW3d4TwD2CNjMRwxTbREXySekvq37kfCNk,696554,5409054,-4712500,604
2022-01-08 17:53:16.525005,2022-01-08 12:49:15-05:00,2767,E5biUzKn2s5frKseCmfWriWjrYMGVtmLrhR9nYhAkVvR,BDHzqefisuGoMGcpML8t6KAC7rcErvhLcfV8KQC7oHAH,True,45088883,11272220,70478,35239,35239,3zqXX6kzhkbW3d4TwD2CNjMRwxTbREXySekvq37kfCNk,2819132,14644294,-11825162,625
2022-01-08 17:53:16.525005,2022-01-08 12:49:44-05:00,2768,5kwvkEtRFFD84j4ntVgxkacadgJaFvQ9JLhJqzLR7Y3G,GpMMkTv9T7y8DTiizuoJUsWvnSk3GSxADjRMGyYpryxm,True,56066786,14016696,87097,43548,43549,DddJ7EWCmYEEZETCBNgAUSg81Ls6fZtiAaY5ekJ5sXx1,3483914,15393616,-11909702,621
2022-01-08 17:53:16.525005,2022-01-08 12:50:49-05:00,2769,46TNhGwBVzedW8xSb9UY94HNeSom9iGiZzAjrKHiRM2G,7JVTiqNYeKHbyzRkKtvSEpqLPKykZso8cGUr3sX1j7QF,True,74948591,18737147,116717,58358,58359,3zqXX6kzhkbW3d4TwD2CNjMRwxTbREXySekvq37kfCNk,4668693,27253516,-22584823,622
2022-01-08 17:53:16.525005,2022-01-08 12:51:07-05:00,2770,BJaaH1SK1pF2kZQzmYpLFfDtm52CR9a5rd39RAPtLe8q,HUsT5FVxaisdnCvG1BQxX6zffjfL2Rwx5mMo5y8SDV7e,True,93258635,23314658,145509,72754,72755,DddJ7EWCmYEEZETCBNgAUSg81Ls6fZtiAaY5ekJ5sXx1,5820374,23219179,-17398805,624
2022-01-08 17:53:16.525005,2022-01-08 12:51:27-05:00,2771,8trkirSQNdMmAcJdeswxs5cPjH8dD6U4eJtWiAdMsrDB,HaSzpQ45x2MipfN17U6jGBxX8tXboomVDhXNSrnEfLDr,True,7918694,1979673,12348,6174,6174,HfEnetJ7uBSmZWCjBNxdvv9HEC5nsW4wDV7wu6WnhWan,493958,2934845,-2440887,623
2022-01-08 17:59:54.450887,2022-01-08 12:53:34-05:00,2772,5Rxuqgs4CaSKbfDXqBMFXkLTQ9dxrUjThXzoy3ouYVtK,BgvbKru66ebrGUcFFymGTmsaQv6GgcGMybiWaXqzBtwX,True,368906,92226,569,284,285,4BnQKPLuE3DMTtxp8MjUBytgnhvxqq3ZTqZHTVZo4JJh,22790,205286,-182496,617
2022-01-08 17:59:54.450887,2022-01-08 12:53:44-05:00,2773,HdfQweV1KuYSpWdycZbpGrUc8yMcY3ZczLn1agKXMJaf,G1Ae1PZHkANkwFnhUKS1tvdFEv8dAFeojBkezh6rUNMh,True,12816016,3204004,20050,10025,10025,3zqXX6kzhkbW3d4TwD2CNjMRwxTbREXySekvq37kfCNk,802029,5523310,-4721281,625
2022-01-08 17:59:54.450887,2022-01-08 12:53:45-05:00,2774,2jDRvE3pQNjWy1NRFa4tzB3KmU5UkbUCHw8sQRFujo66,C4zNi2szDrEEh4coTF3WRUghfP4ZwAVVSYTLWfkejQRu,True,1146500123,286625030,1781163,890581,890582,DddJ7EWCmYEEZETCBNgAUSg81Ls6fZtiAaY5ekJ5sXx1,71246550,364128484,-292881934,621
2022-01-08 17:59:54.450887,2022-01-08 12:53:45-05:00,2775,HwosLQgDY1xtHQRQ4hzroPQHFWssPzTj5vRkP37FcviB,HKTNEYNXrephNkH7apbobK4mcQXcNayQA4W1NgM6sLr8,True,80577935,20144483,125850,62925,62925,4BnQKPLuE3DMTtxp8MjUBytgnhvxqq3ZTqZHTVZo4JJh,5034030,22751002,-17716972,624
2022-01-08 17:59:54.450887,2022-01-08 12:53:46-05:00,2776,3ogBPSRcKfmwzgumVDHBkXLi1eCsEFG2xzSJgD4LQDNy,7TXyqWgJqfe71MSWFA2n7ufZbUdzf7JJoWej8FNNtMXo,True,37409747,9352436,58324,29162,29162,DddJ7EWCmYEEZETCBNgAUSg81Ls6fZtiAaY5ekJ5sXx1,2332992,12904953,-10571961,623
2022-01-08 17:59:54.450887,2022-01-08 12:53:51-05:00,2777,A1j2G5FZRyWSjFt6dK87WHhLkQrPUVqHaM3KhSzhAKDT,2fMiHLYm4pL3YCd8aveTR4mT9uVxztQeMwb5eRZb4wUW,True,1242564,310641,1944,972,972,3zqXX6kzhkbW3d4TwD2CNjMRwxTbREXySekvq37kfCNk,77774,522542,-444768,625
2022-01-08 17:59:54.450887,2022-01-08 12:53:51-05:00,2778,5BJnMHFSiQjHRGFJDW1jnqCfkHHYWnQzmmccy9eA4jNj,9517JGYsPmvgPUM9pFRD2vipHmdgE578F7jA7Qq6jorm,True,928892741,232223185,1449225,724612,724613,3zqXX6kzhkbW3d4TwD2CNjMRwxTbREXySekvq37kfCNk,57969011,350995201,-293026190,624
2022-01-08 17:59:54.450887,2022-01-08 12:54:20-05:00,2779,GXSysysoV8Z4xBrQsaKUsSrpoWeTTUsbFmgfZDaQu4ZM,6FJyraiLgG3tb9B7pi4YFsJNtRVBNaghnm1ajzneVv7b,True,1148939345,287234836,1759807,879903,879904,4BnQKPLuE3DMTtxp8MjUBytgnhvxqq3ZTqZHTVZo4JJh,70392318,333293730,-262901412,612
2022-01-08 17:59:54.450887,2022-01-08 12:54:27-05:00,2780,DRVtEzZs9u9ysrcANZLEjrvbuuGqYn77v2h4cDFKuNUx,Fv9qiMZhuSBL2cs9AWUYbDLQjB46W2ZwrhxaNXtPLDpC,True,31682500,7920625,49356,24678,24678,3zqXX6kzhkbW3d4TwD2CNjMRwxTbREXySekvq37kfCNk,1974273,8072301,-6098028,623
2022-01-08 17:59:54.450887,2022-01-08 12:54:28-05:00,2781,8xvLGVeDmhVYQhN2ZpWkVG9jCrukRsNQ4926a4TMiZqa,9ciBySSjvADwp47WkETiFWZKVTFL8Hf1XvK7aSxhcgQS,True,44225723,11056430,69186,34593,34593,4BnQKPLuE3DMTtxp8MjUBytgnhvxqq3ZTqZHTVZo4JJh,2767470,16800064,-14032594,625
2022-01-08 17:59:54.450887,2022-01-08 12:55:12-05:00,2782,9psSuFHBGqCvcgNMc7aTMhKMMFwBDmW7v5Wkn22KtTHj,7zi9LSfuEhXccQXSRukRRwgQUaiQVVgfsGaRYLP2JvwB,True,2035415075,508853768,3164655,1582327,1582328,3zqXX6kzhkbW3d4TwD2CNjMRwxTbREXySekvq37kfCNk,126586218,590582108,-463995890,621
2022-01-08 17:59:54.450887,2022-01-08 12:55:23-05:00,2783,EF6H6aW1p3qcAtiLFU9rbFYfsKfD683meHXDw8hLdaZK,8vfJbpnK7SQcjpEBCzZJRW8JosNbsmTeJ2YXZCbM225c,True,122310601,30577649,190589,95294,95295,72FwbpFGoLEazJEdpqNtPNefsadUrimUqma9wSoy4qiS,7623596,46593472,-38969876,623
2022-01-08 17:59:54.450887,2022-01-08 12:55:23-05:00,2784,4ytoBUwuhAL4YYSCa6AgwrpeVF4eeU8H9NfDxMPZKxPo,Pby2szzsxDrXt4gnbmmaMccXxctZALr8miRtKhGKjsD,True,6844638,1711159,10614,5307,5307,3zqXX6kzhkbW3d4TwD2CNjMRwxTbREXySekvq37kfCNk,424593,3366490,-2941897,620
2022-01-08 17:59:54.450887,2022-01-08 12:55:36-05:00,2785,CbhrZUdan1axNDFUrX1ZuEohfNMEGrszKSkk6pppVQuw,DHEAjJNtuEePezYAv77thWabbVxxqQpfuiC6moRSrpG1,True,164069157,41017289,256513,128256,128257,3zqXX6kzhkbW3d4TwD2CNjMRwxTbREXySekvq37kfCNk,10260537,86167140,-75906603,625
2022-01-08 17:59:54.450887,2022-01-08 12:55:36-05:00,2786,8WHDaiE6LqFFmCVMnPeLEQ99R6ft8b74UfmP9BqzjcE8,CGmoDGsdnjo3zMNrW78n2xxQr1aDPAiBYiXbyciLXYMu,True,250667460,62666864,391868,195934,195934,3zqXX6kzhkbW3d4TwD2CNjMRwxTbREXySekvq37kfCNk,15674738,108972428,-93297690,625
2022-01-08 17:59:54.450887,2022-01-08 12:55:49-05:00,2787,36ByQojnxEckWdQTjqHfxKqCx9yjqWQsPsZyqaN72UWR,AZoirtS1fjX61agRM64tqThVinnJTh3BWgiHyNHPTgZP,True,1419588,354896,2220,1110,1110,3zqXX6kzhkbW3d4TwD2CNjMRwxTbREXySekvq37kfCNk,88832,734575,-645743,625
2022-01-08 17:59:54.450887,2022-01-08 12:56:27-05:00,2788,4miF1JWfTjjFHkrpffjGFGVfkkWFME4smk47dEcxpH4y,c4QGrEkmzRKVDbYJe3FuQfrzqBqajt8mnaKJYF2Fy3t,True,346057200,86514300,536408,268204,268204,4BnQKPLuE3DMTtxp8MjUBytgnhvxqq3ZTqZHTVZo4JJh,21456358,89907799,-68451441,620
2022-01-08 17:59:54.450887,2022-01-08 12:56:38-05:00,2789,Br1j5Ftafei7ysu5SmqVZSoRe4uS4qCPeKSPHg55pyiE,G8fc7QvXjfkgBFvAVUgJFQS3VaF1biL9rktBExGa87Ks,True,4686792910,1171698227,7330136,3665068,3665068,3zqXX6kzhkbW3d4TwD2CNjMRwxTbREXySekvq37kfCNk,293205453,1898623918,-1605418465,625
2022-01-08 17:59:54.450887,2022-01-08 12:57:10-05:00,2790,BWtXpiXn1bomr28mGfQFTx1Kd58CQipEnKmeweYowDEC,9jws1qkXvWAdEtBvURVEeGcGJzt4zG2gh8AJESvjKKrx,True,133891538,33472884,208447,104223,104224,DddJ7EWCmYEEZETCBNgAUSg81Ls6fZtiAaY5ekJ5sXx1,8337889,74728122,-66390233,622
2022-01-08 17:59:54.450887,2022-01-08 12:57:15-05:00,2791,D7XummfEc3NTK4qMvZegV3FrYuqc8mNgnQu3ujwemZtg,HHiRcecqzW7sGFTio7Ph6TYv3dGt64KWv4DEKgKm84fQ,True,9881802,2470450,15427,7713,7714,3zqXX6kzhkbW3d4TwD2CNjMRwxTbREXySekvq37kfCNk,617093,4738741,-4121648,624
2022-01-08 17:59:54.450887,2022-01-08 12:57:15-05:00,2792,5vzh7WqULESYt69G7cERe6m6CUBFTghs6PsmfwUazeDL,B7wXVicmbid4cYuQJQSx7m8QrVxn7oWMZHHRdCsF15kT,True,3031393072,757848268,4728917,2364458,2364459,3zqXX6kzhkbW3d4TwD2CNjMRwxTbREXySekvq37kfCNk,189156709,791617647,-602460938,623
2022-01-08 17:59:54.450887,2022-01-08 12:58:36-05:00,2793,5SwL5U5hhQXPW1HXFf4GuU4xkmXoAKx58pjY53NPHqWS,7zB7JvYFzEEwawJy7k7NXvBSG3UsbQte7JxgwvBNbS7U,True,244910337,61227584,381211,190605,190606,4BnQKPLuE3DMTtxp8MjUBytgnhvxqq3ZTqZHTVZo4JJh,15248460,136062823,-120814363,622
2022-01-08 17:59:54.450887,2022-01-08 12:59:14-05:00,2794,8xQ3tsWVUe75EG1HmocULJ3kh52utveoFMEPotTGrKno,i3SKW3ywrwYucX9ySEx1C4zaUKGnzLerP3V38437NyV,True,104280969,26070241,163194,81597,81597,3zqXX6kzhkbW3d4TwD2CNjMRwxTbREXySekvq37kfCNk,6527781,45445678,-38917897,625
2022-01-08 17:59:54.450887,2022-01-08 12:59:44-05:00,2795,6cnA7PeqQgpZdA7jBg4yMzTusm8JJHRWBMup84ywJfYo,FLqcukY7RehqY6ACrwVJnGH3eRgRDe93K1jLYCQN2F3U,True,100242443,25060610,155973,77986,77987,72FwbpFGoLEazJEdpqNtPNefsadUrimUqma9wSoy4qiS,6238927,56540028,-50301101,622
2022-01-08 18:19:01.018010,2022-01-08 13:00:11-05:00,2796,H1Z83zVoskNuBvYao1FjdLfETfhPpQFQUkniJfGxbaNz,EVqbBRV6Zy1tPLRevxpAykp8Mvv6tDZVTc4RmCKw4Gq1,True,1053625812,263406452,1644457,822228,822229,3zqXX6kzhkbW3d4TwD2CNjMRwxTbREXySekvq37kfCNk,65778310,486946032,-421167722,624
2022-01-08 18:19:01.018010,2022-01-08 13:00:12-05:00,2797,BgnsCfJ54ReunUtwPJLzkW4PWnqpBDWGNYxsW5PvDrbK,KpMqEkQ9dKMgCevsEK895wHd3fCLRPSzDmJSv3tKU4u,True,25539554205,6384888551,39783628,19891814,19891814,DddJ7EWCmYEEZETCBNgAUSg81Ls6fZtiAaY5ekJ5sXx1,1591345127,8788354070,-7197008943,623
2022-01-08 18:19:01.018010,2022-01-08 13:00:13-05:00,2798,BMn3FQ6axnUt5K3esCEgoVi8GZAcPCg3YrjcwAFVvTah,HEvRK6CPti7aoTaYExEQAyr9ZyTQ6u4jg5Y2btc7ovdd,False,126557,126557,6070,303,5767,3zqXX6kzhkbW3d4TwD2CNjMRwxTbREXySekvq37kfCNk,6070,34156,-28086,479
2022-01-08 18:19:01.018010,2022-01-08 13:00:14-05:00,2799,JDeYjCLpfnzcfxDFgHf4aBcHsajwdR14GUaKAA9euzVf,EJbvKoyMZcoCx4vWa61uMbW2vr6mUhrgEuECdteVBuZZ,True,13734193,3433548,20694,10347,10347,4BnQKPLuE3DMTtxp8MjUBytgnhvxqq3ZTqZHTVZo4JJh,827775,7575932,-6748157,602
2022-01-08 18:19:01.018010,2022-01-08 13:00:20-05:00,2800,5eMLdQ4gYA5iqvTXSNdGvctHp7s5VpyFuwtJKqx6chBc,Ckxc5K39nkBNXBTmFTM8J48R7wGqNm3vHKZu4G5baumZ,True,578011599,144502899,881002,440501,440501,DddJ7EWCmYEEZETCBNgAUSg81Ls6fZtiAaY5ekJ5sXx1,35240114,181457745,-146217631,609
2022-01-08 18:19:01.018010,2022-01-08 13:00:21-05:00,2801,Bsr6kx1B6BSEd5UnJ7Z61M49iUb3bFrDVhiEtMVtPDF2,3CFd1pUJAJPA9fobwn4Jj2mRju1CWmoop4Mh4znypNWT,True,51648451,12912112,80514,40257,40257,DddJ7EWCmYEEZETCBNgAUSg81Ls6fZtiAaY5ekJ5sXx1,3220566,17740976,-14520410,623
2022-01-08 18:19:01.018010,2022-01-08 13:00:24-05:00,2802,DmEVzPyCKnm89v481V2ic57vyikwwMja75uVZ2rjvjfp,38fPZzP4NwTtx7Qu6DLSqx9Sv8e5CQbSrr2BMvVmSy4J,True,29478105,7369526,46099,23049,23050,DddJ7EWCmYEEZETCBNgAUSg81Ls6fZtiAaY5ekJ5sXx1,1843975,16902677,-15058702,625
2022-01-08 18:19:01.018010,2022-01-08 13:00:24-05:00,2803,H3x9b27yHVdCxvtDf7mmJxkNeubcmQMwfAkLTYADPWNv,HGVCCz23rWx78vrTB2wvm2aesbLZuYFhhNuznGiSSAyA,True,5871023407,1467755851,9132565,4566282,4566283,72FwbpFGoLEazJEdpqNtPNefsadUrimUqma9wSoy4qiS,365302630,1161952398,-796649768,622
2022-01-08 18:19:01.018010,2022-01-08 13:00:24-05:00,2804,56488NdcUy6Hi6X5SLs2GFtW5pG4u5wJpH7vHdxTCx4z,tGgXjJeVr3W2m3T2NXPCqpBEd6HJKE2cRsgCyiDZQy4,True,50297911,12574477,77729,38864,38865,3zqXX6kzhkbW3d4TwD2CNjMRwxTbREXySekvq37kfCNk,3109160,24003461,-20894301,618
2022-01-08 18:19:01.018010,2022-01-08 13:00:27-05:00,2805,8aKqLY7GXxNnGRK8Utke7o6EDGZATNDDF8Ph9Q27ppyi,7MQKkebLEzQgjWjByBMzzkn68yqtYivS4VDcraAScZR6,True,2508718,627178,3853,1926,1927,3zqXX6kzhkbW3d4TwD2CNjMRwxTbREXySekvq37kfCNk,154157,614775,-460618,614
2022-01-08 18:19:01.018010,2022-01-08 13:00:33-05:00,2806,2MbNCikBC3fdwqJKfMK1FjPg7wT3xWMXmN88XuikJ8r9,5eG6U5x63YYMpE7iwwu1TPcZapvQMyKczvtnFfST1BH3,False,90484,90484,4482,224,4258,DddJ7EWCmYEEZETCBNgAUSg81Ls6fZtiAaY5ekJ5sXx1,4482,31438,-26956,495
2022-01-08 18:19:01.018010,2022-01-08 13:04:35-05:00,2807,DvuRmJkfn6FQczUKgYeaSCqwy2NTMunuAKNrnmxMvnzS,7LpWTX9dgBtW75kfEoB5WuNsDwEdw5s8CYSHh3J4qagM,True,111769861,27942465,174107,87053,87054,HfEnetJ7uBSmZWCjBNxdvv9HEC5nsW4wDV7wu6WnhWan,6964303,54395785,-47431482,623
2022-01-08 18:19:01.018010,2022-01-08 13:04:41-05:00,2808,Dv1BABsN7amhjmGBpMQsnMkRLx7MuCVwsnuyTQeZ6uum,BCjscxVo1h16teND6KKiAUy1ftNGTMy1vEEEyAW4ttVG,True,11347532,2836883,17586,8793,8793,3zqXX6kzhkbW3d4TwD2CNjMRwxTbREXySekvq37kfCNk,703462,2968437,-2264975,619
2022-01-08 18:19:01.018010,2022-01-08 13:04:51-05:00,2809,7ptPfZnqDCvTWotn8wPGyzERTJYLBgk47j7qf8Ciq941,AfAGcFqFFPi6LCQXydgsPWidN35c7NbhBa7RLEaDQQCu,True,7492931,1873230,11667,5833,5834,3zqXX6kzhkbW3d4TwD2CNjMRwxTbREXySekvq37kfCNk,466699,2365699,-1899000,622
2022-01-08 18:19:01.018010,2022-01-08 13:05:41-05:00,2810,CCP5P6U4xBjea3snWgwBb5rtaounEAsNHpWzTUeNtVf9,GE2Bxc837ybP7sNR487U4bVbx68qyX2HtwPBLfEd4BDj,True,526945888,131736472,824183,412091,412092,3zqXX6kzhkbW3d4TwD2CNjMRwxTbREXySekvq37kfCNk,32967347,153254008,-120286661,625
2022-01-08 18:19:01.018010,2022-01-08 13:05:42-05:00,2811,GXfjQr2ihTfLRys1DMetVGocd1sU97KdoCJ6x4HxdW1U,9GHvjJJXjbVz5D3RBfP3njcdRRXnFsXZ68jFa2LiGwsy,True,134362638,33590659,209216,104608,104608,3zqXX6kzhkbW3d4TwD2CNjMRwxTbREXySekvq37kfCNk,8368643,63263593,-54894950,622
2022-01-08 18:19:01.018010,2022-01-08 13:05:42-05:00,2812,6NJFN855M3Q3RLTDNo57gTgAmwPD6G2E3WvMb1m5eNCN,3YpqNnonsvXaRT4nCC3G5FZx1jjVtbDPc36LiR6WK5jR,True,134056681,33514170,208674,104337,104337,3zqXX6kzhkbW3d4TwD2CNjMRwxTbREXySekvq37kfCNk,8346982,72598943,-64251961,622
2022-01-08 18:19:01.018010,2022-01-08 13:05:50-05:00,2813,BHpLpoGQ27T6Q4CT8H4dzqS8KF8Vj5rqmqfcodoBzpgR,Akn3tG2hQBfBVtNYCeXchfzfcsyCuSpkGpFoMLEKwcBF,True,8496602,2124150,13258,6629,6629,3zqXX6kzhkbW3d4TwD2CNjMRwxTbREXySekvq37kfCNk,530323,4212599,-3682276,624
2022-01-08 18:19:01.018010,2022-01-08 13:06:03-05:00,2814,D64rDiWT3YG28fCgXCmbNjYa2JakZbpKQ1D2XuLChUfV,8WmMWq8cTsGQym5pUbHm9dPCpJugBeWUMVERYFGLxWHj,True,62902701,15725675,97852,48926,48926,3zqXX6kzhkbW3d4TwD2CNjMRwxTbREXySekvq37kfCNk,3914095,20105523,-16191428,622
2022-01-08 18:19:01.018010,2022-01-08 13:06:25-05:00,2815,9jeqT7xKb8hr5VRuQEFxnf93Y3zHsvmYDHz64nyE7Wte,9NqYMu528mFG2M7RYL1NuEvR9aiNAW13WwXDKuprQa7h,True,65068998,16267249,101751,50875,50876,3zqXX6kzhkbW3d4TwD2CNjMRwxTbREXySekvq37kfCNk,4070042,32035010,-27964968,625
2022-01-08 18:19:01.018010,2022-01-08 13:06:25-05:00,2816,ymyzGH4Qc7HH5PbKpVphCbsQgLLXyGkPcXamQJuNj5C,8oTLHaV2XzbKXNWRuUjCfHjUn61Pw93LYK14m9q2VDpZ,True,31712139,7928034,49555,24777,24778,3zqXX6kzhkbW3d4TwD2CNjMRwxTbREXySekvq37kfCNk,1982238,10607301,-8625063,625
2022-01-08 18:19:01.018010,2022-01-08 13:06:30-05:00,2817,B4Uc39nKzz9wBRQsCkMR4A7RwTJ8rSuwpR6EQn2AesRb,H49bGZgatRZVpj6QufZRVgYrQtH7LpdbiqKBs23151m,True,59669903,14917475,93300,46650,46650,3zqXX6kzhkbW3d4TwD2CNjMRwxTbREXySekvq37kfCNk,3732039,49186103,-45454064,625
2022-01-08 18:19:01.018010,2022-01-08 13:06:31-05:00,2818,8swGZMrPrLAxZd7MxTbkCL13k3DmAJUw41jCp6Xo6awW,3fKnX7yTNXAT4uMmXVdTy47ALJT8h8YSD3WiBb4BGuzH,True,408765436,102191359,637557,318778,318779,3zqXX6kzhkbW3d4TwD2CNjMRwxTbREXySekvq37kfCNk,25502288,167874300,-142372012,623
2022-01-08 18:19:01.018010,2022-01-08 13:07:10-05:00,2819,FV9CBGGTbppLnBKh79f2LzD1diTiS5g6u89FcpZHZmnK,Fe7mtmCUziFqbbYTvrhAcAq1Ub7YLfTJRtQ1hG7GzJD1,True,12532952,3133238,19560,9780,9780,HfEnetJ7uBSmZWCjBNxdvv9HEC5nsW4wDV7wu6WnhWan,782423,4272310,-3489887,624
2022-01-08 18:19:01.018010,2022-01-08 13:07:11-05:00,2820,243SAnGxchCVB1LQAUF4SsozR86yDwEdg2QQpbWGsMYe,5u8sNkb2oEQjUXJAB3yGStmv3Uwz16gBgExBo5myVK4b,True,25247733,6311933,39303,19651,19652,DddJ7EWCmYEEZETCBNgAUSg81Ls6fZtiAaY5ekJ5sXx1,1572153,7973944,-6401791,622
2022-01-08 18:19:01.018010,2022-01-08 13:07:11-05:00,2821,DMgD2KCEhTGFLUZ5GnfNcwfiiwKYbyVpoWiN6knMkCAf,5KU2vgBkPTNVHsSULjgX7ZkZS56U3Dy3xqLTxL5sUZJ3,True,3284477821,821119455,5110064,2555032,2555032,4BnQKPLuE3DMTtxp8MjUBytgnhvxqq3ZTqZHTVZo4JJh,204402575,1801644606,-1597242031,622
2022-01-08 18:19:01.018010,2022-01-08 13:07:12-05:00,2822,3WcJUt8jQ1ngL3ZCGo6dFrc3GmTMTYtzeDva7mri2Tqx,HeG1Pz2oMjqtkfsRMsbqP3VpatnVEQzcWmKDVoFp4Htr,True,37394906,9348726,58458,29229,29229,3zqXX6kzhkbW3d4TwD2CNjMRwxTbREXySekvq37kfCNk,2338348,14995465,-12657117,625
2022-01-08 18:19:01.018010,2022-01-08 13:07:12-05:00,2823,BPsM1um9ZJf7eNoVMsQCRSwgARMuLCGGSDxf9tZeNeEy,BpzDdXfxVygiSYSmsHV6uPxQMeTFtrURMCCqhswQjd5X,True,2776868,694217,4287,2143,2144,3zqXX6kzhkbW3d4TwD2CNjMRwxTbREXySekvq37kfCNk,171519,953867,-782348,617
2022-01-08 18:19:01.018010,2022-01-08 13:07:13-05:00,2824,DR7XL3qweFyTKDatQYS2LacqGLv2368cnGuWpEpk4hSL,Fd3BYCiiQfThDJsxBUNwYTMP8eNCrnXMVzE1wpejJqXa,True,10990,2747,17,8,9,DddJ7EWCmYEEZETCBNgAUSg81Ls6fZtiAaY5ekJ5sXx1,687,5136,-4449,625
2022-01-08 18:19:01.018010,2022-01-08 13:07:14-05:00,2825,BYvjENe16Ta77PqGV7JKEWrsqCTfkMGYwTSG5gXneDvd,EvxAXgvhPC6QkNurbK7vWyTApGo8J2R4EgMAknkHVU3d,True,7120590,1780147,11062,5531,5531,3zqXX6kzhkbW3d4TwD2CNjMRwxTbREXySekvq37kfCNk,442492,3999551,-3557059,621
2022-01-08 18:19:01.018010,2022-01-08 13:07:20-05:00,2826,Cs2YxkuqBK1kjoYZbUZdUcxapPbv8oC75trwGgWoCPfG,2PgHQM1GhHykE4bQ1ggueAw2Zs1BFUW5hxvMvr8DojKM,True,130912929,32728232,204849,102424,102425,4BnQKPLuE3DMTtxp8MjUBytgnhvxqq3ZTqZHTVZo4JJh,8193967,67107532,-58913565,625
2022-01-08 18:19:01.018010,2022-01-08 13:07:20-05:00,2827,aTkGURJptmKNNP6RSXSWsmVbfcriSAJaMuUiT2eZEfb,5qoGxL83PLhrguyk27X8xE6jGitRg5BaQpXzrcfEvCfJ,True,488209693,122052423,758238,379119,379119,4BnQKPLuE3DMTtxp8MjUBytgnhvxqq3ZTqZHTVZo4JJh,30329521,146574872,-116245351,621
2022-01-08 18:19:01.018010,2022-01-08 13:07:22-05:00,2828,FFoYoBmkfEsCWVXQf3BhKeaFMZD3YVKvfhPWkXdnCZS9,8yW6WApAuN43brF1HioTLdyxvQTQJzt875E26QqrWWFk,True,1276299,319074,1993,996,997,3zqXX6kzhkbW3d4TwD2CNjMRwxTbREXySekvq37kfCNk,79747,322199,-242452,624
2022-01-08 18:19:01.018010,2022-01-08 13:07:30-05:00,2829,6rb3fRVWJ5cSzFcmuC1YwdrNxiNctvboDF7HwsfyGoCA,H6JaYfFZkRk6iSJrA4nVeuFpMVQtVwQZHVgK1TyaupTE,True,99820,24955,152,76,76,3zqXX6kzhkbW3d4TwD2CNjMRwxTbREXySekvq37kfCNk,6118,71550,-65432,612
2022-01-08 18:19:01.018010,2022-01-08 13:07:30-05:00,2830,CwTus4FyoXYqyTKAYDp69NLhA1joYZ3tarzY6FFTr6fn,6ivuvYWU6i25MzJSY8rG9rPDKiq38E6QtrV1jvRubLGr,True,24082,6020,36,18,18,3zqXX6kzhkbW3d4TwD2CNjMRwxTbREXySekvq37kfCNk,1477,9386,-7909,613
2022-01-08 18:19:01.018010,2022-01-08 13:07:30-05:00,2831,6Bq55LtGCEeGqh4JrFLCmmGc2iJfTTBJixivqH78aGSE,DSNrCgWJeNe2P9tAQu5FvCueTzNKDKds7wzuwTQSMRG,True,15799982,3949995,24255,12127,12128,3zqXX6kzhkbW3d4TwD2CNjMRwxTbREXySekvq37kfCNk,970204,5298445,-4328241,614
2022-01-08 18:19:01.018010,2022-01-08 13:07:33-05:00,2832,BZxJ6CtrVoiU86DMMieMeDFLNWtMpHGTvZfM7nyay6o4,6CRxRR8bisRLHFJBFWjyumYuy7j4C4PkjYH1K8gXhdWD,True,6608855,1652212,10293,5146,5147,3zqXX6kzhkbW3d4TwD2CNjMRwxTbREXySekvq37kfCNk,411735,1871260,-1459525,623
2022-01-08 18:19:01.018010,2022-01-08 13:07:35-05:00,2833,DrzTARa7RK8RXoxHZPKCBqYtMC8TAUHRw8SznXRKTa5M,FYANet92VhyXkKZqqBJR4sFxuCftWb68sgQU9VHCdTJk,True,61322,15330,95,47,48,DddJ7EWCmYEEZETCBNgAUSg81Ls6fZtiAaY5ekJ5sXx1,3831,22611,-18780,624
2022-01-08 18:19:01.018010,2022-01-08 13:07:35-05:00,2834,7vKmhLV45Q5etXhJL5ng8rxWhYSiUCDmAbGnwBPr7zcx,cP6xPeuHLnjr858QK1F9qYn7rJpEbPy7wEJHoju6oV7,True,80374374,20093593,124724,62362,62362,3zqXX6kzhkbW3d4TwD2CNjMRwxTbREXySekvq37kfCNk,4988994,30881835,-25892841,620
2022-01-08 18:19:01.018010,2022-01-08 13:07:36-05:00,2835,X5SF9srgzDgBRBhv8xUWyszYYSQiqFF6cVnVLWzQgp1,7rTqnMkPuUUJFt5px1DxwsUK8U5fQUtnx9N4v6dA4vGb,True,61425,15356,95,47,48,3zqXX6kzhkbW3d4TwD2CNjMRwxTbREXySekvq37kfCNk,3808,23759,-19951,619
2022-01-08 18:19:01.018010,2022-01-08 13:07:36-05:00,2836,7D4rFmGMPKNAF75VRPxHAhSn2wTjiW8jmth1UD22Xqq9,GQ7BrT6vsXu8tHCMm75YdxFR2r9QTCrCUbdPEZBSAg9w,True,89013321,22253330,138251,69125,69126,3zqXX6kzhkbW3d4TwD2CNjMRwxTbREXySekvq37kfCNk,5530074,28525642,-22995568,621
2022-01-08 18:19:01.018010,2022-01-08 13:07:36-05:00,2837,DY6k3Dkwe18iLneaT8Xo3VpJWB6V4jWwQQjoDvEzdg2j,3GGV7S9FpRQGbARBXkvGFVqLrmw8JvYAcpnR1aKVUY2f,True,21800084,5450021,33971,16985,16986,4BnQKPLuE3DMTtxp8MjUBytgnhvxqq3ZTqZHTVZo4JJh,1358845,11899350,-10540505,623
2022-01-08 18:19:01.018010,2022-01-08 13:07:37-05:00,2838,5Z3ZFCA65WoWhm3okRuuziEMi7ajGAEHWUFchzBNba5S,FcomdrWidygkxMKzcsY5xELbmwC652uMci648LMTv7AB,True,23093,5773,36,18,18,DddJ7EWCmYEEZETCBNgAUSg81Ls6fZtiAaY5ekJ5sXx1,1444,8665,-7221,625
2022-01-08 18:19:01.018010,2022-01-08 13:07:39-05:00,2839,2d1qyEJRyGvB2H83ACSqUjqYLwcLHcURHWAKLXs4w9vp,EFA6rDFpTQcY2vjZMq6Qrjv56nJPN2FhWXNwFzkWtE2M,True,21057563,5264390,32763,16381,16382,DddJ7EWCmYEEZETCBNgAUSg81Ls6fZtiAaY5ekJ5sXx1,1310534,10624912,-9314378,622
2022-01-08 18:19:01.018010,2022-01-08 13:07:39-05:00,2840,2PzBAkdXkrwH9VuoMALumQz86qkW7sSBQtCrHw14JUp3,D5vwWAMHVooobG2sCWv9EwtJrAFZG6cwKH4dfmA98tbt,True,4829969,1207492,7482,3741,3741,72FwbpFGoLEazJEdpqNtPNefsadUrimUqma9wSoy4qiS,299281,1875901,-1576620,619
2022-01-08 18:19:01.018010,2022-01-08 13:07:39-05:00,2841,F1JT1p2VuwK4L7zj7NNnZtYiZiNUCcTGKDkgdoX3BZdZ,3BKe4yzTwnnBnvTWP3britpPJ4oAWL7JZJzNLCxjUufS,True,12066,3016,18,9,9,72FwbpFGoLEazJEdpqNtPNefsadUrimUqma9wSoy4qiS,744,2527,-1783,616
2022-01-08 18:19:01.018010,2022-01-08 13:08:04-05:00,2842,BhiAaiZu7fF8ndggJrLyiFVCRq526cNBw7VaeascEmNL,4en8MipPi7vq15NGhpPMQfptNdEyhp2j7fpgxBBtjyfz,True,2051651,512912,3167,1583,1584,4BnQKPLuE3DMTtxp8MjUBytgnhvxqq3ZTqZHTVZo4JJh,126712,769973,-643261,617
2022-01-08 18:19:01.018010,2022-01-08 13:08:07-05:00,2843,7oxuCEhooUZ5z2nnZRD226rcqdZgAR75SamX9DD7ejUf,CPqBb5ptWUPUJhVjshxNZCHd5RDF3fve29z4vz72JhvM,True,228902,57224,356,178,178,4BnQKPLuE3DMTtxp8MjUBytgnhvxqq3ZTqZHTVZo4JJh,14277,80292,-66015,623
2022-01-08 18:19:01.018010,2022-01-08 13:08:48-05:00,2844,gMjmD7WioyUdQdwNqE5fobLcxPwoJv5rAvLmJaf8Jjw,5n77euFjVJiwKrnbYq1KpcENW1mzBZj2BuDGyzazrkJ8,True,2135964,533990,3283,1641,1642,4BnQKPLuE3DMTtxp8MjUBytgnhvxqq3ZTqZHTVZo4JJh,131341,839058,-707717,614
2022-01-08 18:19:01.018010,2022-01-08 13:08:48-05:00,2845,J1sBDjpdBZcsSBS5eg95SSRjRqmQUR9cXJCsLJu8yCUt,F5wRpD2senMkGbL8Uquqo8W9x5NQDDa268dHuVFAZCww,True,6175171,1543792,9500,4750,4750,DddJ7EWCmYEEZETCBNgAUSg81Ls6fZtiAaY5ekJ5sXx1,380011,2761709,-2381698,615
2022-01-08 18:19:01.018010,2022-01-08 13:08:50-05:00,2846,Hy3kzXneDN6FUkiZctU1vWe97BYvj6yZ7QvQzehfWmNr,EhXgQg8BTniANV525RpY76z7Hrh6DuqrMChjqEoXfVJe,True,2981058,745264,4652,2326,2326,3zqXX6kzhkbW3d4TwD2CNjMRwxTbREXySekvq37kfCNk,186094,1353683,-1167589,624
2022-01-08 18:19:01.018010,2022-01-08 13:08:51-05:00,2847,9E97vZ6evPgg1Ao8KwvjjZhBFW6dXZrrJENk1HvZ3SU,D7U38PB8BXLwUVKbRNv9po7VcFdnn7Y4tWY9xpRiNJsT,True,88911695,22227923,138873,69436,69437,3zqXX6kzhkbW3d4TwD2CNjMRwxTbREXySekvq37kfCNk,5554927,22548293,-16993366,624
2022-01-08 18:19:01.018010,2022-01-08 13:09:18-05:00,2848,8kJu5aqVSmW8FSZR9h6F75ftn9V2U9uMLBEKeqRaC855,FhVHByujkvwwtjTVpZ4mqSUqoMoBgeLUc5H7rbz3FgAt,True,155244359,38811089,237700,118850,118850,3zqXX6kzhkbW3d4TwD2CNjMRwxTbREXySekvq37kfCNk,9508032,85668058,-76160026,612
2022-01-08 18:19:01.018010,2022-01-08 13:09:18-05:00,2849,D9VKhnfLLCrntDGFYSfoxFaY76VnHmYZ1ZbyFXdKdibz,2hRCRH2pMDyQGYcXHa8Y6BZo6FbcGZf5VJC1v8Bp6tGa,True,161540728,40385182,246677,123338,123339,3zqXX6kzhkbW3d4TwD2CNjMRwxTbREXySekvq37kfCNk,9867116,57758216,-47891100,610
2022-01-08 18:19:01.018010,2022-01-08 13:09:18-05:00,2850,FsMiJiJZibohKoV5QRisWCjzuFd86xSxFb4m73AQmu93,7p3TSKBaG9SV2YNDnhutQKacPKpTTmgsEfzmK51t6sYb,True,366803595,91700898,572745,286372,286373,3zqXX6kzhkbW3d4TwD2CNjMRwxTbREXySekvq37kfCNk,22909817,114927032,-92017215,624
2022-01-08 18:19:01.018010,2022-01-08 13:09:18-05:00,2851,AUH6YGBV8tDVX1E1WTo92Mubfx1DGsqfGeyUBqxo4fSr,33QZgMwmW32WuvmxD8XNbmF9ea88bLe3YTtNwHV73Wwu,True,367078678,91769669,573786,286893,286893,3zqXX6kzhkbW3d4TwD2CNjMRwxTbREXySekvq37kfCNk,22951466,117848761,-94897295,625
2022-01-08 18:19:01.018010,2022-01-08 13:09:19-05:00,2852,399591e8XgY52yCMorCQ2WL6dQZTC485ZooHtmGuirhZ,JCiXAooFmKmEPQ2S7C8iSk6CLcTyrPEe1SsPSLyUGySe,True,1879991,469997,2857,1428,1429,3zqXX6kzhkbW3d4TwD2CNjMRwxTbREXySekvq37kfCNk,114319,1037218,-922899,608
2022-01-08 18:19:01.018010,2022-01-08 13:09:19-05:00,2853,9KD2AifD5wFD4QkHYuawXbJgLWHrfj2QPF3fT8jhGVA5,Ga9gAqmkuHbqrr31sUFPqa1xa5WNxLWJWGPUaMxQqLdj,True,1710330,427582,2649,1324,1325,3zqXX6kzhkbW3d4TwD2CNjMRwxTbREXySekvq37kfCNk,105993,957544,-851551,619
2022-01-08 18:19:01.018010,2022-01-08 13:09:19-05:00,2854,FnAT8HKGgisYfeAbxKU2gSbCp8KbZHULRpaJX1NVijHy,2u637Crc2QzfSJmCnRNqeib3aZQVn4NGncpgM3Ph6jvm,True,60238068,15059517,92799,46399,46400,3zqXX6kzhkbW3d4TwD2CNjMRwxTbREXySekvq37kfCNk,3711979,18846928,-15134949,616
2022-01-08 18:19:01.018010,2022-01-08 13:09:19-05:00,2855,8E3K7vCHJ2xjdFofPRGLbMxrkm8UYEi926QmXPAFwsqe,4qHUDA1c43Dg4qi1ZPKqmpGYiEMUZ6r4UuzB5ftHCEhW,True,2488576095,622144023,3735096,1867548,1867548,3zqXX6kzhkbW3d4TwD2CNjMRwxTbREXySekvq37kfCNk,149403872,1219130671,-1069726799,600
2022-01-08 18:19:01.018010,2022-01-08 13:09:19-05:00,2856,DYCYiQFH9QHzCo3eAw1pFoDu7pzwFMo1E2WDZjVFRz5w,CPh4FWsGak1kd1WFEH9qBjNhnun3R2tHtZA57zW8ugn5,True,87831005,21957750,133337,66668,66669,3zqXX6kzhkbW3d4TwD2CNjMRwxTbREXySekvq37kfCNk,5333510,43107160,-37773650,607
2022-01-08 18:19:01.018010,2022-01-08 13:09:19-05:00,2857,J3ggP7ZxL8HRh3CBp5iYG2WgjLyNSAWYT46uC9VYDLCz,2FqTRiRPiLvdAH2BS5vroVntpsSXvTJEn5UHWmtKHzh9,True,51564252,12891063,77181,38590,38591,3zqXX6kzhkbW3d4TwD2CNjMRwxTbREXySekvq37kfCNk,3087257,15355005,-12267748,598
2022-01-08 18:19:01.018010,2022-01-08 13:09:20-05:00,2858,A4tDE948CPFPh1UwHb8sXryfKktbxZ8BCkqXgA5DJHA8,3zXeKMrsEpCe5fQumLNzCgpxcG1kLJFEAtJuqxLsC6ZG,True,152128984,38032246,230813,115406,115407,3zqXX6kzhkbW3d4TwD2CNjMRwxTbREXySekvq37kfCNk,9232533,63694741,-54462208,606
2022-01-08 18:19:01.018010,2022-01-08 13:09:20-05:00,2859,4uygLJDk9DFCifJ56YwMrEsvd3oQNq8tYSLnMCyWorS6,GimL4uKGvg3FFmFQSWzAcjstv3Vmk5NMgDGMKTuXYVpB,True,910605857,227651464,1378130,689065,689065,3zqXX6kzhkbW3d4TwD2CNjMRwxTbREXySekvq37kfCNk,55125201,355708026,-300582825,605
2022-01-08 18:19:01.018010,2022-01-08 13:09:20-05:00,2860,DkvR2xUPMyXWGGkUSmDSfhp7RtvMkfbT1ThKCS3TwrXd,F7jYV6TtT1LZ5XCNn1zkbUfNMo4gGcQUczAQy1jLHpaW,True,1066096061,266524015,1541755,770877,770878,3zqXX6kzhkbW3d4TwD2CNjMRwxTbREXySekvq37kfCNk,61670214,430395111,-368724897,578
2022-01-08 18:19:01.018010,2022-01-08 13:09:20-05:00,2861,9WJBnVi84E926j7xEd566WzrZJkPJWRgmEnYj9vyjuad,4dLaFS5F7TGyLdwuJLMGkz3bSL53aHzd9ZfpNmhHxXeF,True,26936279,6734069,40011,20005,20006,3zqXX6kzhkbW3d4TwD2CNjMRwxTbREXySekvq37kfCNk,1600443,13052114,-11451671,594
2022-01-08 18:19:01.018010,2022-01-08 13:09:27-05:00,2862,8T4WK27RvWVGqPuNqY6whk1fmU4vd5qaUQPZG1GJ79bh,DvSz7knS8N3K7L6JhQf1s4mJSyxB8uJXNQXtyjJn8QRL,True,118838965,29709740,175994,87997,87997,72FwbpFGoLEazJEdpqNtPNefsadUrimUqma9wSoy4qiS,7039786,54019333,-46979547,592
2022-01-08 18:19:01.018010,2022-01-08 13:09:32-05:00,2863,7CSCMFa9W52tBDVUbXbc3woAy3GByeA1wPJdp3MgznPa,3447ptuVFu6G8B6N63RmS8mRv4n9PfHneypHLvbeaGLn,True,187408527,46852130,292029,146014,146015,HfEnetJ7uBSmZWCjBNxdvv9HEC5nsW4wDV7wu6WnhWan,11681178,81361087,-69679909,623
2022-01-08 18:19:01.018010,2022-01-08 13:11:01-05:00,2864,Cb4zhnvig11U4GcC4kqKrnDicGgPhUpfDQB1U7hP3nPa,DiRAMrKqaevGXeXg38KnhaYBERj8tNKU7oWFJvhS32kw,True,374378,93594,583,291,292,4BnQKPLuE3DMTtxp8MjUBytgnhvxqq3ZTqZHTVZo4JJh,23329,123563,-100234,623
2022-01-08 18:19:01.018010,2022-01-08 13:11:04-05:00,2865,DC4UVUDFWL3gVtgkX9hPtFgtxaA8DH5p94i4k9U3wyWv,3HCWqVvQQfRgSKitsTjGTduJ82ointZUSNtj13uea4kD,True,2302372628,575593157,3593610,1796805,1796805,3pStmNaV47N2sqUtHJHLAtCKiN9JZ6jzNY9h94ng8G1D,143744433,832899169,-689154736,624
2022-01-08 18:19:01.018010,2022-01-08 13:11:06-05:00,2866,CK3ocyWzXQkJJZQmM6bBK4Nv6Rh3UEufjY6DvNU6gJZy,C924o4GY3p2BHLeAbFbe9SEysXqCUyD8sFu2d4NzkAV7,True,12083871,3020967,18570,9285,9285,3zqXX6kzhkbW3d4TwD2CNjMRwxTbREXySekvq37kfCNk,742803,4081389,-3338586,614
2022-01-08 18:19:01.018010,2022-01-08 13:11:06-05:00,2867,i7TcF4weYcqgrRdH3GpndbEYxCxfcSfr9JWYrAUg1CF,BkDfknUir7PnSEW8auoB87PytycEFwyX5kT2GY4SGJJL,True,9804365,2451091,15049,7524,7525,3zqXX6kzhkbW3d4TwD2CNjMRwxTbREXySekvq37kfCNk,601965,7481494,-6879529,613
2022-01-08 18:19:01.018010,2022-01-08 13:11:06-05:00,2868,E1wp3bmkcY3eiEYyGYwhTCsr7BZ7RfPa5DJTZFupcFwj,452hVdYkD5SDDrA6hv6DLPFvyS8PvR2P6DPNScGxWTsW,True,1495204,373801,2297,1148,1149,3zqXX6kzhkbW3d4TwD2CNjMRwxTbREXySekvq37kfCNk,91916,598774,-506858,614
2022-01-08 18:19:01.018010,2022-01-08 13:11:06-05:00,2869,EhANPABkSw9x9WnsDEi8pCg67iQTX2UGTTUpyjADTwdN,4FKLi98hyg9ZjM4MY6ctJsv7B6vPUnTYWdhrnNoYsztX,True,18602863,4650715,28551,14275,14276,3zqXX6kzhkbW3d4TwD2CNjMRwxTbREXySekvq37kfCNk,1142067,9082752,-7940685,613
2022-01-08 18:19:01.018010,2022-01-08 13:11:07-05:00,2870,AKxRtcdpi7gWhAuL8ENj7zhgeQezzEXe9TSANE6bQoRA,2YH4vrU9deP8Cu6E8Hzf8GqKG1yVjv5pdz4FE7r5YKir,True,12699153,3174788,19708,9854,9854,3zqXX6kzhkbW3d4TwD2CNjMRwxTbREXySekvq37kfCNk,788341,4826592,-4038251,620
2022-01-08 18:19:01.018010,2022-01-08 13:11:07-05:00,2871,GaEpNGa8jnwSRvjzzEMYkZe1pKcr2eiZtePrqFxpABjB,5CFZHuyWbJv14zPdX5dSQDREgHrCb4vsFvB6hLiEe3Ji,True,282638,70659,441,220,221,DddJ7EWCmYEEZETCBNgAUSg81Ls6fZtiAaY5ekJ5sXx1,17669,108790,-91121,625
2022-01-08 18:19:01.018010,2022-01-08 13:11:07-05:00,2872,89CkXnSZnr52Zsoh48efv9MQacrkB6GMtrbEpNJSyA2H,HcvRBS4Z22CpYgDNgm4TVF4AVXFDuYzBUAFcdHAwdpg4,True,5561917,1390479,8688,4344,4344,3zqXX6kzhkbW3d4TwD2CNjMRwxTbREXySekvq37kfCNk,347550,2118565,-1771015,624
2022-01-08 18:19:01.018010,2022-01-08 13:11:07-05:00,2873,75ycx5sUFBxDhY1uwuPCW22s2C6BydkJTje7q7zEQFGT,FpEgrVFRubjGK4DRjTqdVbxSECURpn16zfpoC31NbwnN,True,11827610,2956902,18347,9173,9174,DddJ7EWCmYEEZETCBNgAUSg81Ls6fZtiAaY5ekJ5sXx1,733904,5779597,-5045693,620
2022-01-08 18:19:01.018010,2022-01-08 13:11:07-05:00,2874,2NHv3c4ufYGo3xNr6KXymAZJdpfURrNiCKbXZ7s82Vwo,E4NYpYgHTvSG6LqH2bBV9Q1XJ6pAzCp9FLSKMzJmYRrQ,True,47983264,11995816,74268,37134,37134,3zqXX6kzhkbW3d4TwD2CNjMRwxTbREXySekvq37kfCNk,2970723,23917174,-20946451,619
2022-01-08 18:19:01.018010,2022-01-08 13:11:25-05:00,2875,2p2fGXdKrmxjomLSnyaNg84J82cBBBNympZ6qQc8UZgU,HKAM8bazuLMUY6yapZJqYsgaWkTBqKHyMs1hSfpYsZGi,True,1461459218,365364804,2286284,1143142,1143142,3zqXX6kzhkbW3d4TwD2CNjMRwxTbREXySekvq37kfCNk,91451387,696428820,-604977433,625
2022-01-08 18:19:01.018010,2022-01-08 13:11:25-05:00,2876,2rCRdyfi65rpxRRmg7knaSb8t55FuPt3h8wF4Fzhy8MM,CLVY5nSG3jTdRo7tRSKgK9DJgW6aswfWKe4tLxzsENmb,True,1168948,292237,1828,914,914,3zqXX6kzhkbW3d4TwD2CNjMRwxTbREXySekvq37kfCNk,73140,394468,-321328,625
2022-01-08 18:19:01.018010,2022-01-08 13:11:41-05:00,2877,6VJcr3VAEcEZaHEpt48QL8QxHKABufVp8n2JSEVTLh9U,8naR6kiySKj3vai9dCetdgCnCHgf2oyLjGqKTJ3Lz64Y,True,2045670043,511417510,3200157,1600078,1600079,4BnQKPLuE3DMTtxp8MjUBytgnhvxqq3ZTqZHTVZo4JJh,128006302,856366436,-728360134,625
2022-01-08 18:19:01.018010,2022-01-08 13:11:44-05:00,2878,9YEzjb49Awvedv9yNc6LG54SkGBug2RYiJwiUV13mGsS,3H8w5WCD187NWWoZMNUCzUDdxTgqrRJLga8gDzUVXBgZ,True,2033822,508455,3163,1581,1582,3zqXX6kzhkbW3d4TwD2CNjMRwxTbREXySekvq37kfCNk,126549,1145753,-1019204,622
2022-01-08 18:19:01.018010,2022-01-08 13:11:44-05:00,2879,2NdwSLxsGok8PczpCZj9CVX2BymNU5MvHt7hWfGetg2M,8AQbDXeA6mD9QoZBFJcYbnHvZwKNxzA9CCHLAgdSfTA3,True,19757,4939,30,15,15,72FwbpFGoLEazJEdpqNtPNefsadUrimUqma9wSoy4qiS,1234,9631,-8397,624
2022-01-08 18:19:01.018010,2022-01-08 13:11:44-05:00,2880,4MmpDGUTyMcYEqJ1RoZ46AN2BhrBUseHaHqF8AmiTPyD,7HW2YZpYM349HMfW7u4h9ESZ1AXkwN8JcVDTNFzp9aTz,True,222638331,55659582,346911,173455,173456,72FwbpFGoLEazJEdpqNtPNefsadUrimUqma9wSoy4qiS,13876441,108163987,-94287546,623
2022-01-08 18:19:01.018010,2022-01-08 13:11:44-05:00,2881,BzSJ77zKaqtBk2cEL1XqFL97zTXXMRHmxtkgtXwCc3C,2g4KXTwy2MPSRQ2khNp1o1rn7CradEr9H4ySYKDoSWN9,True,18734599,4683649,29257,14628,14629,3zqXX6kzhkbW3d4TwD2CNjMRwxTbREXySekvq37kfCNk,1170290,16910926,-15740636,624
2022-01-08 18:19:01.018010,2022-01-08 13:11:44-05:00,2882,JCBhqqPQxP1Xc41sSY6e1sQKRstHhe7D1v6rLz4hp3Qp,DWMUq2bMD1jqpxHtyXDFjcAwjA27yyMRe68hGcsK143m,True,12921,3230,20,10,10,72FwbpFGoLEazJEdpqNtPNefsadUrimUqma9wSoy4qiS,802,4876,-4074,620
2022-01-08 18:19:01.018010,2022-01-08 13:11:44-05:00,2883,EeUACm9TkjHKES5U7Yj1oPhYmcp7R3tvesGBiP8txEzq,3qkmm4aS6EDirEDejmbm5PDw2jpYkC7zKqrMkmgeE5BA,True,428492,107123,669,334,335,3zqXX6kzhkbW3d4TwD2CNjMRwxTbREXySekvq37kfCNk,26785,139537,-112752,625
2022-01-08 18:19:01.018010,2022-01-08 13:11:49-05:00,2884,HqtTbC1LFreGvgfpZe7nCqkNnh8GHPQKosfmc19zb1yi,E39UNiHNkwQEd5GXkCtTPqSorQSB1kLx8kjzK4jdFoi3,True,576355550,144088887,894054,447027,447027,3zqXX6kzhkbW3d4TwD2CNjMRwxTbREXySekvq37kfCNk,35762170,254941851,-219179681,620
2022-01-08 18:19:01.018010,2022-01-08 13:11:49-05:00,2885,EV21gv8jEvXtmGDoGRNm5LJEvTBccLMZyVDCLsp54jP3,DGxxoU52aQNoUQcxdvQtv2H5q2PhK6TGkLgNSaFgnZrb,True,8273646,2068411,12905,6452,6453,3zqXX6kzhkbW3d4TwD2CNjMRwxTbREXySekvq37kfCNk,516230,3318835,-2802605,623
2022-01-08 18:19:01.018010,2022-01-08 13:11:51-05:00,2886,GJ3PbEfPK8jjrPgMmZtvN5fMSSy2dtiiAtZ8wcfgxVuc,FCUDVFb2TjDvehHE8fVBofqSykpb9W6Afc9QeHtj7te7,True,142343061,35585765,219748,109874,109874,3zqXX6kzhkbW3d4TwD2CNjMRwxTbREXySekvq37kfCNk,8789925,73902591,-65112666,617
2022-01-08 18:19:01.018010,2022-01-08 13:11:51-05:00,2887,EQUZQWk4WLT6LFeWZs3P9AQufFcoZouFETfhyxvuS2JM,Byc2mLXArmkjQPWaxCJksHZD2XpZyCQ2FRtDJyztU81V,True,176269017,44067254,275048,137524,137524,3zqXX6kzhkbW3d4TwD2CNjMRwxTbREXySekvq37kfCNk,11001953,92500505,-81498552,624
2022-01-08 18:19:01.018010,2022-01-08 13:11:51-05:00,2888,9jdfc9GFTecsdRuTjWFGX13niKKmeBxRgtv5j86uhSnU,HLWMShobjSkaLyXrNjgwVaUGVtbtdUSnr1XjqpXn1bLR,True,543206,135801,845,422,423,3zqXX6kzhkbW3d4TwD2CNjMRwxTbREXySekvq37kfCNk,33812,232016,-198204,622
2022-01-08 18:19:01.018010,2022-01-08 13:11:52-05:00,2889,3VdSA9CED9f5swRwHX2U15U7J6Muaq8VPnCNy9CaGDHe,2YYstfnfdYic5NWmEbcUEHpccNUVd1EhuCkExvMsoMk8,True,8806011,2201502,13761,6880,6881,3zqXX6kzhkbW3d4TwD2CNjMRwxTbREXySekvq37kfCNk,550466,4875804,-4325338,625
2022-01-08 18:19:01.018010,2022-01-08 13:11:55-05:00,2890,8BMDSWFtzq9fu1ubVGtSFw8fEaMg1uvJiECuJnN8e1pd,FwkETAXL296CirvQ2AJuSHHtdKsxkZkmXSwZVVHXVDhA,True,241417304,60354326,376464,188232,188232,3zqXX6kzhkbW3d4TwD2CNjMRwxTbREXySekvq37kfCNk,15058573,90051237,-74992664,623
2022-01-08 18:19:01.018010,2022-01-08 13:11:55-05:00,2891,Ar5QB4VBcUyzSCG23z2QNAbrWY55NbHCr1MNN6P2GAmh,BusFGTiDrJmxzwGUxWz9b3SFF3eseqtgh2DRHqyAwyVe,True,857362,214340,1323,661,662,3zqXX6kzhkbW3d4TwD2CNjMRwxTbREXySekvq37kfCNk,52928,345847,-292919,617
2022-01-08 18:19:01.018010,2022-01-08 13:11:55-05:00,2892,96DzqyUxsB1FKWrhLdTdjDcokuus6rbx83gLsghqPPwt,74CWb7SVoSy3ADysEzFEeMiS2fxHJ9gdUF9pzM3E52Gj,True,35895,8973,55,27,28,3zqXX6kzhkbW3d4TwD2CNjMRwxTbREXySekvq37kfCNk,2225,13531,-11306,619
2022-01-08 18:19:01.018010,2022-01-08 13:11:55-05:00,2893,D3mXrJzhHf8qRaoCKLschUxAFoijFCFuT6bmNZH4W7Cj,9E3Xtqw7TncXWnbhAbFJMtuNmP6WS3ooGuptzyzw7UpA,True,107245,26811,166,83,83,DddJ7EWCmYEEZETCBNgAUSg81Ls6fZtiAaY5ekJ5sXx1,6644,56187,-49543,619
2022-01-08 18:19:01.018010,2022-01-08 13:11:56-05:00,2894,HutRztBianNUgm9sJDWKUQBmoVyy8y7CfnNk4hHjSkEW,EtVfvPyiy5bizbCZxR19TNUgETf3QcmziBvMtc6o5zjr,True,456955272,114238818,708393,354196,354197,3zqXX6kzhkbW3d4TwD2CNjMRwxTbREXySekvq37kfCNk,28335753,363765745,-335429992,620
2022-01-08 18:19:01.018010,2022-01-08 13:11:57-05:00,2895,A36aouot1oFLUtswuBUM4EVcis9chKaSJu53MRoPDjab,33U9gpq1RRFMGWDrWa3ezXXkwgBewdAS6QGgGVPtGvqb,True,472945368,118236342,738301,369150,369151,72FwbpFGoLEazJEdpqNtPNefsadUrimUqma9wSoy4qiS,29532058,147284611,-117752553,624
2022-01-08 18:19:01.018010,2022-01-08 13:11:59-05:00,2896,8vva9SmKpMGW8wjpkvydQczxVK6VtN79qzH2i4JQSwg4,F8a3GLicsSapt4aLURoU4qHxJaxCij4LS6JVxoMF3YHT,True,1779590,444897,2755,1377,1378,3zqXX6kzhkbW3d4TwD2CNjMRwxTbREXySekvq37kfCNk,110228,451265,-341037,619
2022-01-08 18:19:01.018010,2022-01-08 13:12:08-05:00,2897,6XHt7CrURSomkQrtVXV5JuKSZY4tQRpUyQKfCDaSTYaD,GCgcmPSDDBsn2smYbpiX3PJybDkQWtufPu4YRsbEEU8X,True,625723329,156430832,979149,489574,489575,72FwbpFGoLEazJEdpqNtPNefsadUrimUqma9wSoy4qiS,39165987,359859446,-320693459,625
2022-01-08 18:19:01.018010,2022-01-08 13:12:20-05:00,2898,Mcbzp1LhZwpfmXTv1pqe9D1jCKHw443j9QKp6tUpzgM,8uforSMAKEih5jHfHp3gCqCvaugtCmhzVfVHA63Akz7F,True,3697209,924302,5762,2881,2881,3zqXX6kzhkbW3d4TwD2CNjMRwxTbREXySekvq37kfCNk,230515,1812186,-1581671,623
2022-01-08 18:19:01.018010,2022-01-08 13:12:20-05:00,2899,KoCscQ9Q8TZHhmya5KaXBrwUEMTdCkEMRtrhvtgEmiZ,6aZ5AFMFoqf1X64RwAt1J4Yrx4WGGe2JMiEjqnQ2gEtk,True,873684,218421,1348,674,674,3zqXX6kzhkbW3d4TwD2CNjMRwxTbREXySekvq37kfCNk,53957,180273,-126316,617
2022-01-08 18:19:01.018010,2022-01-08 13:12:22-05:00,2900,7LRBswSEDBjJzQ4YurfTxLydh7tFS2jVn5V95Z6wL7ci,fD41VYGmk66MW46KKb23vAqQvUSDScgXnVdsHhJBZzu,True,218358,54589,341,170,171,3zqXX6kzhkbW3d4TwD2CNjMRwxTbREXySekvq37kfCNk,13654,99393,-85739,625
2022-01-08 18:19:01.018010,2022-01-08 13:12:22-05:00,2901,8VT2nxz5ZYDJFd9uL2XZwEXxChd9pjuMJNMAcutZubL1,EhAkiRbouzUAWtqQFsN8HEEfi46UVN8H8tyBP7CbgeLe,True,17002,4250,26,13,13,DddJ7EWCmYEEZETCBNgAUSg81Ls6fZtiAaY5ekJ5sXx1,1059,7452,-6393,622
2022-01-08 18:19:01.018010,2022-01-08 13:12:27-05:00,2902,AtKuDfcFXqWUMnRqQpjedUMTb5CQKLc2zoqEAcQpysKQ,9bPFLYp5TDZruLLDXDYYCiPYcD982iF8xt5rfTkqwNsL,True,20623,5155,31,15,16,3zqXX6kzhkbW3d4TwD2CNjMRwxTbREXySekvq37kfCNk,1276,7621,-6345,618
2022-01-08 18:19:01.018010,2022-01-08 13:12:29-05:00,2903,6WNPf4rFCX74PuyvdmzRFqbxWhguuxTQqBSdnaTVBd5D,9N7a9aiHGQsxFMgVbmWoCF9w95d12xyT7XFAwpHGkTLA,True,2790313,697578,4333,2166,2167,DddJ7EWCmYEEZETCBNgAUSg81Ls6fZtiAaY5ekJ5sXx1,173344,701783,-528439,621
2022-01-08 18:19:01.018010,2022-01-08 13:13:02-05:00,2904,FSduW743jAGyyn8HTifEJitgb89Spp5gEeMXDE59aEHF,HjojGNpR3ACtLCP2mP8DKGyXj6SeqWPKjcCAofcyQpsm,True,342064876,85516219,528662,264331,264331,3zqXX6kzhkbW3d4TwD2CNjMRwxTbREXySekvq37kfCNk,21146490,115855575,-94709085,618
2022-01-08 18:19:01.018010,2022-01-08 13:13:02-05:00,2905,CAkknoa9UFPMEZ1KWSfqtmnL7ArVNV3HRETLwecuuXP,4cHJYv3dxA6qjcuxUkGRuL7STWobGPKtoHFD4ACUbiWq,True,19384849,4846212,29978,14989,14989,3zqXX6kzhkbW3d4TwD2CNjMRwxTbREXySekvq37kfCNk,1199140,7322029,-6122889,618
2022-01-08 18:19:01.018010,2022-01-08 13:13:03-05:00,2906,8sneA6wAg6geVDJ1g7YWg4R1PfjuRVzeHp1nUBJinhZa,14i1uWtmcTjrdbg3DSr9vzd5NBnxqsn1A4QdgFBZqeYM,True,204838,51209,318,159,159,DddJ7EWCmYEEZETCBNgAUSg81Ls6fZtiAaY5ekJ5sXx1,12725,85350,-72625,621
2022-01-08 18:19:01.018010,2022-01-08 13:13:03-05:00,2907,C7a8BtMjuLXkzxZBC4Wk2gjkGBmucLmDjokf9pyA1Mu6,GxwYNWwYTtFMUxuZvNC5qrEYuJzYiEURQVuBxssfCJzr,True,2838046,709511,4410,2205,2205,3zqXX6kzhkbW3d4TwD2CNjMRwxTbREXySekvq37kfCNk,176402,713358,-536956,621
2022-01-08 18:19:01.018010,2022-01-08 13:13:04-05:00,2908,99NHcwD1iaf5FXM3UNb91SjNiiT3HwyQFQMhkGd5ASts,8syAydy52vSQQLzsLXW24BFw4VPeK66Vp3BmAbnHfgod,True,91614582,22903645,141759,70879,70880,3zqXX6kzhkbW3d4TwD2CNjMRwxTbREXySekvq37kfCNk,5670380,37256837,-31586457,618
2022-01-08 18:19:01.018010,2022-01-08 13:13:04-05:00,2909,4hrm69kAKNcfBkiP2YgtW94Pbip6FLfQAwnDRAAack69,BjbZRdGMoC7Mfoa4H19UvE2eQafgKD5rqnK7BSGwqS1s,True,62776,15694,98,49,49,DddJ7EWCmYEEZETCBNgAUSg81Ls6fZtiAaY5ekJ5sXx1,3929,24397,-20468,625
2022-01-08 18:19:01.018010,2022-01-08 13:13:07-05:00,2910,s2NgHqXLYtUrRaA6LnDwmxcS5nqfURXw47DmLy7Pn9E,2qn4QbLj5miEB2zZB4v5dhptm3JRbpQRrpTBgPDzokw1,True,3909191,977297,6021,3010,3011,DddJ7EWCmYEEZETCBNgAUSg81Ls6fZtiAaY5ekJ5sXx1,240868,2743532,-2502664,616
2022-01-08 18:19:01.018010,2022-01-08 13:13:08-05:00,2911,EanSXRkJu91FKUhPCzYxWkmM3PQUWcovEnoZXcd6vQ9E,Fg4EzAzHStoLRDPmoBUczdWnWrhAb7jKEujqAujLFT8,True,253077757,63269439,394983,197491,197492,3zqXX6kzhkbW3d4TwD2CNjMRwxTbREXySekvq37kfCNk,15799329,108955716,-93156387,624
2022-01-08 18:19:01.018010,2022-01-08 13:13:14-05:00,2912,Dc11Q7yj9HoSfndRUB8Ffaz5BcYNFnvbVWuRn8v7Zs7C,BC35JUb1znJxJhcaivpyUPt8Ydojec2ohC1TrFv7TntJ,True,322366313,80591578,503001,251500,251501,3zqXX6kzhkbW3d4TwD2CNjMRwxTbREXySekvq37kfCNk,20120051,158060537,-137940486,624
2022-01-08 18:19:01.018010,2022-01-08 13:13:14-05:00,2913,5kwvkEtRFFD84j4ntVgxkacadgJaFvQ9JLhJqzLR7Y3G,GpMMkTv9T7y8DTiizuoJUsWvnSk3GSxADjRMGyYpryxm,True,41233502,10308375,64351,32175,32176,3zqXX6kzhkbW3d4TwD2CNjMRwxTbREXySekvq37kfCNk,2574050,12323047,-9748997,624
2022-01-08 18:19:01.018010,2022-01-08 13:13:31-05:00,2914,FuoFPNTdYVDkSHaBac6UC1aNJXafSNTvFJuBCdrgQQrH,ApBS1Fx83tcECMzDV6wEzEzEdg4e2hgj3djtjRUoSKK5,True,1556451438,389112858,2364783,1182391,1182392,3zqXX6kzhkbW3d4TwD2CNjMRwxTbREXySekvq37kfCNk,94591321,591115511,-496524190,607
2022-01-08 18:19:01.018010,2022-01-08 13:13:32-05:00,2915,E5biUzKn2s5frKseCmfWriWjrYMGVtmLrhR9nYhAkVvR,BDHzqefisuGoMGcpML8t6KAC7rcErvhLcfV8KQC7oHAH,True,33070542,8267635,49973,24986,24987,3zqXX6kzhkbW3d4TwD2CNjMRwxTbREXySekvq37kfCNk,1998925,11613979,-9615054,604
2022-01-08 18:19:01.018010,2022-01-08 13:13:32-05:00,2916,DmrkajG3SrTXnYSYxGRfkzfvhkevD6RdtFk4SdLC2G6Q,5r7vkWH985E2mGSDBtznduhuu5PbZJ7d4zxjzhzEEZG1,True,40676251396,10169062848,62003890,31001945,31001945,DddJ7EWCmYEEZETCBNgAUSg81Ls6fZtiAaY5ekJ5sXx1,2480155604,20523355914,-18043200310,609
2022-01-08 18:19:01.018010,2022-01-08 13:13:37-05:00,2917,HGAFdundf5voDqeh9g7d6Q9mgMf8eEg898QMRBqwPZ6C,deanBuZXWBHEe2TGfP37S9aMBEnEgmZoyRJjAvruzfA,True,60176624,15044155,90736,45368,45368,3zqXX6kzhkbW3d4TwD2CNjMRwxTbREXySekvq37kfCNk,3629469,34216171,-30586702,603
2022-01-08 18:19:01.018010,2022-01-08 13:13:41-05:00,2918,AvwHizRhHUSahmvSg4jmTUErc7vAFSmkRAEsiKhXfW1m,3UrWYx8y9N5o9GYneSe6zyyHRTZzxwvcipQfHHYh7tEs,True,3381321,845330,5183,2591,2592,3zqXX6kzhkbW3d4TwD2CNjMRwxTbREXySekvq37kfCNk,207350,1273708,-1066358,613
2022-01-08 18:19:01.018010,2022-01-08 13:13:42-05:00,2919,5hUZ9uQFcYnjAQVVaGLJWdKyg7y1XMpoo8osQ9DeY7Xd,BdYiKWsjuzJLcHh3814mJ4xQ9JxoQKKcr7AHZ7Vxoavq,True,75040,18760,116,58,58,3zqXX6kzhkbW3d4TwD2CNjMRwxTbREXySekvq37kfCNk,4663,29725,-25062,621
2022-01-08 18:19:01.018010,2022-01-08 13:13:47-05:00,2920,8mbMH9EKd9kQDyFrYiDJCV9VaWxWCzpZBQZLyYN2yNVx,J9gT39dF1egMeQvweXYWeRAX3kpmBABijYZhfj6M2UqU,True,41590784,10397696,65016,32508,32508,3zqXX6kzhkbW3d4TwD2CNjMRwxTbREXySekvq37kfCNk,2600677,13210767,-10610090,625
2022-01-08 18:19:01.018010,2022-01-08 13:13:47-05:00,2921,Buioe5v3DyFwD9nquW5XdYeVYbSABCyg79eUHEvtvfaW,7T9gi7prCcZJkYJMSB5Ef6Bu4pAuBw4XLvumSFnqKDSi,True,1206294,301573,1884,942,942,4BnQKPLuE3DMTtxp8MjUBytgnhvxqq3ZTqZHTVZo4JJh,75363,624728,-549365,624
2022-01-08 18:19:01.018010,2022-01-08 13:13:52-05:00,2922,CFFpbRxYEP18rqEGxxyG3bzSV13Lv7nfSmZvtUK17kCP,824UwqH2JcFsqYBk9MZ8tTnpka9udTL6WGX35YFtAJQk,True,6560506,1640126,10215,5107,5108,3zqXX6kzhkbW3d4TwD2CNjMRwxTbREXySekvq37kfCNk,408624,2491760,-2083136,622
2022-01-08 18:19:01.018010,2022-01-08 13:13:54-05:00,2923,C4dbwF9mioaBkZnyBFvFs6Cqd362VuGPBGPbTY9CAnAk,CcUqBfu1hbWm5VVxbtF2Xm6HUz4CLFzuDsjUi6KtnZQg,True,3032302,758075,4738,2369,2369,3zqXX6kzhkbW3d4TwD2CNjMRwxTbREXySekvq37kfCNk,189555,757255,-567700,625
2022-01-08 18:19:01.018010,2022-01-08 13:13:55-05:00,2924,CEbGTNX6WpaoKp4RBGSn9LzYM6yAYyeiMrgVYgJxA4zb,AiXUcGAFFm4tc7vKBscSNjZawV5YJqbv7D1KpxD3Zufg,True,33735832,8433958,51314,25657,25657,HfEnetJ7uBSmZWCjBNxdvv9HEC5nsW4wDV7wu6WnhWan,2052595,17458229,-15405634,608
2022-01-08 18:19:01.018010,2022-01-08 13:14:00-05:00,2925,3zH1b58jqbNU37y9kDTZZrotSeT8XzS1tuyAHPKWrbah,4trxDWV16x6sVcz7bxHehYHkjjyKebh3S9fyJf8txzK5,True,12883,3220,19,9,10,HfEnetJ7uBSmZWCjBNxdvv9HEC5nsW4wDV7wu6WnhWan,793,4818,-4025,615
2022-01-08 18:19:01.018010,2022-01-08 13:14:01-05:00,2926,DiPSJvnnEwg1En7HJfEsKrUbBgtUf4KzGMyMCZDQSYgp,s8UVC6vPBofuXUS6RW1aQmZ8C35PrC5r4A6ugmvzLGB,True,3310799,827699,5091,2545,2546,3zqXX6kzhkbW3d4TwD2CNjMRwxTbREXySekvq37kfCNk,203655,830359,-626704,615
2022-01-08 18:19:01.018010,2022-01-08 13:14:03-05:00,2927,ECuu1L4QGdemZ7FjAjVAAxYN6piinweY7Fuk5csVovfT,Amd8WGcpdtB8yoA83R1BUT5uryuqoKbcBexYacbrbGVX,True,5195150,1298787,8110,4055,4055,DddJ7EWCmYEEZETCBNgAUSg81Ls6fZtiAaY5ekJ5sXx1,324421,1778120,-1453699,624
2022-01-08 18:19:01.018010,2022-01-08 13:14:03-05:00,2928,FhAt6pZW3k8StP9VLeWUfidpXfRLoKWdV7Wgxdh9cRy9,Guk93pTo3KcG8konHjJ52oi9rgexmmKhPQAkxZS1BtCG,True,307833013,76958251,478329,239164,239165,3zqXX6kzhkbW3d4TwD2CNjMRwxTbREXySekvq37kfCNk,19133194,133078414,-113945220,621
2022-01-08 18:19:01.018010,2022-01-08 13:14:04-05:00,2929,87R8o8xLjHw2GpunYkm7pX7uJ8hjM4B1y4Qm7aQf6Yh4,48aSVPQoFYdncF5NtJ114urbdTzVjTgYLgPzMfpJbZB3,True,108783354,27195838,168758,84379,84379,4BnQKPLuE3DMTtxp8MjUBytgnhvxqq3ZTqZHTVZo4JJh,6750342,95965988,-89215646,620
2022-01-08 18:19:01.018010,2022-01-08 13:14:04-05:00,2930,5BjBPqumCb9KC82ZNNch3dcRzbpGdRLJneru7o9a1D9R,FuZtBWKktxFu4yoiLVMzxq8fMhQyN8SGzGPz49xs3m6P,True,250777569,62694392,386832,193416,193416,3zqXX6kzhkbW3d4TwD2CNjMRwxTbREXySekvq37kfCNk,15473284,115540398,-100067114,617
2022-01-08 18:19:01.018010,2022-01-08 13:14:04-05:00,2931,EgU9hX6VK7YXeCgCHVaJAMekCcyZa2MVWdKra5pN7Gwv,7y8Ad9XY34bqREvheXHT2tr8Jy11D6X3pu7yLVtjU4QV,True,16859399,4214849,25904,12952,12952,DddJ7EWCmYEEZETCBNgAUSg81Ls6fZtiAaY5ekJ5sXx1,1036180,7776139,-6739959,614
2022-01-08 18:19:01.018010,2022-01-08 13:14:04-05:00,2932,4FazDUgfQ3AKoFcnWHr8E9Ht8jLA3tkxf75yrGZVHdmF,HzRMH6mbgEKydRCnnMvSsKgTEVNQi6nuzoR1xutYFdzg,True,104334,26083,161,80,81,3zqXX6kzhkbW3d4TwD2CNjMRwxTbREXySekvq37kfCNk,6468,70952,-64484,619
2022-01-08 18:19:01.018010,2022-01-08 13:14:04-05:00,2933,9gYrMXAGmGSV4VFjXzYP5WwH2aFpB1TxA6CqpYsosKLv,Dh8aH6RK48wu4fkT9xKw5XL7itxnPDuw3SDwPwvL5sva,True,45072,11268,69,34,35,3zqXX6kzhkbW3d4TwD2CNjMRwxTbREXySekvq37kfCNk,2793,17184,-14391,619
2022-01-08 18:19:01.018010,2022-01-08 13:14:04-05:00,2934,7MSzV5yy5FmrM4j1BcYSRiTGWfit1AJahheRUaXzz349,aPSTZLxBpVr3sucjbj95emRV2J1GrUWr7wbARYqJkQZ,True,7579027,1894756,11753,5876,5877,3zqXX6kzhkbW3d4TwD2CNjMRwxTbREXySekvq37kfCNk,470126,2395952,-1925826,620
2022-01-08 18:19:01.018010,2022-01-08 13:14:04-05:00,2935,3g1debT8Z2efQPuMNSDPUNZzDqarBG2acErsZ4HP7QGA,42wDHagxr5Nno3mUx6kyYGDjwR98aedRbh3ByB468agB,True,32195,8048,49,24,25,DddJ7EWCmYEEZETCBNgAUSg81Ls6fZtiAaY5ekJ5sXx1,1996,12344,-10348,619
2022-01-08 18:19:01.018010,2022-01-08 13:14:04-05:00,2936,93ho4cgnpAJiJsG6uu2udkLVNU7rkz4QjCYfsqvpbPA5,45ouQn9gGwXqnTGfaP5CvU8fCKadBRA5kPwtfvJzykRU,True,107995903,26998975,167503,83751,83752,3zqXX6kzhkbW3d4TwD2CNjMRwxTbREXySekvq37kfCNk,6700159,35329518,-28629359,620
2022-01-08 18:19:01.018010,2022-01-08 13:14:04-05:00,2937,E9FFPvygPSF22u7gqFq4w6yE5kV15zbeGDXFQc349RsG,yi1REPVUwKhr5ss5YJc56crYz8LVfkqNVMpKcdSfwfY,True,2843155,710788,4425,2212,2213,3zqXX6kzhkbW3d4TwD2CNjMRwxTbREXySekvq37kfCNk,177019,708866,-531847,622
2022-01-08 18:19:01.018010,2022-01-08 13:14:04-05:00,2938,FjDp4bWCtqehFD7FunCrjrcdxMezTJj5aqh2VnBvHDQU,HRYeZqcqhP1RPiAGXziR1qCWwk4sF6c5ZYbvSDhX7foN,True,13650246,3412561,20917,10458,10459,3zqXX6kzhkbW3d4TwD2CNjMRwxTbREXySekvq37kfCNk,836719,4982589,-4145870,612
2022-01-08 18:19:01.018010,2022-01-08 13:14:05-05:00,2939,ZoNjrSjYh4NJLW38LUPcf7jtEBxdaaM7T1zp795qjHE,FZx6v8cU25NwEosbKJ2n141o9uFAWURZB7NeCeX1trEn,True,2599752,649938,3958,1979,1979,DddJ7EWCmYEEZETCBNgAUSg81Ls6fZtiAaY5ekJ5sXx1,158336,652336,-494000,609
2022-01-08 18:19:01.018010,2022-01-08 13:14:05-05:00,2940,EEcTbsFTUEifcdbPyjBLkS943daEx1RpR8F3uZxKRZbT,8V3JzDQ1VWYQLas8fxUsWJZZHe4gEmn74RehtUwLw3k5,True,9109876,2277469,13980,6990,6990,3zqXX6kzhkbW3d4TwD2CNjMRwxTbREXySekvq37kfCNk,559206,4168244,-3609038,613
2022-01-08 18:19:01.018010,2022-01-08 13:14:05-05:00,2941,2ce2v2TCbjNH635NgbwTG3sqiRWYrRRaBpxPxBZJ929q,9cnoebT43FkWDFhidndGCVNiFD4NErv8DuL1Va4Jv9S8,True,10240902,2560225,15822,7911,7911,4BnQKPLuE3DMTtxp8MjUBytgnhvxqq3ZTqZHTVZo4JJh,632901,7455346,-6822445,618
2022-01-08 18:19:01.018010,2022-01-08 13:14:06-05:00,2942,6d6HN8LWikwW2HYdy3BABWuxKHt1sgv4DcneACR133sE,4eKvzmfFvX96XbujKBhUauAvWP4yQYwZH3pd7gXzbCvJ,True,2840134,710033,4444,2222,2222,4BnQKPLuE3DMTtxp8MjUBytgnhvxqq3ZTqZHTVZo4JJh,177760,712629,-534869,625
2022-01-08 18:19:01.018010,2022-01-08 13:14:06-05:00,2943,H6tDNj9cHac223ckAnNfnC4bAJuNLBnf2pFk2iQdMzMP,28UL9dqgayCqCAexScXjdpobYGVDN44SGBVNAfBByk8C,True,113874543,28468635,176487,88243,88244,3zqXX6kzhkbW3d4TwD2CNjMRwxTbREXySekvq37kfCNk,7059481,59925656,-52866175,619
2022-01-08 18:19:01.018010,2022-01-08 13:14:08-05:00,2944,DiB9SeCFXjioNGPJM3GuZ3FCG9KBZhHK27zCSN5b6gkq,GtK8UtKDQy9jgtTXvam4jja9N7c4EFuDQr4TKHgNyhXT,True,7476298,1869074,11437,5718,5719,3zqXX6kzhkbW3d4TwD2CNjMRwxTbREXySekvq37kfCNk,457503,3183006,-2725503,611
2022-01-08 18:19:01.018010,2022-01-08 13:14:28-05:00,2945,F9s8a7Cpiw5dw3a2aNFMofqwyDWNXvDLnSdJzoj1gRiV,GpKsQKJD79KBRWdCTkyi4zX7NaoCWsLUjrKxAwJB6o6s,True,27509129,6877282,42903,21451,21452,4BnQKPLuE3DMTtxp8MjUBytgnhvxqq3ZTqZHTVZo4JJh,1716146,6395690,-4679544,623
2022-01-08 18:19:01.018010,2022-01-08 13:14:29-05:00,2946,GjQQ2fQ7mrGjWZwjVYFUKp9NM1LmfkhEo675ovU5SPa8,ECgVUMRY5nB4MALs5drDyipF7YohCPuJpj2UegCs7HMn,True,20815194,5203798,32325,16162,16163,4BnQKPLuE3DMTtxp8MjUBytgnhvxqq3ZTqZHTVZo4JJh,1293032,8999772,-7706740,621
2022-01-08 18:19:01.018010,2022-01-08 13:14:39-05:00,2947,46TNhGwBVzedW8xSb9UY94HNeSom9iGiZzAjrKHiRM2G,7JVTiqNYeKHbyzRkKtvSEpqLPKykZso8cGUr3sX1j7QF,True,55099649,13774911,85813,42906,42907,3zqXX6kzhkbW3d4TwD2CNjMRwxTbREXySekvq37kfCNk,3432526,21482995,-18050469,622
2022-01-08 18:58:41.080137,2022-01-08 13:55:59-05:00,2948,BJaaH1SK1pF2kZQzmYpLFfDtm52CR9a5rd39RAPtLe8q,HUsT5FVxaisdnCvG1BQxX6zffjfL2Rwx5mMo5y8SDV7e,True,68566441,17141609,107122,53561,53561,3zqXX6kzhkbW3d4TwD2CNjMRwxTbREXySekvq37kfCNk,4284882,18711588,-14426706,624
2022-01-08 18:58:41.080137,2022-01-08 13:56:15-05:00,2949,8aKqLY7GXxNnGRK8Utke7o6EDGZATNDDF8Ph9Q27ppyi,7MQKkebLEzQgjWjByBMzzkn68yqtYivS4VDcraAScZR6,True,1845998,461497,2885,1442,1443,DddJ7EWCmYEEZETCBNgAUSg81Ls6fZtiAaY5ekJ5sXx1,115437,495762,-380325,625
2022-01-08 19:11:17.578059,2022-01-08 13:59:24-05:00,2950,243SAnGxchCVB1LQAUF4SsozR86yDwEdg2QQpbWGsMYe,5u8sNkb2oEQjUXJAB3yGStmv3Uwz16gBgExBo5myVK4b,True,18536818,4634204,28346,14173,14173,HfEnetJ7uBSmZWCjBNxdvv9HEC5nsW4wDV7wu6WnhWan,1133868,6334212,-5200344,611
2022-01-08 19:11:17.578059,2022-01-08 13:59:24-05:00,2951,aTkGURJptmKNNP6RSXSWsmVbfcriSAJaMuUiT2eZEfb,5qoGxL83PLhrguyk27X8xE6jGitRg5BaQpXzrcfEvCfJ,True,358452480,89613120,546662,273331,273331,DddJ7EWCmYEEZETCBNgAUSg81Ls6fZtiAaY5ekJ5sXx1,21866493,116761923,-94895430,610
2022-01-08 19:11:17.578059,2022-01-08 14:00:57-05:00,2952,GXSysysoV8Z4xBrQsaKUsSrpoWeTTUsbFmgfZDaQu4ZM,6FJyraiLgG3tb9B7pi4YFsJNtRVBNaghnm1ajzneVv7b,True,845149615,211287403,1296868,648434,648434,72FwbpFGoLEazJEdpqNtPNefsadUrimUqma9wSoy4qiS,51874722,265644254,-213769532,613
2022-01-08 19:11:17.578059,2022-01-08 14:02:40-05:00,2953,HwosLQgDY1xtHQRQ4hzroPQHFWssPzTj5vRkP37FcviB,HKTNEYNXrephNkH7apbobK4mcQXcNayQA4W1NgM6sLr8,True,59209462,14802365,91547,45773,45774,GAUsoe8ZTCiGPm2hYxRPGxcPe5ShNzHK9eE3G2zgRjxd,3661891,18173773,-14511882,618
2022-01-08 19:28:42.459993,2022-01-08 14:21:50-05:00,2954,5Rxuqgs4CaSKbfDXqBMFXkLTQ9dxrUjThXzoy3ouYVtK,BgvbKru66ebrGUcFFymGTmsaQv6GgcGMybiWaXqzBtwX,True,271500,67875,423,211,212,HfEnetJ7uBSmZWCjBNxdvv9HEC5nsW4wDV7wu6WnhWan,16952,159005,-142053,624
2022-01-08 19:28:42.459993,2022-01-08 14:22:25-05:00,2955,3ogBPSRcKfmwzgumVDHBkXLi1eCsEFG2xzSJgD4LQDNy,7TXyqWgJqfe71MSWFA2n7ufZbUdzf7JJoWej8FNNtMXo,True,27505168,6876292,42836,21418,21418,HfEnetJ7uBSmZWCjBNxdvv9HEC5nsW4wDV7wu6WnhWan,1713463,10194640,-8481177,622
2022-01-08 19:28:42.459993,2022-01-08 14:22:27-05:00,2956,5BJnMHFSiQjHRGFJDW1jnqCfkHHYWnQzmmccy9eA4jNj,9517JGYsPmvgPUM9pFRD2vipHmdgE578F7jA7Qq6jorm,True,683072666,170768166,1067444,533722,533722,3zqXX6kzhkbW3d4TwD2CNjMRwxTbREXySekvq37kfCNk,42697798,276103711,-233405913,625
2022-01-08 19:49:04.269649,2022-01-08 14:42:33-05:00,2957,GxFxvEUdWofneMmVvhCSScH9V6Zia5WJ2J9q6CpPnaq3,ATLykiHDii3Lw53MoZXwqu1FbBNPJbVNVGe2SoQMjVmY,True,4174911,1043727,6388,3194,3194,3zqXX6kzhkbW3d4TwD2CNjMRwxTbREXySekvq37kfCNk,255527,2086078,-1830551,612
2022-01-08 19:55:51.900674,2022-01-08 14:47:10-05:00,2958,7W6ih2ZGXaE6tvuQFUPCvc7NvEJHy7UffgoVX3ZPdLXt,6uQCkeMjEXHBQxE2HD33RM1zyTsSko1fYZA1mWUggJ5B,True,43734,10933,68,34,34,GAUsoe8ZTCiGPm2hYxRPGxcPe5ShNzHK9eE3G2zgRjxd,2736,17340,-14604,625
2022-01-08 19:55:51.900674,2022-01-08 14:47:44-05:00,2959,BPRoaqrDs8vhqv2T7d9qV2oPU33pi1K1LUaotM7yuD2i,6qo8uQGAEwBfYQR36v6nRiqA2xGV6SjJAsXsdzy5bqNH,True,1761878855,440469713,2755012,1377506,1377506,GAUsoe8ZTCiGPm2hYxRPGxcPe5ShNzHK9eE3G2zgRjxd,110200497,748321642,-638121145,625
2022-01-08 19:55:51.900674,2022-01-08 14:47:51-05:00,2960,9LZ3rShLfzErXsGkh4dYfAm58GNPWhK6ohDy5RrLJhc,41tLyuvuJ5M7YctkSASD2R7RGGetD7FmKaZUdkTdgXgt,True,2461242,615310,3850,1925,1925,GAUsoe8ZTCiGPm2hYxRPGxcPe5ShNzHK9eE3G2zgRjxd,154004,617764,-463760,625
2022-01-08 19:55:51.900674,2022-01-08 14:47:51-05:00,2961,7g4NJBHwDTRm58GqX7Tz1JzqwbAhF6EWJUQH3SoDxSf7,82Ypv7STZeSCBPf3HckWdyatELpvaDaWxFXhD5dNSML4,True,39566,9891,61,30,31,GAUsoe8ZTCiGPm2hYxRPGxcPe5ShNzHK9eE3G2zgRjxd,2476,15240,-12764,625
2022-01-08 20:27:40.095548,2022-01-08 15:18:48-05:00,2962,A1j2G5FZRyWSjFt6dK87WHhLkQrPUVqHaM3KhSzhAKDT,2fMiHLYm4pL3YCd8aveTR4mT9uVxztQeMwb5eRZb4wUW,True,913702,228425,1428,714,714,4BnQKPLuE3DMTtxp8MjUBytgnhvxqq3ZTqZHTVZo4JJh,57141,408939,-351798,625
2022-01-08 20:27:40.095548,2022-01-08 15:19:07-05:00,2963,8xvLGVeDmhVYQhN2ZpWkVG9jCrukRsNQ4926a4TMiZqa,9ciBySSjvADwp47WkETiFWZKVTFL8Hf1XvK7aSxhcgQS,True,32523304,8130826,50889,25444,25445,DddJ7EWCmYEEZETCBNgAUSg81Ls6fZtiAaY5ekJ5sXx1,2035599,13206124,-11170525,625
2022-01-10 13:35:42.577904,2022-01-10 08:17:38-05:00,2964,4k95B2HfiTXT8fDtW4286MoEPj6UdPiQd5BjFadjs8Pv,GmhpDUb5A14X8xRZHRnbrYEr3xJh9zJA7eqoCzwboDTW,True,1605311931,401327982,2497874,1248937,1248937,HfEnetJ7uBSmZWCjBNxdvv9HEC5nsW4wDV7wu6WnhWan,99914963,338323032,-238408069,622
2022-01-10 13:35:42.577904,2022-01-10 08:17:39-05:00,2965,C33hfnDHzVwKXxr6AwFAXhd1vJYrPKhtqc75Qpjm19Zt,2WYBMSyrHQEYZqxEtxBMe2xn7eioJEGsudqdCmGvssGh,True,84551056,21137764,131515,65757,65758,DddJ7EWCmYEEZETCBNgAUSg81Ls6fZtiAaY5ekJ5sXx1,5260607,15699956,-10439349,622
2022-01-10 13:35:42.577904,2022-01-10 08:17:39-05:00,2966,GKCeRcHQYMhcTwEm5wu1SbkXAT19gjGUGji43HS36B5N,EYQKX5sWsmXoge5xbTcMYAjvRbSUTXXpHEzckPY2LV8W,True,3166633,791658,4948,2474,2474,DddJ7EWCmYEEZETCBNgAUSg81Ls6fZtiAaY5ekJ5sXx1,197937,780925,-582988,625
2022-01-10 13:35:42.577904,2022-01-10 08:25:44-05:00,2967,Gbxc51WERLLeCtiHv7rDvE52aqF541RoQWG5n5aqErq6,4ngBoHbfXijLMqGKxFMNht9sbmxy2g5eqBmn8QsBmbx1,True,1755993,438998,2739,1369,1370,DddJ7EWCmYEEZETCBNgAUSg81Ls6fZtiAaY5ekJ5sXx1,109587,720176,-610589,624
2022-01-10 13:35:42.577904,2022-01-10 08:26:44-05:00,2968,CbhrZUdan1axNDFUrX1ZuEohfNMEGrszKSkk6pppVQuw,DHEAjJNtuEePezYAv77thWabbVxxqQpfuiC6moRSrpG1,True,121025867,30256466,188736,94368,94368,DddJ7EWCmYEEZETCBNgAUSg81Ls6fZtiAaY5ekJ5sXx1,7549458,66506779,-58957321,623
2022-01-10 13:35:42.577904,2022-01-10 08:35:38-05:00,2969,G25vsB3sDqRhHoSK4KwR1TywfrJDtpejVbbevEG9sQ9a,5xFC3Hm13magnAA9GD1EnwC9PrPoEfQ7omEa9p9zCrB1,True,2920090,730022,4526,2263,2263,3zqXX6kzhkbW3d4TwD2CNjMRwxTbREXySekvq37kfCNk,181045,1063124,-882079,619
2022-01-10 13:46:58.288258,2022-01-10 08:36:01-05:00,2970,7iUx7JBwqUvPVPeCqMEXQdLccZJmaFYm1DUQiu3ouHa3,3EVZzhRmJnX9ZiBZZo9tenDtMogAyuA1yf2cKzvUWiuu,True,1987311,496827,3102,1551,1551,HfEnetJ7uBSmZWCjBNxdvv9HEC5nsW4wDV7wu6WnhWan,124093,831137,-707044,624
2022-01-10 13:46:58.288258,2022-01-10 08:45:46-05:00,2971,Dn916KSmX3HqxT53hrxrbCrV3tdRMCPdaoiRLqetMrth,ATCXRiXgnjRRUbSTPBvtBXMENCqsViexSZbZ6aDaXXWA,True,2219556,554888,3456,1728,1728,DddJ7EWCmYEEZETCBNgAUSg81Ls6fZtiAaY5ekJ5sXx1,138279,920359,-782080,623
2022-01-10 13:46:58.288258,2022-01-10 08:46:33-05:00,2972,D58t4uTjFumsUeYFaKnpV8BRTEQEqKXBreFTdwGrott7,67p6kHDfVqQijfcwugvZK59c3aRRH9x3eHxruqH8WEqF,True,1750324,437580,2725,1362,1363,3zqXX6kzhkbW3d4TwD2CNjMRwxTbREXySekvq37kfCNk,109031,716978,-607947,622
2022-01-10 13:46:58.288258,2022-01-10 08:46:34-05:00,2973,7jvKp6onXyWgwsFrFWj4hYTXJsYYD6ot5mn6rPFuJriy,J7N6HiozevJVTiY9hDEUs2ud5BwT5QSE7wnMBS1w5ie2,True,75504463,18876115,118043,59021,59022,4BnQKPLuE3DMTtxp8MjUBytgnhvxqq3ZTqZHTVZo4JJh,4721736,36142985,-31421249,625
2022-01-10 13:46:58.288258,2022-01-10 08:46:44-05:00,2974,DDsY5V3F9wnEGBoQFCEf1hvEYuKUaJdysbc7TxhNqe9G,5oBCGzvy8odB8MCxCUvPDqYCnTyteZ4Yy1JDroroygbi,True,95685771,23921442,148027,74013,74014,HfEnetJ7uBSmZWCjBNxdvv9HEC5nsW4wDV7wu6WnhWan,5921103,22651472,-16730369,618
2022-01-10 13:46:58.288258,2022-01-10 08:46:44-05:00,2975,8Xt3qHjZG3zLxozgM5vPHMVxp8eYFMg89kaVW7vdHKoA,2i8riSsQpfADD9LUVpiBJBfX5qjVAgmZegzfKx6RG9dW,True,72750779,18187694,112543,56271,56272,3zqXX6kzhkbW3d4TwD2CNjMRwxTbREXySekvq37kfCNk,4501751,22330316,-17828565,618
2022-01-10 13:59:49.126224,2022-01-10 08:54:40-05:00,2976,2mfcg17QocKKvDcqDH88TwxHRiS8dAQiJAGoAh1brns9,8aQLELBgaA9eXsxSciMjxWv8B1hpbUPfLwqVjEnasZbe,True,212704667,53176166,332550,166275,166275,4BnQKPLuE3DMTtxp8MjUBytgnhvxqq3ZTqZHTVZo4JJh,13302007,53699518,-40397511,625
2022-01-10 13:59:49.126224,2022-01-10 08:54:42-05:00,2977,8trFFwvXKKMwMx952ugCZmqyw29e1HxEKBuQmFn8ZwTf,FsD7gCvHXM3QchQiDcd292ksy5afZMWApneNTat5ndeS,True,388150188,97037547,604081,302040,302041,DddJ7EWCmYEEZETCBNgAUSg81Ls6fZtiAaY5ekJ5sXx1,24163259,83673971,-59510712,622
2022-01-10 13:59:49.126224,2022-01-10 08:54:42-05:00,2978,B9WJfmrYEkVH3L1UWz4qqWpaexHydymbzvEfwNVtB9BV,6mQb4yzGq8jE1NbweKCKSbevnnYVhHYxyc6Gz2a5kJLn,True,435270357,108817589,670850,335425,335425,DddJ7EWCmYEEZETCBNgAUSg81Ls6fZtiAaY5ekJ5sXx1,26834011,94421254,-67587243,616
2022-01-10 13:59:49.126224,2022-01-10 08:54:57-05:00,2979,Gs3WP18hbzNpbBgiU39e6tfkggfCKRyNqPqJQcthuHFD,4XAY25YUma6gUdG2GdbXeivum3t21g93ZagfWGTZYkWZ,True,17103445,4275861,26697,13348,13349,DddJ7EWCmYEEZETCBNgAUSg81Ls6fZtiAaY5ekJ5sXx1,1067887,7974006,-6906119,624
2022-01-10 14:20:10.725089,2022-01-10 09:05:00-05:00,2980,8trkirSQNdMmAcJdeswxs5cPjH8dD6U4eJtWiAdMsrDB,HaSzpQ45x2MipfN17U6jGBxX8tXboomVDhXNSrnEfLDr,True,5845439,1461359,9121,4560,4561,DddJ7EWCmYEEZETCBNgAUSg81Ls6fZtiAaY5ekJ5sXx1,364855,2289105,-1924250,624
2022-01-10 14:20:10.725089,2022-01-10 09:07:48-05:00,2981,H3x9b27yHVdCxvtDf7mmJxkNeubcmQMwfAkLTYADPWNv,HGVCCz23rWx78vrTB2wvm2aesbLZuYFhhNuznGiSSAyA,True,4343950754,1085987688,6795510,3397755,3397755,DddJ7EWCmYEEZETCBNgAUSg81Ls6fZtiAaY5ekJ5sXx1,271820407,929098182,-657277775,625
2022-01-10 14:20:10.725089,2022-01-10 09:07:48-05:00,2982,2jDRvE3pQNjWy1NRFa4tzB3KmU5UkbUCHw8sQRFujo66,C4zNi2szDrEEh4coTF3WRUghfP4ZwAVVSYTLWfkejQRu,True,846731830,211682957,1324666,662333,662333,3zqXX6kzhkbW3d4TwD2CNjMRwxTbREXySekvq37kfCNk,52986664,285813889,-232827225,625
2022-01-10 14:20:10.725089,2022-01-10 09:08:16-05:00,2983,HdfQweV1KuYSpWdycZbpGrUc8yMcY3ZczLn1agKXMJaf,G1Ae1PZHkANkwFnhUKS1tvdFEv8dAFeojBkezh6rUNMh,True,9457146,2364286,14743,7371,7372,DddJ7EWCmYEEZETCBNgAUSg81Ls6fZtiAaY5ekJ5sXx1,589749,4285579,-3695830,623
2022-01-10 14:20:10.725089,2022-01-10 09:08:21-05:00,2984,2VyFcgZDH1HTEvD1XaWhwqBCMmZ1k6TmZ3fEpPcBZR9E,G1wFJETTpdoc7CfypGCzkq1jssXPfUkiuLjK2cwVZ9dJ,True,136626,34156,210,105,105,4BnQKPLuE3DMTtxp8MjUBytgnhvxqq3ZTqZHTVZo4JJh,8436,64646,-56210,617
2022-01-10 14:20:10.725089,2022-01-10 09:08:21-05:00,2985,BxXXWywnC3dSyLPJHt7owfBhgSiBWzkuD3T8hGYLqCH6,4vuwEBXXbXFMPmbJJJRop4FCWGyKR1sXhBc3EWF6MiB8,True,162429660,40607415,250976,125488,125488,4BnQKPLuE3DMTtxp8MjUBytgnhvxqq3ZTqZHTVZo4JJh,10039077,85087474,-75048397,618
2022-01-10 14:20:10.725089,2022-01-10 09:08:21-05:00,2986,2bikYf33ZxxDmvkMNjWDGGqEpbYJPvWv5At3hzyeLEQK,5FtirUBjRAZ3k5arFFVwKz42ixWzhkEBLkaK9PraRZ78,True,249924,62481,386,193,193,DddJ7EWCmYEEZETCBNgAUSg81Ls6fZtiAaY5ekJ5sXx1,15473,78795,-63322,619
2022-01-10 14:20:10.725089,2022-01-10 09:08:21-05:00,2987,HhwiZPKZBGa16oVi739s4qtMDMTwzWXc7iwNfX63t2UP,5AnbMbAFKy85yHt5y2M5S38nNkA1vT4ejY5NjGbRNUqn,True,2360958,590239,3656,1828,1828,DddJ7EWCmYEEZETCBNgAUSg81Ls6fZtiAaY5ekJ5sXx1,146264,1348570,-1202306,619
2022-01-10 14:20:10.725089,2022-01-10 09:08:21-05:00,2988,FLTW9fwjWqGPm5PiE3C9LFzwZxtDh8c2MnEoRq8W7MfQ,GKsfzKBP2QkmoEWvTaUN1h4nqrT3kAcwYRC9WxW9bB3h,True,21033247,5258311,32412,16206,16206,4BnQKPLuE3DMTtxp8MjUBytgnhvxqq3ZTqZHTVZo4JJh,1296484,6627245,-5330761,616
2022-01-10 14:20:10.725089,2022-01-10 09:08:24-05:00,2989,4kbcrzH6o2LvLUCNphyL52i8uGzVD8wcUNEqoQ14z3VG,5Q1atmEBs2AqaDZsiZFG5stHzj1fE6ZvypgfkEc9LYqE,True,303953276,75988319,468779,234389,234390,4BnQKPLuE3DMTtxp8MjUBytgnhvxqq3ZTqZHTVZo4JJh,18751167,157032742,-138281575,616
2022-01-10 14:20:10.725089,2022-01-10 09:08:24-05:00,2990,CCHzYXr5zMXFu8MMZNkfUWGyUcF8xy7Vvhq7tNCtZg2L,AuEXkCJTTJ3HK8iP4qTWpQr4vp6HPRJZyZwfRjF8zjfp,True,249734,62433,384,192,192,3zqXX6kzhkbW3d4TwD2CNjMRwxTbREXySekvq37kfCNk,15365,78876,-63511,615
2022-01-10 14:20:10.725089,2022-01-10 09:08:26-05:00,2991,921FBgLS3A1wA77uWitsnTvW737Q2jY7tzvgWtWLXNC7,E4eJ9H7cqP9zNpMH5xRBTAp9yaBCBihuJBNd6pqzteDG,True,249735,62433,384,192,192,DddJ7EWCmYEEZETCBNgAUSg81Ls6fZtiAaY5ekJ5sXx1,15363,78874,-63511,615
2022-01-10 14:20:10.725089,2022-01-10 09:08:26-05:00,2992,AGhvB6x3gmvAJSnr9UVtvhKqVg3Qgh1k4roHzrNHhAaa,HhhjXT6WJnz1HQfHcwKdBppuAhc8ncUcq1mkJ4EHqgpe,True,10764,2691,16,8,8,4BnQKPLuE3DMTtxp8MjUBytgnhvxqq3ZTqZHTVZo4JJh,668,4248,-3580,620
2022-01-10 14:20:10.725089,2022-01-10 09:08:26-05:00,2993,GH6Q9E1jZPTTp46aDd57UNZPNS2D6PBSwyLL3EHSjGn2,2XvwZXNsrPWx4EfPvhTP933bzCC3SJHDQ8xARfrXdVY9,True,33649323,8412330,52297,26148,26149,4BnQKPLuE3DMTtxp8MjUBytgnhvxqq3ZTqZHTVZo4JJh,2091918,27042493,-24950575,621
2022-01-10 14:20:10.725089,2022-01-10 09:08:26-05:00,2994,3Xbsek5MsEGoWr3G9yhuohREr26B2vSQcjqXdspTFHta,2rPxkUiMo9wGDq8EvAiwY3ngRpKmL223cBWWNTYoBmFp,True,405281648,101320412,623672,311836,311836,DddJ7EWCmYEEZETCBNgAUSg81Ls6fZtiAaY5ekJ5sXx1,24946884,132110494,-107163610,615
2022-01-10 14:20:10.725089,2022-01-10 09:08:27-05:00,2995,DJiXXW7sjNsAAxWupDKBUsFhXSgPoerVYaAtJqqNgVbn,2MsqvNuJw1xQhJ3UnXt9i7oNHDuZpR9w7iE1WQcGqt5m,True,249732,62433,383,191,192,DddJ7EWCmYEEZETCBNgAUSg81Ls6fZtiAaY5ekJ5sXx1,15354,78867,-63513,614
2022-01-10 14:20:10.725089,2022-01-10 09:08:30-05:00,2996,4D7mDXe7SdmbAx7kaD1mBNuEa7DzMi6TAwXURxtLEazk,5pSnT91PHoLdN6uhPnUtoD7cboLmndn26y1XouPx8vwW,True,2527507,631876,3941,1970,1971,3zqXX6kzhkbW3d4TwD2CNjMRwxTbREXySekvq37kfCNk,157663,793590,-635927,623
2022-01-10 14:20:10.725089,2022-01-10 09:08:31-05:00,2997,AA9zFZTXqBR8Mw1fwEH59edzBiswoGasRNWsi6aLeysB,4VeitxYqqtRxyfdSVpshdJ3EDcgksRVnaHvAqWxTeujH,True,2897760,724440,4511,2255,2256,DddJ7EWCmYEEZETCBNgAUSg81Ls6fZtiAaY5ekJ5sXx1,180441,713933,-533492,622
2022-01-10 14:20:10.725089,2022-01-10 09:08:36-05:00,2998,36ByQojnxEckWdQTjqHfxKqCx9yjqWQsPsZyqaN72UWR,AZoirtS1fjX61agRM64tqThVinnJTh3BWgiHyNHPTgZP,True,1047440,261859,1635,817,818,4BnQKPLuE3DMTtxp8MjUBytgnhvxqq3ZTqZHTVZo4JJh,65411,566973,-501562,624
2022-01-10 14:20:10.725089,2022-01-10 09:08:37-05:00,2999,5RvNKzSeJ1fvqsKpcQu25evEZGmKjyEDgwsMZkykoT3P,BRqSGfE4XHXu4HrinwetWumfVTmr82iuF6Y5oSV6eMiK,True,249828,62457,389,194,195,DddJ7EWCmYEEZETCBNgAUSg81Ls6fZtiAaY5ekJ5sXx1,15577,78995,-63418,623
2022-01-10 14:20:10.725089,2022-01-10 09:08:39-05:00,3000,6dr65yANjSMmfBeKAuSxG3i16S9vMgF1CQ3zDyzh55Pn,EhrE5QpnshD41S4zPEBy2A5q2Gs2mwUrbHGo6WnT9zDP,True,569758,142439,889,444,445,DddJ7EWCmYEEZETCBNgAUSg81Ls6fZtiAaY5ekJ5sXx1,35596,266746,-231150,624
2022-01-10 14:20:10.725089,2022-01-10 09:08:40-05:00,3001,Ayx8dFsVzUBb9b7QKxw7YHJuhptdSitBXFEczXTaxe85,EvU1VLChnowi6ccSPeJRSk65njrqZfYouAN7SHePxsxf,True,39839,9959,62,31,31,DddJ7EWCmYEEZETCBNgAUSg81Ls6fZtiAaY5ekJ5sXx1,2490,18698,-16208,625
2022-01-10 14:20:10.725089,2022-01-10 09:08:40-05:00,3002,5jin5wXjQQ25nGM2ECrCXcg1a95vquh6kM7rMRru6Ke7,EKM657EQ8HWWgf4cssByoYHoXGjFfTspTKXAGmygAPQG,True,64049605,16012401,99646,49823,49823,3zqXX6kzhkbW3d4TwD2CNjMRwxTbREXySekvq37kfCNk,3985852,29187738,-25201886,622
2022-01-10 14:20:10.725089,2022-01-10 09:08:43-05:00,3003,ES1MDwRUa3hoToPKQiiZkzMYe9PDVnAQwMrEvZrzvnc1,C4wBG3xTDkmDQneB28xYnf1aBNEeq7UB8oR7NuEfLkFg,True,46888674,11722168,73050,36525,36525,4BnQKPLuE3DMTtxp8MjUBytgnhvxqq3ZTqZHTVZo4JJh,2922012,14695271,-11773259,623
2022-01-10 14:20:10.725089,2022-01-10 09:08:43-05:00,3004,GGGyesjbt7h2XHHp9u8vpiWGugFwEbrtYaKrNQSDhQd7,8tydo1ZjGHmPBSqU33tywB3f9szdsHk1ckGFe4Ay5pgs,True,85965716,21491429,134175,67087,67088,4BnQKPLuE3DMTtxp8MjUBytgnhvxqq3ZTqZHTVZo4JJh,5367022,61249329,-55882307,624
2022-01-10 14:20:10.725089,2022-01-10 09:08:52-05:00,3005,6u6bPgAmK8ufACrQV99A1Y5nhGkue3KEUHmQQkcNkxwP,7636yXT5w4DcVpc7LJdN46aiggzSq6U2GXHXL5kyy9F3,True,201978918,50494729,316027,158013,158014,4BnQKPLuE3DMTtxp8MjUBytgnhvxqq3ZTqZHTVZo4JJh,12641106,91824889,-79183783,625
2022-01-10 14:20:10.725089,2022-01-10 09:09:09-05:00,3006,3Lv2XpiD4KBUHq7Zx6u3zNhpXoySodXHH8o8f5yaaPxG,H6TN4rhpBXkEH3mZnymYNcKfmnxRH2uzfwzeLH2q6ahP,True,317980,79495,497,248,249,DddJ7EWCmYEEZETCBNgAUSg81Ls6fZtiAaY5ekJ5sXx1,19895,127018,-107123,625
2022-01-10 14:20:10.725089,2022-01-10 09:09:10-05:00,3007,2QStaRnbSnDhA891Lb1bxjVeMYpJUpNdqaVkw3rqU45V,DakRWPnttPoRcjY5V7WLwiwBx39BapCo9Atog8dL17Ku,True,3855464,963866,6031,3015,3016,4BnQKPLuE3DMTtxp8MjUBytgnhvxqq3ZTqZHTVZo4JJh,241249,1131883,-890634,625
2022-01-10 14:20:10.725089,2022-01-10 09:09:11-05:00,3008,6CeKxTJvFqhyNEyzySiBBKEwYVMe7j3A6nkMes4BW6o2,DzDR9XvwY1z7ygQ8YrCXrwDGHSf67JZF8BzUnuFE2fxQ,True,7452133,1863033,11661,5830,5831,DddJ7EWCmYEEZETCBNgAUSg81Ls6fZtiAaY5ekJ5sXx1,466463,2504157,-2037694,625
2022-01-10 14:20:10.725089,2022-01-10 09:09:38-05:00,3009,3njiRuSRMXRzKmamyiR72Hc38PU8UDDmWdfPhgxmGxEW,5WoF3gkgygyNNbwxWgVfqGWkExcDixuzgJQQjXEZQ6J5,True,434187214,108546803,679108,339554,339554,3zqXX6kzhkbW3d4TwD2CNjMRwxTbREXySekvq37kfCNk,27164329,281938535,-254774206,625
2022-01-10 14:20:10.725089,2022-01-10 09:09:41-05:00,3010,8MKNsuGVaoYpdQy6NNyxDvRzh2DAquBUtri4nDsixUxs,D7M1SDmpZAs8vdPCCCa96UbDF15YQDxHmoGWB57tHiir,True,7042808,1760702,10958,5479,5479,DddJ7EWCmYEEZETCBNgAUSg81Ls6fZtiAaY5ekJ5sXx1,438338,3402803,-2964465,622
2022-01-10 14:20:10.725089,2022-01-10 09:09:41-05:00,3011,8VnGmfop6qcUezAJ2M15jz2Nn6mPQgehDcJPvypq4XJn,6F6sqXNhgkW9ev8QNMm4ydywUUmemhwgydRQYNeqyUmi,True,18016524,4504131,28067,14033,14034,4BnQKPLuE3DMTtxp8MjUBytgnhvxqq3ZTqZHTVZo4JJh,1122703,14746851,-13624148,623
2022-01-10 14:20:10.725089,2022-01-10 09:09:45-05:00,3012,5PbrpM9kjzF4R2eW2UTcRVXnhqWdRQWHZJXKLN43N8WC,6ip4ocbyHusy8CsVvcrpiRCUp2nq9cY8bHpTcUU3Wztq,True,13472947,3368236,21014,10507,10507,4BnQKPLuE3DMTtxp8MjUBytgnhvxqq3ZTqZHTVZo4JJh,840587,5386230,-4545643,623
2022-01-10 14:20:10.725089,2022-01-10 09:09:45-05:00,3013,DAku12iueL13vRoTpKLyqdGaLQ2rWF6REe8Dr8soFvNs,H2vVH3LxkhGe6x6Mdwy67BYwTKNQM6XayKx7mhrwyfJM,True,758782,189695,1185,592,593,4BnQKPLuE3DMTtxp8MjUBytgnhvxqq3ZTqZHTVZo4JJh,47434,356526,-309092,625
2022-01-10 14:20:10.725089,2022-01-10 09:09:45-05:00,3014,FpqCxvTkSiwDwD5qEt6hXJxzFDLFLAQ8VevK8zwRqYun,A3p6YQisCJKpNkF7vkjZRbEfbnUt7vTZdR2zPBUSdTkk,True,698354896,174588724,1090254,545127,545127,4BnQKPLuE3DMTtxp8MjUBytgnhvxqq3ZTqZHTVZo4JJh,43610186,235251816,-191641630,624
2022-01-10 14:20:10.725089,2022-01-10 09:10:08-05:00,3015,C2Dmfw4G8KKzFq38aRH2pLCRngnGZDvUUN3fHDMjFkoG,7kzJk3BTNvY3hGFNj7nDy9L5CAYus6eNiCAxWH8dSioX,True,631347,157836,986,493,493,4BnQKPLuE3DMTtxp8MjUBytgnhvxqq3ZTqZHTVZo4JJh,39444,359148,-319704,624
2022-01-10 14:20:10.725089,2022-01-10 09:10:09-05:00,3016,AM5fwZR9BUW8AFkhdGWXW4PHd2cy8ora63kDf2z2eknw,E7ru6hg4MchnRG5zcr5YazwX8Snt55r5Xq9zCHCGaYZT,True,1625539,406384,2540,1270,1270,HfEnetJ7uBSmZWCjBNxdvv9HEC5nsW4wDV7wu6WnhWan,101602,725836,-624234,625
2022-01-10 14:20:10.725089,2022-01-10 09:10:31-05:00,3017,6eBSLXDMVoW2nG3n7s42RXDH8byY3C6n1RsUuegBLSrG,37dYrKnTXYer7Bu9xFfpArA4ZNo2B9bycFw9HywDtTRx,True,16858357,4214589,26162,13081,13081,HfEnetJ7uBSmZWCjBNxdvv9HEC5nsW4wDV7wu6WnhWan,1046518,7421697,-6375179,620
2022-01-10 14:20:10.725089,2022-01-10 09:11:03-05:00,3018,6yw4GPvkqUbakcEWtqSCfjVLukty11xqjDpGxtEN9Km2,5ppEx7wkpqbG5nApCWMdRja3oRSheFmAAsNHUX7h2w2Y,True,2805716,701429,4386,2193,2193,HfEnetJ7uBSmZWCjBNxdvv9HEC5nsW4wDV7wu6WnhWan,175440,2346721,-2171281,625
2022-01-10 14:20:10.725089,2022-01-10 09:11:03-05:00,3019,Fd2HrzBAr4JobRPARZwpQHHVoSCEoog32A6tKMWAC1sK,BYappsar5sQf8VLem4wrLuTtrDFH9y8pEx1aMxfuU4Pq,True,51155164,12788791,79767,39883,39884,4BnQKPLuE3DMTtxp8MjUBytgnhvxqq3ZTqZHTVZo4JJh,3190685,23345893,-20155208,623
2022-01-10 14:20:10.725089,2022-01-10 09:11:03-05:00,3020,2FrqGFZjbiNykJyo9BZ5S9FguQJPJiTi681rJJsQ5dta,3QUncYP92NKrfpaTvuF9iQg11PXKgZAgEngwh6BbnCCj,True,1403088,350772,2173,1086,1087,DddJ7EWCmYEEZETCBNgAUSg81Ls6fZtiAaY5ekJ5sXx1,86954,537412,-450458,619
2022-01-10 14:20:10.725089,2022-01-10 09:11:03-05:00,3021,8RmB8o4zux2sD48dEsKpsX475KRxTwdk8QULUDU9xx8R,AKSiZnb4YKVB6B86aPPqvyXquhvN9xqt45bexBCZ7nx,True,107628759,26907189,168394,84197,84197,4BnQKPLuE3DMTtxp8MjUBytgnhvxqq3ZTqZHTVZo4JJh,6735777,57259071,-50523294,625
2022-01-10 14:20:10.725089,2022-01-10 09:11:03-05:00,3022,BAczoNDnbwj5AJX5LwzynzYab7ji7VbhRy9edA9Prax,34sbkUKnMetUNyMs6BhiWut85d5UZtBWnPtwx8jEpJNA,True,2207600,551900,3423,1711,1712,4BnQKPLuE3DMTtxp8MjUBytgnhvxqq3ZTqZHTVZo4JJh,136951,929048,-792097,620
2022-01-10 14:20:10.725089,2022-01-10 09:11:07-05:00,3023,AHm7zF4rpaxaayBLn5QDHgJSp8KAr647s4cNvQ9wLgd7,FDM33WngED24pukBvSDpPAzinW6afVAeGReum5nyLRiC,True,1406914,351728,2187,1093,1094,DddJ7EWCmYEEZETCBNgAUSg81Ls6fZtiAaY5ekJ5sXx1,87510,665466,-577956,621
2022-01-10 14:20:10.725089,2022-01-10 09:11:07-05:00,3024,8NdcaYUC1X5CP7FMDip78uqtqmCt8GcZdCzLRTYTihmb,9Ei1K9bXWXSXcBfeX5exPSXGCAu62WSKzvnnd4wHvyVh,True,223184,55796,345,172,173,4BnQKPLuE3DMTtxp8MjUBytgnhvxqq3ZTqZHTVZo4JJh,13819,90922,-77103,619
2022-01-10 14:20:10.725089,2022-01-10 09:11:07-05:00,3025,ANQkPUoMjLHyRtypeKzxsKW1DFauQsh9SnB3rRgRXM1Y,7RHAExWpG8Q3PXwKhJs2yXmYK9WogGydvFYpx28p6pgr,True,123346807,30836701,192967,96483,96484,HfEnetJ7uBSmZWCjBNxdvv9HEC5nsW4wDV7wu6WnhWan,7718685,66529563,-58810878,625
2022-01-10 14:20:10.725089,2022-01-10 09:11:08-05:00,3026,EmGW2aAG69ssWqCtbfDocRaM2u3TJsczn2HHP9jdmRvD,aypkDKsp9uqAB4F6mwvm5LofpsrFBuZT2MMWtE2eHdB,True,1096940,274235,1715,857,858,3zqXX6kzhkbW3d4TwD2CNjMRwxTbREXySekvq37kfCNk,68638,473246,-404608,625
2022-01-10 14:20:10.725089,2022-01-10 09:11:09-05:00,3027,F2v1YwVAwXLiUgsJ5uwn4qAAkTXitn1E75fJcPnGuAcy,5rdJ4H5GxPg4Juu77mGc7uya5LwEqLzDSRyG8mQ2mDbK,True,32759796,8189949,50954,25477,25477,DddJ7EWCmYEEZETCBNgAUSg81Ls6fZtiAaY5ekJ5sXx1,2038160,14953677,-12915517,622
2022-01-10 14:20:10.725089,2022-01-10 09:11:14-05:00,3028,6tFQaTqqffino9kwMZTL2xVNBG8k9VREFhXqVi2si3A3,3w3wGxBbS4bmXeqmvd595SAWFeXekVpnH4UdbeEs8Sx5,True,7446314,1861578,11635,5817,5818,72FwbpFGoLEazJEdpqNtPNefsadUrimUqma9wSoy4qiS,465422,2508934,-2043512,625
2022-01-10 14:20:10.725089,2022-01-10 09:11:39-05:00,3029,JDeYjCLpfnzcfxDFgHf4aBcHsajwdR14GUaKAA9euzVf,EJbvKoyMZcoCx4vWa61uMbW2vr6mUhrgEuECdteVBuZZ,True,10157025,2539256,15698,7849,7849,DddJ7EWCmYEEZETCBNgAUSg81Ls6fZtiAaY5ekJ5sXx1,627927,5832675,-5204748,618
2022-01-10 14:20:10.725089,2022-01-10 09:11:59-05:00,3030,AWvHDdb2ikqV8wc7qQ8azbvNTZdixMNxhQjhQdhayYtR,9EpgEPBb1nog6aQeFdMXfSRiLSnzGQFQ39mbLdCxgYTv,True,60349126,15087281,94408,47204,47204,DddJ7EWCmYEEZETCBNgAUSg81Ls6fZtiAaY5ekJ5sXx1,3776346,18008157,-14231811,625
2022-01-10 14:20:10.725089,2022-01-10 09:13:04-05:00,3031,9zpPiboHF5HW7NfCx7hYdmJGwUomVMTiUFc4Um5KrDi3,8q3eBpuwV6dMNkib9N8XQAq2tBUcjSANRe5SXpd4dFhZ,True,13940363,3485090,21703,10851,10852,3zqXX6kzhkbW3d4TwD2CNjMRwxTbREXySekvq37kfCNk,868134,4326972,-3458838,622
2022-01-10 14:20:10.725089,2022-01-10 09:13:04-05:00,3032,E8ifvhmyJGBGVQomo3AnZw2UcaLHcpGsTtuoCid8voU3,FMQUWTbTAfSLfrc6GTrz4DM2ZSgoxF3KtqGn8AyjVtsf,True,12083949,3020987,18796,9398,9398,3zqXX6kzhkbW3d4TwD2CNjMRwxTbREXySekvq37kfCNk,751861,4005841,-3253980,622
2022-01-10 14:20:10.725089,2022-01-10 09:16:05-05:00,3033,5eMLdQ4gYA5iqvTXSNdGvctHp7s5VpyFuwtJKqx6chBc,Ckxc5K39nkBNXBTmFTM8J48R7wGqNm3vHKZu4G5baumZ,True,427381304,106845326,668400,334200,334200,HfEnetJ7uBSmZWCjBNxdvv9HEC5nsW4wDV7wu6WnhWan,26736016,142541207,-115805191,625
2022-01-10 14:20:10.725089,2022-01-10 09:16:38-05:00,3034,Bsr6kx1B6BSEd5UnJ7Z61M49iUb3bFrDVhiEtMVtPDF2,3CFd1pUJAJPA9fobwn4Jj2mRju1CWmoop4Mh4znypNWT,True,38105688,9526422,59394,29697,29697,4BnQKPLuE3DMTtxp8MjUBytgnhvxqq3ZTqZHTVZo4JJh,2375762,13896840,-11521078,623
2022-01-10 14:20:10.725089,2022-01-10 09:16:39-05:00,3035,BgnsCfJ54ReunUtwPJLzkW4PWnqpBDWGNYxsW5PvDrbK,KpMqEkQ9dKMgCevsEK895wHd3fCLRPSzDmJSv3tKU4u,True,18842171577,4710542894,29318818,14659409,14659409,DddJ7EWCmYEEZETCBNgAUSg81Ls6fZtiAaY5ekJ5sXx1,1172752752,6912103347,-5739350595,622
2022-01-10 14:20:10.725089,2022-01-10 09:16:45-05:00,3036,6NJFN855M3Q3RLTDNo57gTgAmwPD6G2E3WvMb1m5eNCN,3YpqNnonsvXaRT4nCC3G5FZx1jjVtbDPc36LiR6WK5jR,True,98741141,24685285,149740,74870,74870,4BnQKPLuE3DMTtxp8MjUBytgnhvxqq3ZTqZHTVZo4JJh,5989636,55980903,-49991267,606
2022-01-10 14:20:10.725089,2022-01-10 09:16:48-05:00,3037,D64rDiWT3YG28fCgXCmbNjYa2JakZbpKQ1D2XuLChUfV,8WmMWq8cTsGQym5pUbHm9dPCpJugBeWUMVERYFGLxWHj,True,46383296,11595824,71484,35742,35742,4BnQKPLuE3DMTtxp8MjUBytgnhvxqq3ZTqZHTVZo4JJh,2859370,15796845,-12937475,616
2022-01-10 14:20:10.725089,2022-01-10 09:16:56-05:00,3038,DkvR2xUPMyXWGGkUSmDSfhp7RtvMkfbT1ThKCS3TwrXd,F7jYV6TtT1LZ5XCNn1zkbUfNMo4gGcQUczAQy1jLHpaW,True,791547706,197886926,1232962,616481,616481,DddJ7EWCmYEEZETCBNgAUSg81Ls6fZtiAaY5ekJ5sXx1,49318507,333940019,-284621512,623
2022-01-10 14:20:10.725089,2022-01-10 09:17:00-05:00,3039,8swGZMrPrLAxZd7MxTbkCL13k3DmAJUw41jCp6Xo6awW,3fKnX7yTNXAT4uMmXVdTy47ALJT8h8YSD3WiBb4BGuzH,True,301564766,75391191,469854,234927,234927,DddJ7EWCmYEEZETCBNgAUSg81Ls6fZtiAaY5ekJ5sXx1,18794173,130590348,-111796175,623
2022-01-10 14:20:10.725089,2022-01-10 09:17:10-05:00,3040,3XZLp6JyrQYnufa1obczXqmK6cNR29ZMW1FdCYbWNTCP,8kUTi1Prio14m9LjCj6Mari6pXwJTYkE1mp21LMn235p,True,571675,142916,891,445,446,DddJ7EWCmYEEZETCBNgAUSg81Ls6fZtiAaY5ekJ5sXx1,35645,155548,-119903,623
2022-01-10 14:20:10.725089,2022-01-10 09:17:10-05:00,3041,2F45BX9mRmtNCHPejKFknN5aNgGvR4vVLFjMaY1a7dR8,ALdSutsvEFRUEQGGBbi31QywTL1pdXSDWrNJzvNTaoXL,True,42566936,10641734,66538,33269,33269,4BnQKPLuE3DMTtxp8MjUBytgnhvxqq3ZTqZHTVZo4JJh,2661524,18681320,-16019796,625
2022-01-10 14:20:10.725089,2022-01-10 09:17:14-05:00,3042,9UyQC8vc6zJJaSdnjvTAzgmcsw4fC3xFBBiCC1w9Sbjx,3ppBfboe6FPmt7f6WrivspMUoAznZKWQMeh3rCgw7vjQ,True,15215397,3803849,23763,11881,11882,DddJ7EWCmYEEZETCBNgAUSg81Ls6fZtiAaY5ekJ5sXx1,950526,4717624,-3767098,624
2022-01-10 14:20:10.725089,2022-01-10 09:17:19-05:00,3043,H1LftKtj94Zs6PG2A7gJt9rPurBkXkTy2hbbArQwAehi,8bANmhgdnPYa3PqdPnk5BA2xhvqJmPyaMF77mrBePJ13,True,65041,16260,101,50,51,HfEnetJ7uBSmZWCjBNxdvv9HEC5nsW4wDV7wu6WnhWan,4071,49153,-45082,625
2022-01-10 14:20:10.725089,2022-01-10 09:17:21-05:00,3044,pgzvXpnUYiY7hLrfjmwScqLd8oj9vYcXpFvpm4y4JvG,GdqdQgoyBAFuXdbvoZyDhB3jyqJzVo4nkGh7EPFxkBF2,True,3594306,898576,5560,2780,2780,DddJ7EWCmYEEZETCBNgAUSg81Ls6fZtiAaY5ekJ5sXx1,222413,3028415,-2806002,618
2022-01-10 14:20:10.725089,2022-01-10 09:17:27-05:00,3045,6nJyqvFKprwaVCE1gAa2P4RHKc6Pa6XFSJymx654zZ9K,4e7iJmdwzAPxp1Zi8Azo38YyPQdPKqqY4VLJyQ5rpdYP,True,4249442,1062360,6638,3319,3319,DddJ7EWCmYEEZETCBNgAUSg81Ls6fZtiAaY5ekJ5sXx1,265549,2030838,-1765289,624
2022-01-10 14:20:10.725089,2022-01-10 09:17:27-05:00,3046,DGAQzgZhS2yioeZmG3cbacM3hdz4F1aZn1PWRwgiFukc,48KUtJaNCPNxkLXJBtWAdDxY4b9vZzLgbGxTNdwMqmjz,True,891412809,222853202,1392484,696242,696242,DddJ7EWCmYEEZETCBNgAUSg81Ls6fZtiAaY5ekJ5sXx1,55699360,382585515,-326886155,624
2022-01-10 14:20:10.725089,2022-01-10 09:17:27-05:00,3047,o2aCmkxsxSiyUX8soTEjwUCbJeXmCZsEaf8CWwxDT5n,3pvS2bTsUuiQyqZp5rdnTpq4cqWGgtv4E5rN9HsBxpRt,True,40752,10188,63,31,32,4BnQKPLuE3DMTtxp8MjUBytgnhvxqq3ZTqZHTVZo4JJh,2549,10628,-8079,625
2022-01-10 14:20:10.725089,2022-01-10 09:17:27-05:00,3048,67Z7ZGhNu5xxEh9BYKWcXp9m1T4tFiE1o1M16hCzUWQA,CT7YKWixz7BhTbvg5F6M5HCyPGnHoFLNFuDV9GhoLTo3,True,5539405,1384851,8585,4292,4293,DddJ7EWCmYEEZETCBNgAUSg81Ls6fZtiAaY5ekJ5sXx1,343411,2999528,-2656117,619
2022-01-10 14:20:10.725089,2022-01-10 09:17:27-05:00,3049,J4krKPBBTMVLZRgrSeYJAMyHQs2FkNm5TXk7nQWwDB43,ASmLbfNbhTD2HHeV7qzAqiHjUx5a8Traj8oPDwbkMdFg,True,48210640,12052660,74432,37216,37216,4BnQKPLuE3DMTtxp8MjUBytgnhvxqq3ZTqZHTVZo4JJh,2977314,16630460,-13653146,617
2022-01-10 14:20:10.725089,2022-01-10 09:17:28-05:00,3050,51yPLtXTgL9oLKs1cCf5TjL54Ld5vuVxat2NNtwZVsZG,7UjtM7Z1tiXEQMMiorQyncgi9SKu3v46DhVdgXbWqSiF,True,604761397,151190349,940752,470376,470376,DddJ7EWCmYEEZETCBNgAUSg81Ls6fZtiAaY5ekJ5sXx1,37630084,489327128,-451697044,622
2022-01-10 14:20:10.725089,2022-01-10 09:17:29-05:00,3051,CvZssqscu2dm35mwcE3zg9zedavbRjVJjWD59Py5ExUK,7pXaoR6aHKYofCmg1eHipygNYDteEaf8rbbS8BDYGQK6,True,1193147,298286,1846,923,923,DddJ7EWCmYEEZETCBNgAUSg81Ls6fZtiAaY5ekJ5sXx1,73852,402745,-328893,618
2022-01-10 14:20:10.725089,2022-01-10 09:17:33-05:00,3052,DdYgcyV1T2CDYiQVr4VL9Ym8RdKm93a7SKy8HxuyaoMW,GPdAeqeXb1UJ56AttcwwY1CyFhRyfptDC4BAX2Tc8MpE,True,896575,224143,1402,701,701,DddJ7EWCmYEEZETCBNgAUSg81Ls6fZtiAaY5ekJ5sXx1,56094,425019,-368925,625
2022-01-10 14:20:10.725089,2022-01-10 09:17:55-05:00,3053,CRaKcudjkQiSw5YPVjTLVdXvJskeGiHSYtq5ZcMPJhgQ,AgqTg3b3bAcaBmRidhNC4Uf9ZwNbeH52RQEqumWyuUs7,True,1475625,368906,2283,1141,1142,4BnQKPLuE3DMTtxp8MjUBytgnhvxqq3ZTqZHTVZo4JJh,91337,842750,-751413,618
2022-01-10 14:20:10.725089,2022-01-10 09:17:55-05:00,3054,EAUFD16wab8qRMJ4H6updHGt4xFqgRCDeRHVCsLCTSTL,8vkfYSyCyBY9g4TZrp52jUcQj6udy9xAaA4fioRE2RXx,True,3601374462,900343615,5613050,2806525,2806525,3zqXX6kzhkbW3d4TwD2CNjMRwxTbREXySekvq37kfCNk,224522017,789927554,-565405537,623
2022-01-10 14:20:10.725089,2022-01-10 09:17:55-05:00,3055,Ckqos6cdncPKj13DnCmDVZsZTqp6eS7277CRrT9WhcEr,AtUV8m7VQJvZq7GLCAHMf3jV7iamKEPnWVZHWuuVZQp1,True,2115870,528967,3301,1650,1651,DddJ7EWCmYEEZETCBNgAUSg81Ls6fZtiAaY5ekJ5sXx1,132069,1208549,-1076480,624
2022-01-10 14:20:10.725089,2022-01-10 09:18:01-05:00,3056,BrHRMouGRz3LBNzd9anfdYMhWfg8yUPHL4PqJ8WdEDFS,4uzoLa3mC2VYHAPBoHLX4gTjPTC28rPf2fvEGtJWPYc,True,103649470,25912367,162143,81071,81072,DddJ7EWCmYEEZETCBNgAUSg81Ls6fZtiAaY5ekJ5sXx1,6485720,79626750,-73141030,625
2022-01-10 14:20:10.725089,2022-01-10 09:18:03-05:00,3057,M69XSefqeum2arinvHEqmA3L2XHWNFN17p4msRhRZXf,2vK15yYUANLSbAoiBfgJ9VLyqsmtEpd2iNytQjms8GaQ,True,461422424,115355606,713437,356718,356719,3zqXX6kzhkbW3d4TwD2CNjMRwxTbREXySekvq37kfCNk,28537514,276931402,-248393888,618
2022-01-10 14:20:10.725089,2022-01-10 09:18:03-05:00,3058,HVZkXeDR3mc8oB9qFFwCK4RXpPojdcHk9tRGep6xtKGK,Bh3py7awPejWqeTMxtAgF7mPotL2Asxf8YrYJykq9nBt,True,11229880,2807470,17444,8722,8722,4BnQKPLuE3DMTtxp8MjUBytgnhvxqq3ZTqZHTVZo4JJh,697783,4485973,-3788190,621
2022-01-10 14:20:10.725089,2022-01-10 09:18:03-05:00,3059,9vcKW1GfrDZ3KLPh2pEVFF8ZyKqD1pJW1hiE8H98Av7S,C6Ki27mo4sCHu6u8UnR1p7WSgsTjFQxGGR9Lk9n5Rhjq,True,4730759,1182689,7289,3644,3645,4BnQKPLuE3DMTtxp8MjUBytgnhvxqq3ZTqZHTVZo4JJh,291564,2134536,-1842972,616
2022-01-10 14:20:10.725089,2022-01-10 09:18:04-05:00,3060,3qnPsgqW11AcDEmyjmJquPcPLyE3EdJQuVLJ5kinDrd3,86rZadBB7emKio76aFTahpbrFtxd9tqZ4Mxgzaavq2xU,True,269078,67269,420,210,210,DddJ7EWCmYEEZETCBNgAUSg81Ls6fZtiAaY5ekJ5sXx1,16811,108144,-91333,624
2022-01-10 14:20:10.725089,2022-01-10 09:18:04-05:00,3061,5rW9kqXB9feGSKSvSMNJF1FCsBYV3vGmTmc8MvzaZ3pi,7AjnjcfPJevW5521hXw4VtgRCfHSsAqyzyArukKfNcHo,True,18730935,4682733,29230,14615,14615,DddJ7EWCmYEEZETCBNgAUSg81Ls6fZtiAaY5ekJ5sXx1,1169205,9013737,-7844532,624
2022-01-10 14:20:10.725089,2022-01-10 09:18:05-05:00,3062,6oroGB3mvzK3tDfiB9X2NJuL3x476pxhgRnt7VxqhdLo,2SoK8tKkLn2ppKURpTVazKsCEis4uahkHMsac1m85J4r,True,3050663,762665,4729,2364,2365,3zqXX6kzhkbW3d4TwD2CNjMRwxTbREXySekvq37kfCNk,189179,2477337,-2288158,620
2022-01-10 14:20:10.725089,2022-01-10 09:18:06-05:00,3063,CagSUfZLwXuCdypC4KzU6FSNdmCj9dKDroPcNeaRtsyt,yxw5d1ztZuEUY2QjL7eLpr72QJAj5rJd6ERvg91cy1m,True,2754911,688727,4288,2144,2144,DddJ7EWCmYEEZETCBNgAUSg81Ls6fZtiAaY5ekJ5sXx1,171545,974411,-802866,622
2022-01-10 14:20:10.725089,2022-01-10 09:18:10-05:00,3064,zLTuMVfVswjMkhyvjaXnvjcKXv5xNk3iSWSjRGpVqXf,J3D8NHUJCiSjvFYfJ5Es4YDhF1KcPZWRUmCQ5L92t8eB,True,207276701,51819175,322445,161222,161223,3zqXX6kzhkbW3d4TwD2CNjMRwxTbREXySekvq37kfCNk,12897819,78191287,-65293468,622
2022-01-10 14:20:10.725089,2022-01-10 09:18:10-05:00,3065,CBL2NbekJrXvBiAcoj4fzQ4PfLDwTntW7Zt4nruHFYEw,59EvfgYTdKkfjUJz5LddLUAqbEdLaihcMzjcrTZsyzyS,True,15932,3983,24,12,12,DddJ7EWCmYEEZETCBNgAUSg81Ls6fZtiAaY5ekJ5sXx1,987,6234,-5247,619
2022-01-10 14:20:10.725089,2022-01-10 09:18:11-05:00,3066,8xQ3tsWVUe75EG1HmocULJ3kh52utveoFMEPotTGrKno,i3SKW3ywrwYucX9ySEx1C4zaUKGnzLerP3V38437NyV,True,76929516,19232377,120014,60007,60007,3zqXX6kzhkbW3d4TwD2CNjMRwxTbREXySekvq37kfCNk,4800569,35270393,-30469824,624
2022-01-10 14:20:10.725089,2022-01-10 09:18:11-05:00,3067,2jPxG5FL6D6XEJsRszJ9cmQ54AWSpZyPFSbn3DpWBSuM,3toQou4UVNvyWYvMvkuv379RVEF2aN2TzCpKKBUqeQV6,True,328861573,82215393,512074,256037,256037,72FwbpFGoLEazJEdpqNtPNefsadUrimUqma9wSoy4qiS,20482992,129012576,-108529584,622
2022-01-10 14:20:10.725089,2022-01-10 09:18:11-05:00,3068,7PzGZgzieFyyFs1dbajkNQgVxooFUNZrj1bUsQvrSwbp,A2gDREmSmJTBPPw3sbKVY3smC9wbHMDdv87gr4Tr2ES7,True,4843301,1210825,7578,3789,3789,4BnQKPLuE3DMTtxp8MjUBytgnhvxqq3ZTqZHTVZo4JJh,303138,1947829,-1644691,625
2022-01-10 14:20:10.725089,2022-01-10 09:18:20-05:00,3069,BZxJ6CtrVoiU86DMMieMeDFLNWtMpHGTvZfM7nyay6o4,6CRxRR8bisRLHFJBFWjyumYuy7j4C4PkjYH1K8gXhdWD,True,4885278,1221318,7642,3821,3821,DddJ7EWCmYEEZETCBNgAUSg81Ls6fZtiAaY5ekJ5sXx1,305687,1471699,-1166012,625
2022-01-10 14:20:10.725089,2022-01-10 09:18:22-05:00,3070,GqAS41YJssg9aaEp3hs3sG98APCsXhiQBQszXaSjZ2bN,2wodJ3AhrXdE1T4oVL95KvoBND7PubG5Wd5GWiLCMZJU,True,323460437,80865109,505337,252668,252669,4BnQKPLuE3DMTtxp8MjUBytgnhvxqq3ZTqZHTVZo4JJh,20213483,250212102,-229998619,624
2022-01-10 14:20:10.725089,2022-01-10 09:18:28-05:00,3071,HGJoZvLakWfSDFwuvShNBc4kCf7nP7VqzyM3mELpbFEf,12Qn5jin7QvsBngXqYAv4UstyG3b6nRf1jsLp9Dp8G7k,True,27617633,6904408,43159,21579,21580,4BnQKPLuE3DMTtxp8MjUBytgnhvxqq3ZTqZHTVZo4JJh,1726379,11647776,-9921397,625
2022-01-10 14:20:10.725089,2022-01-10 09:18:41-05:00,3073,ymyzGH4Qc7HH5PbKpVphCbsQgLLXyGkPcXamQJuNj5C,8oTLHaV2XzbKXNWRuUjCfHjUn61Pw93LYK14m9q2VDpZ,True,23410650,5852662,36472,18236,18236,3zqXX6kzhkbW3d4TwD2CNjMRwxTbREXySekvq37kfCNk,1458880,8301141,-6842261,623
2022-01-10 14:20:10.725089,2022-01-10 09:18:41-05:00,3072,BPsM1um9ZJf7eNoVMsQCRSwgARMuLCGGSDxf9tZeNeEy,BpzDdXfxVygiSYSmsHV6uPxQMeTFtrURMCCqhswQjd5X,True,2052292,513073,3201,1600,1601,DddJ7EWCmYEEZETCBNgAUSg81Ls6fZtiAaY5ekJ5sXx1,128076,745197,-617121,624
2022-01-10 14:20:10.725089,2022-01-10 09:18:42-05:00,3074,B4Uc39nKzz9wBRQsCkMR4A7RwTJ8rSuwpR6EQn2AesRb,H49bGZgatRZVpj6QufZRVgYrQtH7LpdbiqKBs23151m,True,44051286,11012821,68719,34359,34360,4BnQKPLuE3DMTtxp8MjUBytgnhvxqq3ZTqZHTVZo4JJh,2748773,37540505,-34791732,623
2022-01-10 14:20:10.725089,2022-01-10 09:18:42-05:00,3075,3C2MZQKh9x4zNTCMbhhvoafGaFMwUooqfy9MCgPyXs6E,AHjgWKpYPWe6ketjDHDKFBFsKQiRJ41jnkuo39MVYxZo,True,360339692,90084923,559995,279997,279998,3zqXX6kzhkbW3d4TwD2CNjMRwxTbREXySekvq37kfCNk,22399838,194653717,-172253879,621
2022-01-10 14:20:10.725089,2022-01-10 09:18:42-05:00,3076,2FEbsetZMkRqLjSC8GBbgecKgX5T1T1fci2sLQux29p8,H722Fcd6DkTFRZxqQWbPDufBfXEgmFfhiEpQZWhxwYv1,True,8223189,2055797,12791,6395,6396,DddJ7EWCmYEEZETCBNgAUSg81Ls6fZtiAaY5ekJ5sXx1,511677,2965438,-2453761,622
2022-01-10 14:20:10.725089,2022-01-10 09:18:46-05:00,3077,U3vvMQ4X4aKzVYfhMw1V1p58HRqaLnuXozqmmefYeD9,7JA94MArkNCFRhBq8f5a32DgMF6aPdFsoC5HvXDQ6NuR,True,534556397,133639099,832007,416003,416004,DddJ7EWCmYEEZETCBNgAUSg81Ls6fZtiAaY5ekJ5sXx1,33280280,261804756,-228524476,622
2022-01-10 14:20:10.725089,2022-01-10 09:19:04-05:00,3078,FFoYoBmkfEsCWVXQf3BhKeaFMZD3YVKvfhPWkXdnCZS9,8yW6WApAuN43brF1HioTLdyxvQTQJzt875E26QqrWWFk,True,941689,235422,1454,727,727,4BnQKPLuE3DMTtxp8MjUBytgnhvxqq3ZTqZHTVZo4JJh,58175,255551,-197376,617
2022-01-10 14:20:10.725089,2022-01-10 09:19:06-05:00,3079,BYvjENe16Ta77PqGV7JKEWrsqCTfkMGYwTSG5gXneDvd,EvxAXgvhPC6QkNurbK7vWyTApGo8J2R4EgMAknkHVU3d,True,5253570,1313392,8050,4025,4025,DddJ7EWCmYEEZETCBNgAUSg81Ls6fZtiAaY5ekJ5sXx1,322000,3076669,-2754669,612
2022-01-10 14:20:10.725089,2022-01-10 09:19:06-05:00,3080,6Bq55LtGCEeGqh4JrFLCmmGc2iJfTTBJixivqH78aGSE,DSNrCgWJeNe2P9tAQu5FvCueTzNKDKds7wzuwTQSMRG,True,11673969,2918492,17995,8997,8998,4BnQKPLuE3DMTtxp8MjUBytgnhvxqq3ZTqZHTVZo4JJh,719805,4142007,-3422202,616
2022-01-10 14:20:10.725089,2022-01-10 09:19:06-05:00,3081,6rb3fRVWJ5cSzFcmuC1YwdrNxiNctvboDF7HwsfyGoCA,H6JaYfFZkRk6iSJrA4nVeuFpMVQtVwQZHVgK1TyaupTE,True,73753,18438,113,56,57,4BnQKPLuE3DMTtxp8MjUBytgnhvxqq3ZTqZHTVZo4JJh,4538,54725,-50187,615
2022-01-10 14:20:10.725089,2022-01-10 09:19:06-05:00,3082,3WcJUt8jQ1ngL3ZCGo6dFrc3GmTMTYtzeDva7mri2Tqx,HeG1Pz2oMjqtkfsRMsbqP3VpatnVEQzcWmKDVoFp4Htr,True,27589941,6897485,42629,21314,21315,DddJ7EWCmYEEZETCBNgAUSg81Ls6fZtiAaY5ekJ5sXx1,1705185,11654275,-9949090,618
2022-01-10 14:20:10.725089,2022-01-10 09:19:06-05:00,3083,CwTus4FyoXYqyTKAYDp69NLhA1joYZ3tarzY6FFTr6fn,6ivuvYWU6i25MzJSY8rG9rPDKiq38E6QtrV1jvRubLGr,True,17794,4448,27,13,14,4BnQKPLuE3DMTtxp8MjUBytgnhvxqq3ZTqZHTVZo4JJh,1097,7298,-6201,616
2022-01-10 14:20:10.725089,2022-01-10 09:19:12-05:00,3084,2PzBAkdXkrwH9VuoMALumQz86qkW7sSBQtCrHw14JUp3,D5vwWAMHVooobG2sCWv9EwtJrAFZG6cwKH4dfmA98tbt,True,3568654,892163,5566,2783,2783,DddJ7EWCmYEEZETCBNgAUSg81Ls6fZtiAaY5ekJ5sXx1,222653,1458942,-1236289,623
2022-01-10 14:20:10.725089,2022-01-10 09:19:12-05:00,3085,FV9CBGGTbppLnBKh79f2LzD1diTiS5g6u89FcpZHZmnK,Fe7mtmCUziFqbbYTvrhAcAq1Ub7YLfTJRtQ1hG7GzJD1,True,9246202,2311550,14241,7120,7121,72FwbpFGoLEazJEdpqNtPNefsadUrimUqma9wSoy4qiS,569650,3340579,-2770929,616
2022-01-10 14:20:10.725089,2022-01-10 09:19:12-05:00,3086,X5SF9srgzDgBRBhv8xUWyszYYSQiqFF6cVnVLWzQgp1,7rTqnMkPuUUJFt5px1DxwsUK8U5fQUtnx9N4v6dA4vGb,True,45384,11346,70,35,35,DddJ7EWCmYEEZETCBNgAUSg81Ls6fZtiAaY5ekJ5sXx1,2834,18483,-15649,624
2022-01-10 14:20:10.725089,2022-01-10 09:19:12-05:00,3087,Cs2YxkuqBK1kjoYZbUZdUcxapPbv8oC75trwGgWoCPfG,2PgHQM1GhHykE4bQ1ggueAw2Zs1BFUW5hxvMvr8DojKM,True,96586980,24146745,149416,74708,74708,4BnQKPLuE3DMTtxp8MjUBytgnhvxqq3ZTqZHTVZo4JJh,5976669,51759722,-45783053,618
2022-01-10 14:20:10.725089,2022-01-10 09:19:12-05:00,3088,DMgD2KCEhTGFLUZ5GnfNcwfiiwKYbyVpoWiN6knMkCAf,5KU2vgBkPTNVHsSULjgX7ZkZS56U3Dy3xqLTxL5sUZJ3,True,2423263240,605815810,3719783,1859891,1859892,DddJ7EWCmYEEZETCBNgAUSg81Ls6fZtiAaY5ekJ5sXx1,148791332,1386922350,-1238131018,614
2022-01-10 14:20:10.725089,2022-01-10 09:19:12-05:00,3089,7vKmhLV45Q5etXhJL5ng8rxWhYSiUCDmAbGnwBPr7zcx,cP6xPeuHLnjr858QK1F9qYn7rJpEbPy7wEJHoju6oV7,True,59382371,14845592,92771,46385,46386,4BnQKPLuE3DMTtxp8MjUBytgnhvxqq3ZTqZHTVZo4JJh,3710869,24028966,-20318097,624
2022-01-10 14:20:10.725089,2022-01-10 09:19:13-05:00,3090,F1JT1p2VuwK4L7zj7NNnZtYiZiNUCcTGKDkgdoX3BZdZ,3BKe4yzTwnnBnvTWP3britpPJ4oAWL7JZJzNLCxjUufS,True,8915,2228,13,6,7,3zqXX6kzhkbW3d4TwD2CNjMRwxTbREXySekvq37kfCNk,553,2026,-1473,620
2022-01-10 14:20:10.725089,2022-01-10 09:19:21-05:00,3091,7D4rFmGMPKNAF75VRPxHAhSn2wTjiW8jmth1UD22Xqq9,GQ7BrT6vsXu8tHCMm75YdxFR2r9QTCrCUbdPEZBSAg9w,True,65762749,16440687,102804,51402,51402,3zqXX6kzhkbW3d4TwD2CNjMRwxTbREXySekvq37kfCNk,4112182,22356166,-18243984,625
2022-01-10 14:20:10.725089,2022-01-10 09:19:24-05:00,3092,BhiAaiZu7fF8ndggJrLyiFVCRq526cNBw7VaeascEmNL,4en8MipPi7vq15NGhpPMQfptNdEyhp2j7fpgxBBtjyfz,True,1517758,379439,2353,1176,1177,3zqXX6kzhkbW3d4TwD2CNjMRwxTbREXySekvq37kfCNk,94157,597586,-503429,620
2022-01-10 14:20:10.725089,2022-01-10 09:19:28-05:00,3093,DY6k3Dkwe18iLneaT8Xo3VpJWB6V4jWwQQjoDvEzdg2j,3GGV7S9FpRQGbARBXkvGFVqLrmw8JvYAcpnR1aKVUY2f,True,16070535,4017633,24717,12358,12359,4BnQKPLuE3DMTtxp8MjUBytgnhvxqq3ZTqZHTVZo4JJh,988709,9173641,-8184932,615
2022-01-10 14:20:10.725089,2022-01-10 09:19:34-05:00,3094,2d1qyEJRyGvB2H83ACSqUjqYLwcLHcURHWAKLXs4w9vp,EFA6rDFpTQcY2vjZMq6Qrjv56nJPN2FhWXNwFzkWtE2M,True,15542873,3885718,24016,12008,12008,3zqXX6kzhkbW3d4TwD2CNjMRwxTbREXySekvq37kfCNk,960665,8196754,-7236089,618
2022-01-10 14:20:10.725089,2022-01-10 09:19:34-05:00,3095,5Z3ZFCA65WoWhm3okRuuziEMi7ajGAEHWUFchzBNba5S,FcomdrWidygkxMKzcsY5xELbmwC652uMci648LMTv7AB,True,17046,4261,26,13,13,4BnQKPLuE3DMTtxp8MjUBytgnhvxqq3ZTqZHTVZo4JJh,1061,6752,-5691,622
2022-01-10 14:20:10.725089,2022-01-10 09:19:34-05:00,3096,E1wp3bmkcY3eiEYyGYwhTCsr7BZ7RfPa5DJTZFupcFwj,452hVdYkD5SDDrA6hv6DLPFvyS8PvR2P6DPNScGxWTsW,True,1104395,276098,1696,848,848,4BnQKPLuE3DMTtxp8MjUBytgnhvxqq3ZTqZHTVZo4JJh,67861,465013,-397152,614
2022-01-10 14:20:10.725089,2022-01-10 09:19:35-05:00,3097,i7TcF4weYcqgrRdH3GpndbEYxCxfcSfr9JWYrAUg1CF,BkDfknUir7PnSEW8auoB87PytycEFwyX5kT2GY4SGJJL,True,7241414,1810353,11097,5548,5549,4BnQKPLuE3DMTtxp8MjUBytgnhvxqq3ZTqZHTVZo4JJh,443907,5715416,-5271509,613
2022-01-10 14:20:10.725089,2022-01-10 09:19:35-05:00,3098,DYCYiQFH9QHzCo3eAw1pFoDu7pzwFMo1E2WDZjVFRz5w,CPh4FWsGak1kd1WFEH9qBjNhnun3R2tHtZA57zW8ugn5,True,64958553,16239637,100470,50235,50235,4BnQKPLuE3DMTtxp8MjUBytgnhvxqq3ZTqZHTVZo4JJh,4018819,33263874,-29245055,618
2022-01-10 14:20:10.725089,2022-01-10 09:19:35-05:00,3099,DrzTARa7RK8RXoxHZPKCBqYtMC8TAUHRw8SznXRKTa5M,FYANet92VhyXkKZqqBJR4sFxuCftWb68sgQU9VHCdTJk,True,45227,11306,69,34,35,72FwbpFGoLEazJEdpqNtPNefsadUrimUqma9wSoy4qiS,2777,17628,-14851,614
2022-01-10 14:20:10.725089,2022-01-10 09:19:37-05:00,3100,EhANPABkSw9x9WnsDEi8pCg67iQTX2UGTTUpyjADTwdN,4FKLi98hyg9ZjM4MY6ctJsv7B6vPUnTYWdhrnNoYsztX,True,13739902,3434975,21054,10527,10527,4BnQKPLuE3DMTtxp8MjUBytgnhvxqq3ZTqZHTVZo4JJh,842167,7009931,-6167764,612
2022-01-10 14:20:10.725089,2022-01-10 09:19:37-05:00,3101,Cb4zhnvig11U4GcC4kqKrnDicGgPhUpfDQB1U7hP3nPa,DiRAMrKqaevGXeXg38KnhaYBERj8tNKU7oWFJvhS32kw,True,276242,69060,425,212,213,4BnQKPLuE3DMTtxp8MjUBytgnhvxqq3ZTqZHTVZo4JJh,17016,96734,-79718,615
2022-01-10 14:20:10.725089,2022-01-10 09:19:42-05:00,3102,Hy3kzXneDN6FUkiZctU1vWe97BYvj6yZ7QvQzehfWmNr,EhXgQg8BTniANV525RpY76z7Hrh6DuqrMChjqEoXfVJe,True,2203031,550757,3441,1720,1721,4BnQKPLuE3DMTtxp8MjUBytgnhvxqq3ZTqZHTVZo4JJh,137662,1046118,-908456,624
2022-01-10 14:20:10.725089,2022-01-10 09:19:42-05:00,3103,CK3ocyWzXQkJJZQmM6bBK4Nv6Rh3UEufjY6DvNU6gJZy,C924o4GY3p2BHLeAbFbe9SEysXqCUyD8sFu2d4NzkAV7,True,8925028,2231257,13699,6849,6850,3zqXX6kzhkbW3d4TwD2CNjMRwxTbREXySekvq37kfCNk,547966,3189784,-2641818,613
2022-01-10 14:20:10.725089,2022-01-10 09:19:42-05:00,3104,AKxRtcdpi7gWhAuL8ENj7zhgeQezzEXe9TSANE6bQoRA,2YH4vrU9deP8Cu6E8Hzf8GqKG1yVjv5pdz4FE7r5YKir,True,9379474,2344868,14584,7292,7292,4BnQKPLuE3DMTtxp8MjUBytgnhvxqq3ZTqZHTVZo4JJh,583396,3756977,-3173581,621
2022-01-10 14:20:10.725089,2022-01-10 09:19:42-05:00,3105,8E3K7vCHJ2xjdFofPRGLbMxrkm8UYEi926QmXPAFwsqe,4qHUDA1c43Dg4qi1ZPKqmpGYiEMUZ6r4UuzB5ftHCEhW,True,1842473863,460618465,2880205,1440102,1440103,4BnQKPLuE3DMTtxp8MjUBytgnhvxqq3ZTqZHTVZo4JJh,115208200,941771178,-826562978,625
2022-01-10 14:20:10.725089,2022-01-10 09:19:42-05:00,3106,2NHv3c4ufYGo3xNr6KXymAZJdpfURrNiCKbXZ7s82Vwo,E4NYpYgHTvSG6LqH2bBV9Q1XJ6pAzCp9FLSKMzJmYRrQ,True,35440021,8860005,54914,27457,27457,4BnQKPLuE3DMTtxp8MjUBytgnhvxqq3ZTqZHTVZo4JJh,2196579,18453867,-16257288,619
2022-01-10 14:20:10.725089,2022-01-10 09:19:43-05:00,3107,75ycx5sUFBxDhY1uwuPCW22s2C6BydkJTje7q7zEQFGT,FpEgrVFRubjGK4DRjTqdVbxSECURpn16zfpoC31NbwnN,True,8735757,2183939,13575,6787,6788,4BnQKPLuE3DMTtxp8MjUBytgnhvxqq3ZTqZHTVZo4JJh,543029,4462252,-3919223,621
2022-01-10 14:20:10.725089,2022-01-10 09:19:45-05:00,3108,J3ggP7ZxL8HRh3CBp5iYG2WgjLyNSAWYT46uC9VYDLCz,2FqTRiRPiLvdAH2BS5vroVntpsSXvTJEn5UHWmtKHzh9,True,38170428,9542607,59315,29657,29658,4BnQKPLuE3DMTtxp8MjUBytgnhvxqq3ZTqZHTVZo4JJh,2372629,12076317,-9703688,621
2022-01-10 14:20:10.725089,2022-01-10 09:19:56-05:00,3109,gMjmD7WioyUdQdwNqE5fobLcxPwoJv5rAvLmJaf8Jjw,5n77euFjVJiwKrnbYq1KpcENW1mzBZj2BuDGyzazrkJ8,True,1580933,395232,2461,1230,1231,72FwbpFGoLEazJEdpqNtPNefsadUrimUqma9wSoy4qiS,98467,650297,-551830,622
2022-01-10 14:20:10.725089,2022-01-10 09:19:59-05:00,3110,399591e8XgY52yCMorCQ2WL6dQZTC485ZooHtmGuirhZ,JCiXAooFmKmEPQ2S7C8iSk6CLcTyrPEe1SsPSLyUGySe,True,1389489,347372,2151,1075,1076,72FwbpFGoLEazJEdpqNtPNefsadUrimUqma9wSoy4qiS,86048,798729,-712681,619
2022-01-10 14:20:10.725089,2022-01-10 09:20:00-05:00,3111,4uygLJDk9DFCifJ56YwMrEsvd3oQNq8tYSLnMCyWorS6,GimL4uKGvg3FFmFQSWzAcjstv3Vmk5NMgDGMKTuXYVpB,True,673255856,168313964,1041737,520868,520869,4BnQKPLuE3DMTtxp8MjUBytgnhvxqq3ZTqZHTVZo4JJh,41669492,276843720,-235174228,618
2022-01-10 14:20:10.725089,2022-01-10 09:20:00-05:00,3112,8kJu5aqVSmW8FSZR9h6F75ftn9V2U9uMLBEKeqRaC855,FhVHByujkvwwtjTVpZ4mqSUqoMoBgeLUc5H7rbz3FgAt,True,114723165,28680791,178871,89435,89436,4BnQKPLuE3DMTtxp8MjUBytgnhvxqq3ZTqZHTVZo4JJh,7154854,65986236,-58831382,623
2022-01-10 14:20:10.725089,2022-01-10 09:20:01-05:00,3113,A4tDE948CPFPh1UwHb8sXryfKktbxZ8BCkqXgA5DJHA8,3zXeKMrsEpCe5fQumLNzCgpxcG1kLJFEAtJuqxLsC6ZG,True,112458506,28114626,174152,87076,87076,4BnQKPLuE3DMTtxp8MjUBytgnhvxqq3ZTqZHTVZo4JJh,6966113,49452101,-42485988,619
2022-01-10 14:20:10.725089,2022-01-10 09:20:01-05:00,3114,9WJBnVi84E926j7xEd566WzrZJkPJWRgmEnYj9vyjuad,4dLaFS5F7TGyLdwuJLMGkz3bSL53aHzd9ZfpNmhHxXeF,True,19915649,4978912,30087,15043,15044,4BnQKPLuE3DMTtxp8MjUBytgnhvxqq3ZTqZHTVZo4JJh,1203499,10078850,-8875351,604
2022-01-10 14:20:10.725089,2022-01-10 09:20:05-05:00,3115,96DzqyUxsB1FKWrhLdTdjDcokuus6rbx83gLsghqPPwt,74CWb7SVoSy3ADysEzFEeMiS2fxHJ9gdUF9pzM3E52Gj,True,26518,6629,41,20,21,4BnQKPLuE3DMTtxp8MjUBytgnhvxqq3ZTqZHTVZo4JJh,1652,10536,-8884,622
2022-01-10 14:20:10.725089,2022-01-10 09:20:05-05:00,3116,JCBhqqPQxP1Xc41sSY6e1sQKRstHhe7D1v6rLz4hp3Qp,DWMUq2bMD1jqpxHtyXDFjcAwjA27yyMRe68hGcsK143m,True,9546,2386,14,7,7,3zqXX6kzhkbW3d4TwD2CNjMRwxTbREXySekvq37kfCNk,596,3797,-3201,624
2022-01-10 14:20:10.725089,2022-01-10 09:20:05-05:00,3117,D9VKhnfLLCrntDGFYSfoxFaY76VnHmYZ1ZbyFXdKdibz,2hRCRH2pMDyQGYcXHa8Y6BZo6FbcGZf5VJC1v8Bp6tGa,True,119375111,29843777,185454,92727,92727,3zqXX6kzhkbW3d4TwD2CNjMRwxTbREXySekvq37kfCNk,7418184,45118128,-37699944,621
2022-01-10 14:20:10.725089,2022-01-10 09:20:05-05:00,3118,9YEzjb49Awvedv9yNc6LG54SkGBug2RYiJwiUV13mGsS,3H8w5WCD187NWWoZMNUCzUDdxTgqrRJLga8gDzUVXBgZ,True,1502461,375615,2350,1175,1175,4BnQKPLuE3DMTtxp8MjUBytgnhvxqq3ZTqZHTVZo4JJh,94012,881322,-787310,625
2022-01-10 14:20:10.725089,2022-01-10 09:20:05-05:00,3119,2rCRdyfi65rpxRRmg7knaSb8t55FuPt3h8wF4Fzhy8MM,CLVY5nSG3jTdRo7tRSKgK9DJgW6aswfWKe4tLxzsENmb,True,862632,215658,1337,668,669,3zqXX6kzhkbW3d4TwD2CNjMRwxTbREXySekvq37kfCNk,53519,308595,-255076,620
2022-01-10 14:20:10.725089,2022-01-10 09:20:05-05:00,3120,Ar5QB4VBcUyzSCG23z2QNAbrWY55NbHCr1MNN6P2GAmh,BusFGTiDrJmxzwGUxWz9b3SFF3eseqtgh2DRHqyAwyVe,True,633314,158328,979,489,490,DddJ7EWCmYEEZETCBNgAUSg81Ls6fZtiAaY5ekJ5sXx1,39171,268569,-229398,618
2022-01-10 14:34:34.127757,2022-01-10 09:20:06-05:00,3121,HutRztBianNUgm9sJDWKUQBmoVyy8y7CfnNk4hHjSkEW,EtVfvPyiy5bizbCZxR19TNUgETf3QcmziBvMtc6o5zjr,True,337545178,84386294,525068,262534,262534,4BnQKPLuE3DMTtxp8MjUBytgnhvxqq3ZTqZHTVZo4JJh,21002737,277748869,-256746132,622
2022-01-10 14:34:34.127757,2022-01-10 09:20:06-05:00,3122,GaEpNGa8jnwSRvjzzEMYkZe1pKcr2eiZtePrqFxpABjB,5CFZHuyWbJv14zPdX5dSQDREgHrCb4vsFvB6hLiEe3Ji,True,208560,52140,322,161,161,4BnQKPLuE3DMTtxp8MjUBytgnhvxqq3ZTqZHTVZo4JJh,12912,84672,-71760,619
2022-01-10 14:34:34.127757,2022-01-10 09:20:06-05:00,3123,GJ3PbEfPK8jjrPgMmZtvN5fMSSy2dtiiAtZ8wcfgxVuc,FCUDVFb2TjDvehHE8fVBofqSykpb9W6Afc9QeHtj7te7,True,105144196,26286049,162609,81304,81305,3zqXX6kzhkbW3d4TwD2CNjMRwxTbREXySekvq37kfCNk,6504366,56952159,-50447793,618
2022-01-10 14:34:34.127757,2022-01-10 09:20:08-05:00,3124,D3mXrJzhHf8qRaoCKLschUxAFoijFCFuT6bmNZH4W7Cj,9E3Xtqw7TncXWnbhAbFJMtuNmP6WS3ooGuptzyzw7UpA,True,79220,19805,123,61,62,4BnQKPLuE3DMTtxp8MjUBytgnhvxqq3ZTqZHTVZo4JJh,4923,43295,-38372,621
2022-01-10 14:34:34.127757,2022-01-10 09:20:09-05:00,3125,89CkXnSZnr52Zsoh48efv9MQacrkB6GMtrbEpNJSyA2H,HcvRBS4Z22CpYgDNgm4TVF4AVXFDuYzBUAFcdHAwdpg4,True,4101081,1025270,6270,3135,3135,3zqXX6kzhkbW3d4TwD2CNjMRwxTbREXySekvq37kfCNk,250835,1649454,-1398619,611
2022-01-10 14:34:34.127757,2022-01-10 09:20:13-05:00,3126,6XHt7CrURSomkQrtVXV5JuKSZY4tQRpUyQKfCDaSTYaD,GCgcmPSDDBsn2smYbpiX3PJybDkQWtufPu4YRsbEEU8X,True,461883096,115470774,719680,359840,359840,4BnQKPLuE3DMTtxp8MjUBytgnhvxqq3ZTqZHTVZo4JJh,28787223,276720581,-247933358,623
2022-01-10 14:34:34.127757,2022-01-10 09:20:13-05:00,3127,9jdfc9GFTecsdRuTjWFGX13niKKmeBxRgtv5j86uhSnU,HLWMShobjSkaLyXrNjgwVaUGVtbtdUSnr1XjqpXn1bLR,True,400946,100236,619,309,310,DddJ7EWCmYEEZETCBNgAUSg81Ls6fZtiAaY5ekJ5sXx1,24781,179894,-155113,618
2022-01-10 14:34:34.127757,2022-01-10 09:20:14-05:00,3128,8vva9SmKpMGW8wjpkvydQczxVK6VtN79qzH2i4JQSwg4,F8a3GLicsSapt4aLURoU4qHxJaxCij4LS6JVxoMF3YHT,True,1313550,328387,2016,1008,1008,4BnQKPLuE3DMTtxp8MjUBytgnhvxqq3ZTqZHTVZo4JJh,80671,357593,-276922,614
2022-01-10 14:34:34.127757,2022-01-10 09:20:15-05:00,3129,4MmpDGUTyMcYEqJ1RoZ46AN2BhrBUseHaHqF8AmiTPyD,7HW2YZpYM349HMfW7u4h9ESZ1AXkwN8JcVDTNFzp9aTz,True,164328918,41082229,254290,127145,127145,4BnQKPLuE3DMTtxp8MjUBytgnhvxqq3ZTqZHTVZo4JJh,10171622,83537574,-73365952,618
2022-01-10 14:34:34.127757,2022-01-10 09:20:19-05:00,3130,KoCscQ9Q8TZHhmya5KaXBrwUEMTdCkEMRtrhvtgEmiZ,6aZ5AFMFoqf1X64RwAt1J4Yrx4WGGe2JMiEjqnQ2gEtk,True,645518,161379,1002,501,501,4BnQKPLuE3DMTtxp8MjUBytgnhvxqq3ZTqZHTVZo4JJh,40083,144566,-104483,620
2022-01-10 14:34:34.127757,2022-01-10 09:20:19-05:00,3131,2NdwSLxsGok8PczpCZj9CVX2BymNU5MvHt7hWfGetg2M,8AQbDXeA6mD9QoZBFJcYbnHvZwKNxzA9CCHLAgdSfTA3,True,14583,3645,22,11,11,DddJ7EWCmYEEZETCBNgAUSg81Ls6fZtiAaY5ekJ5sXx1,907,7441,-6534,621
2022-01-10 14:34:34.127757,2022-01-10 09:20:21-05:00,3132,BzSJ77zKaqtBk2cEL1XqFL97zTXXMRHmxtkgtXwCc3C,2g4KXTwy2MPSRQ2khNp1o1rn7CradEr9H4ySYKDoSWN9,True,13827451,3456862,21448,10724,10724,3zqXX6kzhkbW3d4TwD2CNjMRwxTbREXySekvq37kfCNk,857951,12886932,-12028981,620
2022-01-10 14:34:34.127757,2022-01-10 09:20:21-05:00,3133,6WNPf4rFCX74PuyvdmzRFqbxWhguuxTQqBSdnaTVBd5D,9N7a9aiHGQsxFMgVbmWoCF9w95d12xyT7XFAwpHGkTLA,True,2061540,515385,3223,1611,1612,3zqXX6kzhkbW3d4TwD2CNjMRwxTbREXySekvq37kfCNk,128933,556458,-427525,625
2022-01-10 14:34:34.127757,2022-01-10 09:20:23-05:00,3134,EQUZQWk4WLT6LFeWZs3P9AQufFcoZouFETfhyxvuS2JM,Byc2mLXArmkjQPWaxCJksHZD2XpZyCQ2FRtDJyztU81V,True,130100928,32525232,201636,100818,100818,3zqXX6kzhkbW3d4TwD2CNjMRwxTbREXySekvq37kfCNk,8065457,71290503,-63225046,619
2022-01-10 14:34:34.127757,2022-01-10 09:20:25-05:00,3135,EV21gv8jEvXtmGDoGRNm5LJEvTBccLMZyVDCLsp54jP3,DGxxoU52aQNoUQcxdvQtv2H5q2PhK6TGkLgNSaFgnZrb,True,6106579,1526644,9458,4729,4729,3zqXX6kzhkbW3d4TwD2CNjMRwxTbREXySekvq37kfCNk,378356,2578967,-2200611,619
2022-01-10 14:34:34.127757,2022-01-10 09:20:25-05:00,3136,8BMDSWFtzq9fu1ubVGtSFw8fEaMg1uvJiECuJnN8e1pd,FwkETAXL296CirvQ2AJuSHHtdKsxkZkmXSwZVVHXVDhA,True,178179763,44544940,275776,137888,137888,72FwbpFGoLEazJEdpqNtPNefsadUrimUqma9wSoy4qiS,11031077,70159289,-59128212,619
2022-01-10 14:34:34.127757,2022-01-10 09:20:25-05:00,3137,AtKuDfcFXqWUMnRqQpjedUMTb5CQKLc2zoqEAcQpysKQ,9bPFLYp5TDZruLLDXDYYCiPYcD982iF8xt5rfTkqwNsL,True,15236,3809,23,11,12,3zqXX6kzhkbW3d4TwD2CNjMRwxTbREXySekvq37kfCNk,948,5939,-4991,622
2022-01-10 14:34:34.127757,2022-01-10 09:20:26-05:00,3138,8aKqLY7GXxNnGRK8Utke7o6EDGZATNDDF8Ph9Q27ppyi,7MQKkebLEzQgjWjByBMzzkn68yqtYivS4VDcraAScZR6,True,1359524,339880,2077,1038,1039,4BnQKPLuE3DMTtxp8MjUBytgnhvxqq3ZTqZHTVZo4JJh,83112,393253,-310141,611
2022-01-10 14:34:34.127757,2022-01-10 09:20:27-05:00,3139,EeUACm9TkjHKES5U7Yj1oPhYmcp7R3tvesGBiP8txEzq,3qkmm4aS6EDirEDejmbm5PDw2jpYkC7zKqrMkmgeE5BA,True,316244,79061,490,245,245,3zqXX6kzhkbW3d4TwD2CNjMRwxTbREXySekvq37kfCNk,19629,109319,-89690,620
2022-01-10 14:34:34.127757,2022-01-10 09:20:38-05:00,3140,7LRBswSEDBjJzQ4YurfTxLydh7tFS2jVn5V95Z6wL7ci,fD41VYGmk66MW46KKb23vAqQvUSDScgXnVdsHhJBZzu,True,161075,40268,248,124,124,4BnQKPLuE3DMTtxp8MjUBytgnhvxqq3ZTqZHTVZo4JJh,9924,76923,-66999,616
2022-01-10 14:34:34.127757,2022-01-10 09:20:38-05:00,3141,s2NgHqXLYtUrRaA6LnDwmxcS5nqfURXw47DmLy7Pn9E,2qn4QbLj5miEB2zZB4v5dhptm3JRbpQRrpTBgPDzokw1,True,2887007,721751,4437,2218,2219,3zqXX6kzhkbW3d4TwD2CNjMRwxTbREXySekvq37kfCNk,177501,2099387,-1921886,614
2022-01-10 14:34:34.127757,2022-01-10 09:20:38-05:00,3142,99NHcwD1iaf5FXM3UNb91SjNiiT3HwyQFQMhkGd5ASts,8syAydy52vSQQLzsLXW24BFw4VPeK66Vp3BmAbnHfgod,True,67651892,16912973,104440,52220,52220,DddJ7EWCmYEEZETCBNgAUSg81Ls6fZtiAaY5ekJ5sXx1,4177602,28926564,-24748962,617
2022-01-10 14:34:34.127757,2022-01-10 09:20:38-05:00,3143,CAkknoa9UFPMEZ1KWSfqtmnL7ArVNV3HRETLwecuuXP,4cHJYv3dxA6qjcuxUkGRuL7STWobGPKtoHFD4ACUbiWq,True,14314013,3578503,22069,11034,11035,3zqXX6kzhkbW3d4TwD2CNjMRwxTbREXySekvq37kfCNk,882762,5699557,-4816795,616
2022-01-10 14:34:34.127757,2022-01-10 09:20:42-05:00,3144,8VT2nxz5ZYDJFd9uL2XZwEXxChd9pjuMJNMAcutZubL1,EhAkiRbouzUAWtqQFsN8HEEfi46UVN8H8tyBP7CbgeLe,True,12542,3135,19,9,10,4BnQKPLuE3DMTtxp8MjUBytgnhvxqq3ZTqZHTVZo4JJh,769,5775,-5006,613
2022-01-10 14:34:34.127757,2022-01-10 09:20:42-05:00,3145,243SAnGxchCVB1LQAUF4SsozR86yDwEdg2QQpbWGsMYe,5u8sNkb2oEQjUXJAB3yGStmv3Uwz16gBgExBo5myVK4b,True,13697793,3424448,21273,10636,10637,4BnQKPLuE3DMTtxp8MjUBytgnhvxqq3ZTqZHTVZo4JJh,850945,4956035,-4105090,621
2022-01-10 14:34:34.127757,2022-01-10 09:20:42-05:00,3146,FSduW743jAGyyn8HTifEJitgb89Spp5gEeMXDE59aEHF,HjojGNpR3ACtLCP2mP8DKGyXj6SeqWPKjcCAofcyQpsm,True,252584814,63146203,389096,194548,194548,3zqXX6kzhkbW3d4TwD2CNjMRwxTbREXySekvq37kfCNk,15563864,90560497,-74996633,616
2022-01-10 14:34:34.127757,2022-01-10 09:20:42-05:00,3147,Mcbzp1LhZwpfmXTv1pqe9D1jCKHw443j9QKp6tUpzgM,8uforSMAKEih5jHfHp3gCqCvaugtCmhzVfVHA63Akz7F,True,2727267,681816,4183,2091,2092,3zqXX6kzhkbW3d4TwD2CNjMRwxTbREXySekvq37kfCNk,167343,1399237,-1231894,613
2022-01-10 14:34:34.127757,2022-01-10 09:20:42-05:00,3148,aTkGURJptmKNNP6RSXSWsmVbfcriSAJaMuUiT2eZEfb,5qoGxL83PLhrguyk27X8xE6jGitRg5BaQpXzrcfEvCfJ,True,264884253,66221063,410062,205031,205031,3zqXX6kzhkbW3d4TwD2CNjMRwxTbREXySekvq37kfCNk,16402511,91532879,-75130368,619
2022-01-10 14:34:34.127757,2022-01-10 09:20:48-05:00,3149,2RZPBo8Z2BgZmsASo14ySTSwqqgqmfVEjPkiAwQ1VTgf,BRS5cYtEoPRoSvTAiQaT1svWRdLJWVfy8LUb4SCudCjS,True,6695739,1673934,10403,5201,5202,3zqXX6kzhkbW3d4TwD2CNjMRwxTbREXySekvq37kfCNk,416129,2702182,-2286053,621
2022-01-10 14:34:34.127757,2022-01-10 09:20:52-05:00,3150,C7a8BtMjuLXkzxZBC4Wk2gjkGBmucLmDjokf9pyA1Mu6,GxwYNWwYTtFMUxuZvNC5qrEYuJzYiEURQVuBxssfCJzr,True,2095638,523909,3251,1625,1626,72FwbpFGoLEazJEdpqNtPNefsadUrimUqma9wSoy4qiS,130051,565666,-435615,620
2022-01-10 14:34:34.127757,2022-01-10 09:20:59-05:00,3151,CEbGTNX6WpaoKp4RBGSn9LzYM6yAYyeiMrgVYgJxA4zb,AiXUcGAFFm4tc7vKBscSNjZawV5YJqbv7D1KpxD3Zufg,True,24963030,6240757,38866,19433,19433,4BnQKPLuE3DMTtxp8MjUBytgnhvxqq3ZTqZHTVZo4JJh,1554647,13447728,-11893081,622
2022-01-10 14:34:34.127757,2022-01-10 09:21:00-05:00,3152,FnAT8HKGgisYfeAbxKU2gSbCp8KbZHULRpaJX1NVijHy,2u637Crc2QzfSJmCnRNqeib3aZQVn4NGncpgM3Ph6jvm,True,44497370,11124342,69517,34758,34759,4BnQKPLuE3DMTtxp8MjUBytgnhvxqq3ZTqZHTVZo4JJh,2780694,14813246,-12032552,624
2022-01-10 14:34:34.127757,2022-01-10 09:21:00-05:00,3153,ZoNjrSjYh4NJLW38LUPcf7jtEBxdaaM7T1zp795qjHE,FZx6v8cU25NwEosbKJ2n141o9uFAWURZB7NeCeX1trEn,True,1922284,480571,2963,1481,1482,4BnQKPLuE3DMTtxp8MjUBytgnhvxqq3ZTqZHTVZo4JJh,118542,516573,-398031,616
2022-01-10 14:34:34.127757,2022-01-10 09:21:00-05:00,3154,3axqGcX5yuJ2vGxRjtNguefXUvSQHDQmn2zskhyCuQkf,EYrZo9zZDaHqFdc1fam63W3jvqqmbU67wzp6yFcppwsL,True,36720197,9180049,56447,28223,28224,3zqXX6kzhkbW3d4TwD2CNjMRwxTbREXySekvq37kfCNk,2257904,29531243,-27273339,614
2022-01-10 14:34:34.127757,2022-01-10 09:21:00-05:00,3155,5hUZ9uQFcYnjAQVVaGLJWdKyg7y1XMpoo8osQ9DeY7Xd,BdYiKWsjuzJLcHh3814mJ4xQ9JxoQKKcr7AHZ7Vxoavq,True,55380,13845,85,42,43,72FwbpFGoLEazJEdpqNtPNefsadUrimUqma9wSoy4qiS,3408,23105,-19697,615
2022-01-10 14:34:34.127757,2022-01-10 09:21:01-05:00,3156,4hrm69kAKNcfBkiP2YgtW94Pbip6FLfQAwnDRAAack69,BjbZRdGMoC7Mfoa4H19UvE2eQafgKD5rqnK7BSGwqS1s,True,46294,11573,71,35,36,4BnQKPLuE3DMTtxp8MjUBytgnhvxqq3ZTqZHTVZo4JJh,2843,18983,-16140,614
2022-01-10 14:34:34.127757,2022-01-10 09:21:05-05:00,3157,BJaaH1SK1pF2kZQzmYpLFfDtm52CR9a5rd39RAPtLe8q,HUsT5FVxaisdnCvG1BQxX6zffjfL2Rwx5mMo5y8SDV7e,True,50577261,12644314,78757,39378,39379,4BnQKPLuE3DMTtxp8MjUBytgnhvxqq3ZTqZHTVZo4JJh,3150296,14817935,-11667639,622
2022-01-10 14:34:34.127757,2022-01-10 09:21:06-05:00,3158,DiPSJvnnEwg1En7HJfEsKrUbBgtUf4KzGMyMCZDQSYgp,s8UVC6vPBofuXUS6RW1aQmZ8C35PrC5r4A6ugmvzLGB,True,2447926,611981,3820,1910,1910,DddJ7EWCmYEEZETCBNgAUSg81Ls6fZtiAaY5ekJ5sXx1,152812,658015,-505203,624
2022-01-10 14:34:34.127757,2022-01-10 09:21:08-05:00,3159,Buioe5v3DyFwD9nquW5XdYeVYbSABCyg79eUHEvtvfaW,7T9gi7prCcZJkYJMSB5Ef6Bu4pAuBw4XLvumSFnqKDSi,True,889594,222398,1362,681,681,4BnQKPLuE3DMTtxp8MjUBytgnhvxqq3ZTqZHTVZo4JJh,54505,481657,-427152,612
2022-01-10 14:34:34.127757,2022-01-10 09:21:09-05:00,3160,DiB9SeCFXjioNGPJM3GuZ3FCG9KBZhHK27zCSN5b6gkq,GtK8UtKDQy9jgtTXvam4jja9N7c4EFuDQr4TKHgNyhXT,True,5523741,1380935,8467,4233,4234,HfEnetJ7uBSmZWCjBNxdvv9HEC5nsW4wDV7wu6WnhWan,338694,2466306,-2127612,613
2022-01-10 14:34:34.127757,2022-01-10 09:21:09-05:00,3161,3zH1b58jqbNU37y9kDTZZrotSeT8XzS1tuyAHPKWrbah,4trxDWV16x6sVcz7bxHehYHkjjyKebh3S9fyJf8txzK5,True,9519,2379,14,7,7,3zqXX6kzhkbW3d4TwD2CNjMRwxTbREXySekvq37kfCNk,589,3753,-3164,618
2022-01-10 14:34:34.127757,2022-01-10 09:21:09-05:00,3162,J1sBDjpdBZcsSBS5eg95SSRjRqmQUR9cXJCsLJu8yCUt,F5wRpD2senMkGbL8Uquqo8W9x5NQDDa268dHuVFAZCww,True,4572679,1143169,7134,3567,3567,3zqXX6kzhkbW3d4TwD2CNjMRwxTbREXySekvq37kfCNk,285368,2130343,-1844975,624
2022-01-10 14:34:34.127757,2022-01-10 09:21:11-05:00,3163,93ho4cgnpAJiJsG6uu2udkLVNU7rkz4QjCYfsqvpbPA5,45ouQn9gGwXqnTGfaP5CvU8fCKadBRA5kPwtfvJzykRU,True,79790767,19947691,124535,62267,62268,4BnQKPLuE3DMTtxp8MjUBytgnhvxqq3ZTqZHTVZo4JJh,4981416,27659694,-22678278,624
2022-01-10 14:34:34.127757,2022-01-10 09:21:11-05:00,3164,C4dbwF9mioaBkZnyBFvFs6Cqd362VuGPBGPbTY9CAnAk,CcUqBfu1hbWm5VVxbtF2Xm6HUz4CLFzuDsjUi6KtnZQg,True,2236199,559049,3427,1713,1714,4BnQKPLuE3DMTtxp8MjUBytgnhvxqq3ZTqZHTVZo4JJh,137118,600922,-463804,613
2022-01-10 14:34:34.127757,2022-01-10 09:21:11-05:00,3165,2ce2v2TCbjNH635NgbwTG3sqiRWYrRRaBpxPxBZJ929q,9cnoebT43FkWDFhidndGCVNiFD4NErv8DuL1Va4Jv9S8,True,7566295,1891573,11749,5874,5875,DddJ7EWCmYEEZETCBNgAUSg81Ls6fZtiAaY5ekJ5sXx1,469975,5701193,-5231218,621
2022-01-10 14:34:34.127757,2022-01-10 09:21:11-05:00,3166,FjDp4bWCtqehFD7FunCrjrcdxMezTJj5aqh2VnBvHDQU,HRYeZqcqhP1RPiAGXziR1qCWwk4sF6c5ZYbvSDhX7foN,True,10085218,2521304,15492,7746,7746,3zqXX6kzhkbW3d4TwD2CNjMRwxTbREXySekvq37kfCNk,619719,3881591,-3261872,614
2022-01-10 14:34:34.127757,2022-01-10 09:21:13-05:00,3167,9gYrMXAGmGSV4VFjXzYP5WwH2aFpB1TxA6CqpYsosKLv,Dh8aH6RK48wu4fkT9xKw5XL7itxnPDuw3SDwPwvL5sva,True,33301,8325,51,25,26,4BnQKPLuE3DMTtxp8MjUBytgnhvxqq3ZTqZHTVZo4JJh,2077,13374,-11297,623
2022-01-10 14:34:34.127757,2022-01-10 09:21:13-05:00,3168,4FazDUgfQ3AKoFcnWHr8E9Ht8jLA3tkxf75yrGZVHdmF,HzRMH6mbgEKydRCnnMvSsKgTEVNQi6nuzoR1xutYFdzg,True,77085,19271,120,60,60,4BnQKPLuE3DMTtxp8MjUBytgnhvxqq3ZTqZHTVZo4JJh,4808,54338,-49530,623
2022-01-10 14:34:34.127757,2022-01-10 09:21:13-05:00,3169,3g1debT8Z2efQPuMNSDPUNZzDqarBG2acErsZ4HP7QGA,42wDHagxr5Nno3mUx6kyYGDjwR98aedRbh3ByB468agB,True,23787,5946,37,18,19,4BnQKPLuE3DMTtxp8MjUBytgnhvxqq3ZTqZHTVZo4JJh,1485,9607,-8122,624
2022-01-10 14:34:34.127757,2022-01-10 09:21:13-05:00,3170,8mbMH9EKd9kQDyFrYiDJCV9VaWxWCzpZBQZLyYN2yNVx,J9gT39dF1egMeQvweXYWeRAX3kpmBABijYZhfj6M2UqU,True,30671477,7667869,47035,23517,23518,4BnQKPLuE3DMTtxp8MjUBytgnhvxqq3ZTqZHTVZo4JJh,1881403,10360596,-8479193,613
2022-01-10 14:34:34.127757,2022-01-10 09:21:16-05:00,3171,5BjBPqumCb9KC82ZNNch3dcRzbpGdRLJneru7o9a1D9R,FuZtBWKktxFu4yoiLVMzxq8fMhQyN8SGzGPz49xs3m6P,True,185274989,46318747,286923,143461,143462,DddJ7EWCmYEEZETCBNgAUSg81Ls6fZtiAaY5ekJ5sXx1,11476954,89336054,-77859100,619
2022-01-10 14:34:34.127757,2022-01-10 09:21:16-05:00,3172,EgU9hX6VK7YXeCgCHVaJAMekCcyZa2MVWdKra5pN7Gwv,7y8Ad9XY34bqREvheXHT2tr8Jy11D6X3pu7yLVtjU4QV,True,12455722,3113930,19189,9594,9595,3zqXX6kzhkbW3d4TwD2CNjMRwxTbREXySekvq37kfCNk,767578,6011379,-5243801,616
2022-01-10 14:34:34.127757,2022-01-10 09:21:18-05:00,3173,9KD2AifD5wFD4QkHYuawXbJgLWHrfj2QPF3fT8jhGVA5,Ga9gAqmkuHbqrr31sUFPqa1xa5WNxLWJWGPUaMxQqLdj,True,1262920,315730,1976,988,988,4BnQKPLuE3DMTtxp8MjUBytgnhvxqq3ZTqZHTVZo4JJh,79050,737542,-658492,625
2022-01-10 14:34:34.127757,2022-01-10 09:21:18-05:00,3174,7MSzV5yy5FmrM4j1BcYSRiTGWfit1AJahheRUaXzz349,aPSTZLxBpVr3sucjbj95emRV2J1GrUWr7wbARYqJkQZ,True,5599377,1399844,8731,4365,4366,3zqXX6kzhkbW3d4TwD2CNjMRwxTbREXySekvq37kfCNk,349262,1878527,-1529265,623
2022-01-10 14:34:34.127757,2022-01-10 09:21:19-05:00,3175,H6tDNj9cHac223ckAnNfnC4bAJuNLBnf2pFk2iQdMzMP,28UL9dqgayCqCAexScXjdpobYGVDN44SGBVNAfBByk8C,True,84130748,21032687,131099,65549,65550,3zqXX6kzhkbW3d4TwD2CNjMRwxTbREXySekvq37kfCNk,5243970,46168886,-40924916,623
2022-01-10 14:34:34.127757,2022-01-10 09:21:19-05:00,3176,87R8o8xLjHw2GpunYkm7pX7uJ8hjM4B1y4Qm7aQf6Yh4,48aSVPQoFYdncF5NtJ114urbdTzVjTgYLgPzMfpJbZB3,True,80368493,20092123,125374,62687,62687,3zqXX6kzhkbW3d4TwD2CNjMRwxTbREXySekvq37kfCNk,5014969,73145868,-68130899,623
2022-01-10 14:34:34.127757,2022-01-10 09:21:22-05:00,3177,EEcTbsFTUEifcdbPyjBLkS943daEx1RpR8F3uZxKRZbT,8V3JzDQ1VWYQLas8fxUsWJZZHe4gEmn74RehtUwLw3k5,True,6730360,1682590,10351,5175,5176,4BnQKPLuE3DMTtxp8MjUBytgnhvxqq3ZTqZHTVZo4JJh,414071,3222898,-2808827,615
2022-01-10 14:34:34.127757,2022-01-10 09:21:45-05:00,3178,HwosLQgDY1xtHQRQ4hzroPQHFWssPzTj5vRkP37FcviB,HKTNEYNXrephNkH7apbobK4mcQXcNayQA4W1NgM6sLr8,True,43681836,10920458,67465,33732,33733,3zqXX6kzhkbW3d4TwD2CNjMRwxTbREXySekvq37kfCNk,2698634,14307898,-11609264,617
2022-01-10 14:34:34.127757,2022-01-10 09:21:46-05:00,3179,FsMiJiJZibohKoV5QRisWCjzuFd86xSxFb4m73AQmu93,7p3TSKBaG9SV2YNDnhutQKacPKpTTmgsEfzmK51t6sYb,True,270434451,67608612,417773,208886,208887,3zqXX6kzhkbW3d4TwD2CNjMRwxTbREXySekvq37kfCNk,16710956,90397999,-73687043,617
2022-01-10 14:34:34.127757,2022-01-10 09:21:47-05:00,3180,AUH6YGBV8tDVX1E1WTo92Mubfx1DGsqfGeyUBqxo4fSr,33QZgMwmW32WuvmxD8XNbmF9ea88bLe3YTtNwHV73Wwu,True,270588742,67647185,417469,208734,208735,4BnQKPLuE3DMTtxp8MjUBytgnhvxqq3ZTqZHTVZo4JJh,16698791,92597960,-75899169,617
2022-01-10 14:34:34.127757,2022-01-10 09:21:48-05:00,3181,3VdSA9CED9f5swRwHX2U15U7J6Muaq8VPnCNy9CaGDHe,2YYstfnfdYic5NWmEbcUEHpccNUVd1EhuCkExvMsoMk8,True,6495041,1623760,10105,5052,5053,3zqXX6kzhkbW3d4TwD2CNjMRwxTbREXySekvq37kfCNk,404228,3757704,-3353476,622
2022-01-10 14:34:34.127757,2022-01-10 09:21:48-05:00,3182,6d6HN8LWikwW2HYdy3BABWuxKHt1sgv4DcneACR133sE,4eKvzmfFvX96XbujKBhUauAvWP4yQYwZH3pd7gXzbCvJ,True,2096647,524161,3269,1634,1635,3zqXX6kzhkbW3d4TwD2CNjMRwxTbREXySekvq37kfCNk,130787,565393,-434606,623
2022-01-10 14:34:34.127757,2022-01-10 09:21:51-05:00,3183,E9FFPvygPSF22u7gqFq4w6yE5kV15zbeGDXFQc349RsG,yi1REPVUwKhr5ss5YJc56crYz8LVfkqNVMpKcdSfwfY,True,2098877,524719,3250,1625,1625,3zqXX6kzhkbW3d4TwD2CNjMRwxTbREXySekvq37kfCNk,130020,562396,-432376,619
2022-01-10 14:34:34.127757,2022-01-10 09:21:54-05:00,3184,A36aouot1oFLUtswuBUM4EVcis9chKaSJu53MRoPDjab,33U9gpq1RRFMGWDrWa3ezXXkwgBewdAS6QGgGVPtGvqb,True,348910278,87227569,543971,271985,271986,3zqXX6kzhkbW3d4TwD2CNjMRwxTbREXySekvq37kfCNk,21758865,115881801,-94122936,623
2022-01-10 14:34:34.127757,2022-01-10 09:22:00-05:00,3185,ECuu1L4QGdemZ7FjAjVAAxYN6piinweY7Fuk5csVovfT,Amd8WGcpdtB8yoA83R1BUT5uryuqoKbcBexYacbrbGVX,True,3835127,958781,5961,2980,2981,72FwbpFGoLEazJEdpqNtPNefsadUrimUqma9wSoy4qiS,238476,1389987,-1151511,621
2022-01-10 14:34:34.127757,2022-01-10 09:22:03-05:00,3186,4mB2DVbQVqVk535v98Cj8SPNg1tTc3DFyY2Q7VBbY645,HXo255k3RgsTGsc4hiP6ZTXUspBTqJ37duQa5eK7tqp3,True,657813404,164453350,1025207,512603,512604,4BnQKPLuE3DMTtxp8MjUBytgnhvxqq3ZTqZHTVZo4JJh,41008313,238840258,-197831945,623
2022-01-10 14:34:34.127757,2022-01-10 09:22:06-05:00,3187,5kwvkEtRFFD84j4ntVgxkacadgJaFvQ9JLhJqzLR7Y3G,GpMMkTv9T7y8DTiizuoJUsWvnSk3GSxADjRMGyYpryxm,True,30398633,7599658,46881,23440,23441,3zqXX6kzhkbW3d4TwD2CNjMRwxTbREXySekvq37kfCNk,1875247,9713563,-7838316,616
2022-01-10 14:34:34.127757,2022-01-10 09:22:08-05:00,3188,5Rxuqgs4CaSKbfDXqBMFXkLTQ9dxrUjThXzoy3ouYVtK,BgvbKru66ebrGUcFFymGTmsaQv6GgcGMybiWaXqzBtwX,True,200196,50049,310,155,155,4BnQKPLuE3DMTtxp8MjUBytgnhvxqq3ZTqZHTVZo4JJh,12426,122395,-109969,620
2022-01-10 14:34:34.127757,2022-01-10 09:22:08-05:00,3189,7W6ih2ZGXaE6tvuQFUPCvc7NvEJHy7UffgoVX3ZPdLXt,6uQCkeMjEXHBQxE2HD33RM1zyTsSko1fYZA1mWUggJ5B,True,32283,8070,50,25,25,4BnQKPLuE3DMTtxp8MjUBytgnhvxqq3ZTqZHTVZo4JJh,2018,13490,-11472,625
2022-01-10 14:34:34.127757,2022-01-10 09:22:09-05:00,3190,FLTW9fwjWqGPm5PiE3C9LFzwZxtDh8c2MnEoRq8W7MfQ,GKsfzKBP2QkmoEWvTaUN1h4nqrT3kAcwYRC9WxW9bB3h,True,15478321,3869580,24186,12093,12093,3zqXX6kzhkbW3d4TwD2CNjMRwxTbREXySekvq37kfCNk,967457,5262147,-4294690,625
2022-01-10 14:34:34.127757,2022-01-10 09:22:16-05:00,3191,BPRoaqrDs8vhqv2T7d9qV2oPU33pi1K1LUaotM7yuD2i,6qo8uQGAEwBfYQR36v6nRiqA2xGV6SjJAsXsdzy5bqNH,True,1300123604,325030901,2020464,1010232,1010232,3zqXX6kzhkbW3d4TwD2CNjMRwxTbREXySekvq37kfCNk,80818580,580722624,-499904044,621
2022-01-10 14:34:34.127757,2022-01-10 09:22:17-05:00,3192,3ogBPSRcKfmwzgumVDHBkXLi1eCsEFG2xzSJgD4LQDNy,7TXyqWgJqfe71MSWFA2n7ufZbUdzf7JJoWej8FNNtMXo,True,20289167,5072291,31562,15781,15781,4BnQKPLuE3DMTtxp8MjUBytgnhvxqq3ZTqZHTVZo4JJh,1262496,7963123,-6700627,622
2022-01-10 14:34:34.127757,2022-01-10 09:22:18-05:00,3193,8trkirSQNdMmAcJdeswxs5cPjH8dD6U4eJtWiAdMsrDB,HaSzpQ45x2MipfN17U6jGBxX8tXboomVDhXNSrnEfLDr,True,4293593,1073398,6631,3315,3316,4BnQKPLuE3DMTtxp8MjUBytgnhvxqq3ZTqZHTVZo4JJh,265247,1798924,-1533677,617
2022-01-10 14:34:34.127757,2022-01-10 09:22:21-05:00,3194,BxXXWywnC3dSyLPJHt7owfBhgSiBWzkuD3T8hGYLqCH6,4vuwEBXXbXFMPmbJJJRop4FCWGyKR1sXhBc3EWF6MiB8,True,119371707,29842926,183439,91719,91720,DddJ7EWCmYEEZETCBNgAUSg81Ls6fZtiAaY5ekJ5sXx1,7337563,66074651,-58737088,614
2022-01-10 14:34:34.127757,2022-01-10 09:22:25-05:00,3195,9LZ3rShLfzErXsGkh4dYfAm58GNPWhK6ohDy5RrLJhc,41tLyuvuJ5M7YctkSASD2R7RGGetD7FmKaZUdkTdgXgt,True,1812636,453159,2734,1367,1367,3zqXX6kzhkbW3d4TwD2CNjMRwxTbREXySekvq37kfCNk,109397,490514,-381117,603
2022-01-10 14:34:34.127757,2022-01-10 09:22:27-05:00,3196,4kbcrzH6o2LvLUCNphyL52i8uGzVD8wcUNEqoQ14z3VG,5Q1atmEBs2AqaDZsiZFG5stHzj1fE6ZvypgfkEc9LYqE,True,223290412,55822603,340196,170098,170098,4BnQKPLuE3DMTtxp8MjUBytgnhvxqq3ZTqZHTVZo4JJh,13607843,121994448,-108386605,609
2022-01-10 14:34:34.127757,2022-01-10 09:22:27-05:00,3197,2bikYf33ZxxDmvkMNjWDGGqEpbYJPvWv5At3hzyeLEQK,5FtirUBjRAZ3k5arFFVwKz42ixWzhkEBLkaK9PraRZ78,True,183459,45864,277,138,139,3zqXX6kzhkbW3d4TwD2CNjMRwxTbREXySekvq37kfCNk,11103,62579,-51476,605
2022-01-10 14:34:34.127757,2022-01-10 09:22:27-05:00,3198,2VyFcgZDH1HTEvD1XaWhwqBCMmZ1k6TmZ3fEpPcBZR9E,G1wFJETTpdoc7CfypGCzkq1jssXPfUkiuLjK2cwVZ9dJ,True,100347,25086,152,76,76,3zqXX6kzhkbW3d4TwD2CNjMRwxTbREXySekvq37kfCNk,6103,50386,-44283,608
2022-01-10 14:34:34.127757,2022-01-10 09:22:30-05:00,3199,CCHzYXr5zMXFu8MMZNkfUWGyUcF8xy7Vvhq7tNCtZg2L,AuEXkCJTTJ3HK8iP4qTWpQr4vp6HPRJZyZwfRjF8zjfp,True,183453,45863,278,139,139,3zqXX6kzhkbW3d4TwD2CNjMRwxTbREXySekvq37kfCNk,11133,62615,-51482,606
2022-01-10 14:34:34.127757,2022-01-10 09:22:30-05:00,3200,7g4NJBHwDTRm58GqX7Tz1JzqwbAhF6EWJUQH3SoDxSf7,82Ypv7STZeSCBPf3HckWdyatELpvaDaWxFXhD5dNSML4,True,29138,7284,43,21,22,3zqXX6kzhkbW3d4TwD2CNjMRwxTbREXySekvq37kfCNk,1759,11870,-10111,603
2022-01-10 14:34:34.127757,2022-01-10 09:22:31-05:00,3201,DJiXXW7sjNsAAxWupDKBUsFhXSgPoerVYaAtJqqNgVbn,2MsqvNuJw1xQhJ3UnXt9i7oNHDuZpR9w7iE1WQcGqt5m,True,183453,45863,278,139,139,3zqXX6kzhkbW3d4TwD2CNjMRwxTbREXySekvq37kfCNk,11125,62606,-51481,606
2022-01-10 14:34:34.127757,2022-01-10 09:22:32-05:00,3202,2p2fGXdKrmxjomLSnyaNg84J82cBBBNympZ6qQc8UZgU,HKAM8bazuLMUY6yapZJqYsgaWkTBqKHyMs1hSfpYsZGi,True,1016370845,254092711,1538155,769077,769078,3zqXX6kzhkbW3d4TwD2CNjMRwxTbREXySekvq37kfCNk,61526222,517489581,-455963359,605
2022-01-10 14:34:34.127757,2022-01-10 09:22:32-05:00,3203,2jDRvE3pQNjWy1NRFa4tzB3KmU5UkbUCHw8sQRFujo66,C4zNi2szDrEEh4coTF3WRUghfP4ZwAVVSYTLWfkejQRu,True,621763701,155440925,959420,479710,479710,3zqXX6kzhkbW3d4TwD2CNjMRwxTbREXySekvq37kfCNk,38376826,226294975,-187918149,617
2022-01-10 14:34:34.127757,2022-01-10 09:22:33-05:00,3204,GH6Q9E1jZPTTp46aDd57UNZPNS2D6PBSwyLL3EHSjGn2,2XvwZXNsrPWx4EfPvhTP933bzCC3SJHDQ8xARfrXdVY9,True,24717992,6179498,38015,19007,19008,3zqXX6kzhkbW3d4TwD2CNjMRwxTbREXySekvq37kfCNk,1520620,20752566,-19231946,615
2022-01-10 14:34:34.127757,2022-01-10 09:22:33-05:00,3205,921FBgLS3A1wA77uWitsnTvW737Q2jY7tzvgWtWLXNC7,E4eJ9H7cqP9zNpMH5xRBTAp9yaBCBihuJBNd6pqzteDG,True,183450,45862,278,139,139,3zqXX6kzhkbW3d4TwD2CNjMRwxTbREXySekvq37kfCNk,11127,62613,-51486,606
2022-01-10 14:34:34.127757,2022-01-10 09:22:33-05:00,3206,5jin5wXjQQ25nGM2ECrCXcg1a95vquh6kM7rMRru6Ke7,EKM657EQ8HWWgf4cssByoYHoXGjFfTspTKXAGmygAPQG,True,47078934,11769733,73198,36599,36599,4BnQKPLuE3DMTtxp8MjUBytgnhvxqq3ZTqZHTVZo4JJh,2927936,22787658,-19859722,621
2022-01-10 14:34:34.127757,2022-01-10 09:22:34-05:00,3207,5BJnMHFSiQjHRGFJDW1jnqCfkHHYWnQzmmccy9eA4jNj,9517JGYsPmvgPUM9pFRD2vipHmdgE578F7jA7Qq6jorm,True,503837910,125959477,786606,393303,393303,4BnQKPLuE3DMTtxp8MjUBytgnhvxqq3ZTqZHTVZo4JJh,31464279,215007240,-183542961,624
2022-01-10 14:34:34.127757,2022-01-10 09:22:34-05:00,3208,3VYtHvoT9wi4K1PBjg6JjCf6U9fVPDf6tX9jyRRvLxcg,Ba5fjpVyAxLbiP6hYJmrxzougi7JUEDfDLKBxSbbTL7q,True,563517120,140879279,869284,434642,434642,4BnQKPLuE3DMTtxp8MjUBytgnhvxqq3ZTqZHTVZo4JJh,34771364,108194244,-73422880,617
2022-01-10 14:34:34.127757,2022-01-10 09:22:34-05:00,3209,A1j2G5FZRyWSjFt6dK87WHhLkQrPUVqHaM3KhSzhAKDT,2fMiHLYm4pL3YCd8aveTR4mT9uVxztQeMwb5eRZb4wUW,True,673838,168459,1053,526,527,3zqXX6kzhkbW3d4TwD2CNjMRwxTbREXySekvq37kfCNk,42128,317416,-275288,625
2022-01-10 14:34:34.127757,2022-01-10 09:22:34-05:00,3210,AGhvB6x3gmvAJSnr9UVtvhKqVg3Qgh1k4roHzrNHhAaa,HhhjXT6WJnz1HQfHcwKdBppuAhc8ncUcq1mkJ4EHqgpe,True,7906,1976,12,6,6,3zqXX6kzhkbW3d4TwD2CNjMRwxTbREXySekvq37kfCNk,485,3338,-2853,613
2022-01-10 14:34:34.127757,2022-01-10 09:22:34-05:00,3211,AA9zFZTXqBR8Mw1fwEH59edzBiswoGasRNWsi6aLeysB,4VeitxYqqtRxyfdSVpshdJ3EDcgksRVnaHvAqWxTeujH,True,2128965,532241,3289,1644,1645,3zqXX6kzhkbW3d4TwD2CNjMRwxTbREXySekvq37kfCNk,131575,576050,-444475,618
2022-01-10 14:34:34.127757,2022-01-10 09:22:34-05:00,3212,Ayx8dFsVzUBb9b7QKxw7YHJuhptdSitBXFEczXTaxe85,EvU1VLChnowi6ccSPeJRSk65njrqZfYouAN7SHePxsxf,True,29283,7320,45,22,23,3zqXX6kzhkbW3d4TwD2CNjMRwxTbREXySekvq37kfCNk,1831,14585,-12754,625
2022-01-10 14:34:34.127757,2022-01-10 09:22:34-05:00,3213,GGGyesjbt7h2XHHp9u8vpiWGugFwEbrtYaKrNQSDhQd7,8tydo1ZjGHmPBSqU33tywB3f9szdsHk1ckGFe4Ay5pgs,True,63185426,15796356,98599,49299,49300,3zqXX6kzhkbW3d4TwD2CNjMRwxTbREXySekvq37kfCNk,3943986,47144657,-43200671,624
2022-01-10 14:34:34.127757,2022-01-10 09:22:34-05:00,3214,HdfQweV1KuYSpWdycZbpGrUc8yMcY3ZczLn1agKXMJaf,G1Ae1PZHkANkwFnhUKS1tvdFEv8dAFeojBkezh6rUNMh,True,6949735,1737433,10797,5398,5399,4BnQKPLuE3DMTtxp8MjUBytgnhvxqq3ZTqZHTVZo4JJh,431881,3346881,-2915000,621
2022-01-10 14:34:34.127757,2022-01-10 09:22:34-05:00,3215,6dr65yANjSMmfBeKAuSxG3i16S9vMgF1CQ3zDyzh55Pn,EhrE5QpnshD41S4zPEBy2A5q2Gs2mwUrbHGo6WnT9zDP,True,418775,104693,654,327,327,3zqXX6kzhkbW3d4TwD2CNjMRwxTbREXySekvq37kfCNk,26163,208070,-181907,624
2022-01-10 14:34:34.127757,2022-01-10 09:22:34-05:00,3216,3Xbsek5MsEGoWr3G9yhuohREr26B2vSQcjqXdspTFHta,2rPxkUiMo9wGDq8EvAiwY3ngRpKmL223cBWWNTYoBmFp,True,297698508,74424627,451512,225756,225756,3zqXX6kzhkbW3d4TwD2CNjMRwxTbREXySekvq37kfCNk,18060484,104697276,-86636792,606
2022-01-10 14:34:34.127757,2022-01-10 09:22:35-05:00,3217,HkRKcvAWLM5sCDL6a5DvYsH55bg5BnZnyP9WwX7wLUDF,GXtDJS8BCoZKnvviGaUb2QfKs2LQQZPMa9564tf5Jq8Y,True,1911026602,477756650,2917742,1458871,1458871,4BnQKPLuE3DMTtxp8MjUBytgnhvxqq3ZTqZHTVZo4JJh,116709717,410919315,-294209598,610
2022-01-10 14:34:34.127757,2022-01-10 09:22:35-05:00,3218,ES1MDwRUa3hoToPKQiiZkzMYe9PDVnAQwMrEvZrzvnc1,C4wBG3xTDkmDQneB28xYnf1aBNEeq7UB8oR7NuEfLkFg,True,34460872,8615218,53583,26791,26792,3zqXX6kzhkbW3d4TwD2CNjMRwxTbREXySekvq37kfCNk,2143328,11678925,-9535597,621
2022-01-10 14:34:34.127757,2022-01-10 09:22:35-05:00,3219,5RvNKzSeJ1fvqsKpcQu25evEZGmKjyEDgwsMZkykoT3P,BRqSGfE4XHXu4HrinwetWumfVTmr82iuF6Y5oSV6eMiK,True,183604,45901,285,142,143,3zqXX6kzhkbW3d4TwD2CNjMRwxTbREXySekvq37kfCNk,11421,62752,-51331,622
2022-01-10 14:34:34.127757,2022-01-10 09:22:35-05:00,3220,7CSCMFa9W52tBDVUbXbc3woAy3GByeA1wPJdp3MgznPa,3447ptuVFu6G8B6N63RmS8mRv4n9PfHneypHLvbeaGLn,True,138202687,34550670,213704,106852,106852,3zqXX6kzhkbW3d4TwD2CNjMRwxTbREXySekvq37kfCNk,8548169,63162201,-54614032,618
2022-01-10 14:34:34.127757,2022-01-10 09:22:35-05:00,3221,HhwiZPKZBGa16oVi739s4qtMDMTwzWXc7iwNfX63t2UP,5AnbMbAFKy85yHt5y2M5S38nNkA1vT4ejY5NjGbRNUqn,True,1732713,433178,2615,1307,1308,3zqXX6kzhkbW3d4TwD2CNjMRwxTbREXySekvq37kfCNk,104602,1044339,-939737,603
2022-01-10 14:34:34.127757,2022-01-10 09:22:39-05:00,3222,7jvKp6onXyWgwsFrFWj4hYTXJsYYD6ot5mn6rPFuJriy,J7N6HiozevJVTiY9hDEUs2ud5BwT5QSE7wnMBS1w5ie2,True,55466438,13866609,85803,42901,42902,DddJ7EWCmYEEZETCBNgAUSg81Ls6fZtiAaY5ekJ5sXx1,3432136,28160019,-24727883,618
2022-01-10 14:34:34.127757,2022-01-10 09:22:39-05:00,3223,4D7mDXe7SdmbAx7kaD1mBNuEa7DzMi6TAwXURxtLEazk,5pSnT91PHoLdN6uhPnUtoD7cboLmndn26y1XouPx8vwW,True,1855437,463859,2838,1419,1419,3zqXX6kzhkbW3d4TwD2CNjMRwxTbREXySekvq37kfCNk,113528,630668,-517140,611
2022-01-10 14:34:34.127757,2022-01-10 09:22:48-05:00,3224,2QStaRnbSnDhA891Lb1bxjVeMYpJUpNdqaVkw3rqU45V,DakRWPnttPoRcjY5V7WLwiwBx39BapCo9Atog8dL17Ku,True,2831944,707986,4389,2194,2195,3zqXX6kzhkbW3d4TwD2CNjMRwxTbREXySekvq37kfCNk,175564,903194,-727630,619
2022-01-10 14:34:34.127757,2022-01-10 09:22:48-05:00,3225,3Lv2XpiD4KBUHq7Zx6u3zNhpXoySodXHH8o8f5yaaPxG,H6TN4rhpBXkEH3mZnymYNcKfmnxRH2uzfwzeLH2q6ahP,True,233565,58391,361,180,181,3zqXX6kzhkbW3d4TwD2CNjMRwxTbREXySekvq37kfCNk,14478,99741,-85263,619
2022-01-10 14:34:34.127757,2022-01-10 09:22:50-05:00,3226,6xikA6d7sjCBnSfqkFwrL4nPrtQUNWdRhXB7i1AccnxC,G8t7u2R9qjRfdTdULs74v3nVrTM2WeKvc4dK4FFAvuG1,True,46846542,11711635,72447,36223,36224,4BnQKPLuE3DMTtxp8MjUBytgnhvxqq3ZTqZHTVZo4JJh,2897884,10391342,-7493458,618
2022-01-10 14:34:34.127757,2022-01-10 09:22:50-05:00,3227,9E97vZ6evPgg1Ao8KwvjjZhBFW6dXZrrJENk1HvZ3SU,D7U38PB8BXLwUVKbRNv9po7VcFdnn7Y4tWY9xpRiNJsT,True,65657414,16414353,100234,50117,50117,4BnQKPLuE3DMTtxp8MjUBytgnhvxqq3ZTqZHTVZo4JJh,4009368,17780866,-13771498,610
2022-01-10 14:34:34.127757,2022-01-10 09:22:50-05:00,3228,6u6bPgAmK8ufACrQV99A1Y5nhGkue3KEUHmQQkcNkxwP,7636yXT5w4DcVpc7LJdN46aiggzSq6U2GXHXL5kyy9F3,True,148342130,37085532,229575,114787,114788,4BnQKPLuE3DMTtxp8MjUBytgnhvxqq3ZTqZHTVZo4JJh,9183020,71713288,-62530268,619
2022-01-10 14:34:34.127757,2022-01-10 09:22:53-05:00,3229,Gbxc51WERLLeCtiHv7rDvE52aqF541RoQWG5n5aqErq6,4ngBoHbfXijLMqGKxFMNht9sbmxy2g5eqBmn8QsBmbx1,True,1289425,322356,1975,987,988,3zqXX6kzhkbW3d4TwD2CNjMRwxTbREXySekvq37kfCNk,79022,564535,-485513,612
2022-01-10 14:34:34.127757,2022-01-10 09:22:53-05:00,3230,6CeKxTJvFqhyNEyzySiBBKEwYVMe7j3A6nkMes4BW6o2,DzDR9XvwY1z7ygQ8YrCXrwDGHSf67JZF8BzUnuFE2fxQ,True,5473825,1368456,8488,4244,4244,3zqXX6kzhkbW3d4TwD2CNjMRwxTbREXySekvq37kfCNk,339527,1983074,-1643547,620
2022-01-10 14:34:34.127757,2022-01-10 09:22:54-05:00,3231,8VnGmfop6qcUezAJ2M15jz2Nn6mPQgehDcJPvypq4XJn,6F6sqXNhgkW9ev8QNMm4ydywUUmemhwgydRQYNeqyUmi,True,13244013,3311003,20656,10328,10328,4BnQKPLuE3DMTtxp8MjUBytgnhvxqq3ZTqZHTVZo4JJh,826256,11312751,-10486495,623
2022-01-10 14:34:34.127757,2022-01-10 09:22:54-05:00,3232,3njiRuSRMXRzKmamyiR72Hc38PU8UDDmWdfPhgxmGxEW,5WoF3gkgygyNNbwxWgVfqGWkExcDixuzgJQQjXEZQ6J5,True,319046408,79761602,497280,248640,248640,3zqXX6kzhkbW3d4TwD2CNjMRwxTbREXySekvq37kfCNk,19891218,217567831,-197676613,623
2022-01-10 14:34:34.127757,2022-01-10 09:22:54-05:00,3233,8MKNsuGVaoYpdQy6NNyxDvRzh2DAquBUtri4nDsixUxs,D7M1SDmpZAs8vdPCCCa96UbDF15YQDxHmoGWB57tHiir,True,5177067,1294266,8058,4029,4029,4BnQKPLuE3DMTtxp8MjUBytgnhvxqq3ZTqZHTVZo4JJh,322341,2650730,-2328389,622
2022-01-10 14:34:34.127757,2022-01-10 09:22:54-05:00,3234,5PbrpM9kjzF4R2eW2UTcRVXnhqWdRQWHZJXKLN43N8WC,6ip4ocbyHusy8CsVvcrpiRCUp2nq9cY8bHpTcUU3Wztq,True,9848489,2462122,14083,7041,7042,4BnQKPLuE3DMTtxp8MjUBytgnhvxqq3ZTqZHTVZo4JJh,563351,4228808,-3665457,572
2022-01-10 14:34:34.127757,2022-01-10 09:22:55-05:00,3235,EeztHR1M4PPacJEZ6c5arCRVCuu8aN7eGdpY1u4bev79,9Twdc9Xrzv2oeJ9Fbd8mRvzjbFi7mkGopFS37SMabeAK,True,220866576,55216644,315624,157812,157812,3zqXX6kzhkbW3d4TwD2CNjMRwxTbREXySekvq37kfCNk,12624983,69900807,-57275824,571
2022-01-10 14:34:34.127757,2022-01-10 09:22:55-05:00,3236,7iUx7JBwqUvPVPeCqMEXQdLccZJmaFYm1DUQiu3ouHa3,3EVZzhRmJnX9ZiBZZo9tenDtMogAyuA1yf2cKzvUWiuu,True,1458120,364529,2208,1104,1104,3zqXX6kzhkbW3d4TwD2CNjMRwxTbREXySekvq37kfCNk,88342,650991,-562649,605
2022-01-10 14:34:34.127757,2022-01-10 09:22:57-05:00,3237,FpqCxvTkSiwDwD5qEt6hXJxzFDLFLAQ8VevK8zwRqYun,A3p6YQisCJKpNkF7vkjZRbEfbnUt7vTZdR2zPBUSdTkk,True,510762744,127690686,737912,368956,368956,3zqXX6kzhkbW3d4TwD2CNjMRwxTbREXySekvq37kfCNk,29516504,186255217,-156738713,577
2022-01-10 14:34:34.127757,2022-01-10 09:22:59-05:00,3238,DAku12iueL13vRoTpKLyqdGaLQ2rWF6REe8Dr8soFvNs,H2vVH3LxkhGe6x6Mdwy67BYwTKNQM6XayKx7mhrwyfJM,True,555055,138763,805,402,403,DddJ7EWCmYEEZETCBNgAUSg81Ls6fZtiAaY5ekJ5sXx1,32217,278069,-245852,580
2022-01-10 14:34:34.127757,2022-01-10 09:22:59-05:00,3239,9UyQC8vc6zJJaSdnjvTAzgmcsw4fC3xFBBiCC1w9Sbjx,3ppBfboe6FPmt7f6WrivspMUoAznZKWQMeh3rCgw7vjQ,True,11160981,2790245,16904,8452,8452,4BnQKPLuE3DMTtxp8MjUBytgnhvxqq3ZTqZHTVZo4JJh,676196,3752089,-3075893,605
2022-01-10 14:34:34.127757,2022-01-10 09:23:00-05:00,3240,J4krKPBBTMVLZRgrSeYJAMyHQs2FkNm5TXk7nQWwDB43,ASmLbfNbhTD2HHeV7qzAqiHjUx5a8Traj8oPDwbkMdFg,True,35417836,8854459,54068,27034,27034,4BnQKPLuE3DMTtxp8MjUBytgnhvxqq3ZTqZHTVZo4JJh,2162738,13142762,-10980024,610
2022-01-10 14:34:34.127757,2022-01-10 09:23:01-05:00,3241,51yPLtXTgL9oLKs1cCf5TjL54Ld5vuVxat2NNtwZVsZG,7UjtM7Z1tiXEQMMiorQyncgi9SKu3v46DhVdgXbWqSiF,True,444381810,111095452,687502,343751,343751,4BnQKPLuE3DMTtxp8MjUBytgnhvxqq3ZTqZHTVZo4JJh,27500094,375466300,-347966206,618
2022-01-10 14:34:34.127757,2022-01-10 09:23:02-05:00,3242,4cKgCTttVp8pzJnp43PP7uLLUXNcU7YGPJ3cCGHaUFe7,BBQqjwTpVEgpDzMk4wDDH8rCjaSxCRPWVhtFxERSujTD,True,50700347,12675086,79028,39514,39514,DddJ7EWCmYEEZETCBNgAUSg81Ls6fZtiAaY5ekJ5sXx1,3161149,21453833,-18292684,623
2022-01-10 14:34:34.127757,2022-01-10 09:23:03-05:00,3243,BAczoNDnbwj5AJX5LwzynzYab7ji7VbhRy9edA9Prax,34sbkUKnMetUNyMs6BhiWut85d5UZtBWnPtwx8jEpJNA,True,1618054,404513,2397,1198,1199,3zqXX6kzhkbW3d4TwD2CNjMRwxTbREXySekvq37kfCNk,95882,727601,-631719,592
2022-01-10 14:34:34.127757,2022-01-10 09:23:03-05:00,3244,o2aCmkxsxSiyUX8soTEjwUCbJeXmCZsEaf8CWwxDT5n,3pvS2bTsUuiQyqZp5rdnTpq4cqWGgtv4E5rN9HsBxpRt,True,29945,7486,46,23,23,3zqXX6kzhkbW3d4TwD2CNjMRwxTbREXySekvq37kfCNk,1867,8546,-6679,623
2022-01-10 14:34:34.127757,2022-01-10 09:23:03-05:00,3245,6eBSLXDMVoW2nG3n7s42RXDH8byY3C6n1RsUuegBLSrG,37dYrKnTXYer7Bu9xFfpArA4ZNo2B9bycFw9HywDtTRx,True,12346957,3086739,18088,9044,9044,3zqXX6kzhkbW3d4TwD2CNjMRwxTbREXySekvq37kfCNk,723545,5801743,-5078198,586
2022-01-10 14:34:34.127757,2022-01-10 09:23:03-05:00,3246,8sneA6wAg6geVDJ1g7YWg4R1PfjuRVzeHp1nUBJinhZa,14i1uWtmcTjrdbg3DSr9vzd5NBnxqsn1A4QdgFBZqeYM,True,150990,37746,234,117,117,4BnQKPLuE3DMTtxp8MjUBytgnhvxqq3ZTqZHTVZo4JJh,9375,66484,-57109,620
2022-01-10 14:34:34.127757,2022-01-10 09:23:03-05:00,3247,8NdcaYUC1X5CP7FMDip78uqtqmCt8GcZdCzLRTYTihmb,9Ei1K9bXWXSXcBfeX5exPSXGCAu62WSKzvnnd4wHvyVh,True,163590,40897,241,120,121,3zqXX6kzhkbW3d4TwD2CNjMRwxTbREXySekvq37kfCNk,9676,71302,-61626,591
2022-01-10 14:34:34.127757,2022-01-10 09:23:07-05:00,3248,9zpPiboHF5HW7NfCx7hYdmJGwUomVMTiUFc4Um5KrDi3,8q3eBpuwV6dMNkib9N8XQAq2tBUcjSANRe5SXpd4dFhZ,True,10227253,2556813,15460,7730,7730,4BnQKPLuE3DMTtxp8MjUBytgnhvxqq3ZTqZHTVZo4JJh,618411,3440562,-2822151,604
2022-01-10 14:34:34.127757,2022-01-10 09:23:07-05:00,3249,CvZssqscu2dm35mwcE3zg9zedavbRjVJjWD59Py5ExUK,7pXaoR6aHKYofCmg1eHipygNYDteEaf8rbbS8BDYGQK6,True,876812,219203,1348,674,674,3zqXX6kzhkbW3d4TwD2CNjMRwxTbREXySekvq37kfCNk,53957,318677,-264720,615
2022-01-10 14:34:34.127757,2022-01-10 09:23:07-05:00,3250,F2v1YwVAwXLiUgsJ5uwn4qAAkTXitn1E75fJcPnGuAcy,5rdJ4H5GxPg4Juu77mGc7uya5LwEqLzDSRyG8mQ2mDbK,True,24012378,6003094,35743,17871,17872,3zqXX6kzhkbW3d4TwD2CNjMRwxTbREXySekvq37kfCNk,1429737,11673854,-10244117,595
2022-01-10 14:34:34.127757,2022-01-10 09:23:07-05:00,3251,ANQkPUoMjLHyRtypeKzxsKW1DFauQsh9SnB3rRgRXM1Y,7RHAExWpG8Q3PXwKhJs2yXmYK9WogGydvFYpx28p6pgr,True,90411043,22602760,135666,67833,67833,3zqXX6kzhkbW3d4TwD2CNjMRwxTbREXySekvq37kfCNk,5426655,51634024,-46207369,600
2022-01-10 14:34:34.127757,2022-01-10 09:23:08-05:00,3252,2FrqGFZjbiNykJyo9BZ5S9FguQJPJiTi681rJJsQ5dta,3QUncYP92NKrfpaTvuF9iQg11PXKgZAgEngwh6BbnCCj,True,1028433,257108,1522,761,761,3zqXX6kzhkbW3d4TwD2CNjMRwxTbREXySekvq37kfCNk,60898,422625,-361727,592
2022-01-10 14:34:34.127757,2022-01-10 09:23:08-05:00,3253,Dn916KSmX3HqxT53hrxrbCrV3tdRMCPdaoiRLqetMrth,ATCXRiXgnjRRUbSTPBvtBXMENCqsViexSZbZ6aDaXXWA,True,1630826,407706,2517,1258,1259,3zqXX6kzhkbW3d4TwD2CNjMRwxTbREXySekvq37kfCNk,100693,721097,-620404,617
2022-01-10 14:34:34.127757,2022-01-10 09:23:08-05:00,3254,6nJyqvFKprwaVCE1gAa2P4RHKc6Pa6XFSJymx654zZ9K,4e7iJmdwzAPxp1Zi8Azo38YyPQdPKqqY4VLJyQ5rpdYP,True,3122708,780677,4863,2431,2432,3zqXX6kzhkbW3d4TwD2CNjMRwxTbREXySekvq37kfCNk,194537,1582879,-1388342,622
2022-01-10 14:34:34.127757,2022-01-10 09:23:08-05:00,3255,CRaKcudjkQiSw5YPVjTLVdXvJskeGiHSYtq5ZcMPJhgQ,AgqTg3b3bAcaBmRidhNC4Uf9ZwNbeH52RQEqumWyuUs7,True,1085285,271321,1690,845,845,3zqXX6kzhkbW3d4TwD2CNjMRwxTbREXySekvq37kfCNk,67620,652615,-584995,623
2022-01-10 14:34:34.127757,2022-01-10 09:23:08-05:00,3256,2F45BX9mRmtNCHPejKFknN5aNgGvR4vVLFjMaY1a7dR8,ALdSutsvEFRUEQGGBbi31QywTL1pdXSDWrNJzvNTaoXL,True,31233358,7808339,47578,23789,23789,3zqXX6kzhkbW3d4TwD2CNjMRwxTbREXySekvq37kfCNk,1903142,14609850,-12706708,609
2022-01-10 14:34:34.127757,2022-01-10 09:23:08-05:00,3257,AM5fwZR9BUW8AFkhdGWXW4PHd2cy8ora63kDf2z2eknw,E7ru6hg4MchnRG5zcr5YazwX8Snt55r5Xq9zCHCGaYZT,True,1189692,297423,1739,869,870,HfEnetJ7uBSmZWCjBNxdvv9HEC5nsW4wDV7wu6WnhWan,69599,567238,-497639,585
2022-01-10 14:34:34.127757,2022-01-10 09:23:15-05:00,3258,67Z7ZGhNu5xxEh9BYKWcXp9m1T4tFiE1o1M16hCzUWQA,CT7YKWixz7BhTbvg5F6M5HCyPGnHoFLNFuDV9GhoLTo3,True,4070733,1017683,6275,3137,3138,72FwbpFGoLEazJEdpqNtPNefsadUrimUqma9wSoy4qiS,251005,2326915,-2075910,616
2022-01-10 14:34:34.127757,2022-01-10 09:23:15-05:00,3259,Fd2HrzBAr4JobRPARZwpQHHVoSCEoog32A6tKMWAC1sK,BYappsar5sQf8VLem4wrLuTtrDFH9y8pEx1aMxfuU4Pq,True,37495906,9373976,56011,28005,28006,3zqXX6kzhkbW3d4TwD2CNjMRwxTbREXySekvq37kfCNk,2240451,18227349,-15986898,597
2022-01-10 14:34:34.127757,2022-01-10 09:23:15-05:00,3260,pgzvXpnUYiY7hLrfjmwScqLd8oj9vYcXpFvpm4y4JvG,GdqdQgoyBAFuXdbvoZyDhB3jyqJzVo4nkGh7EPFxkBF2,True,2641298,660324,4060,2030,2030,72FwbpFGoLEazJEdpqNtPNefsadUrimUqma9wSoy4qiS,162421,2321356,-2158935,614
2022-01-10 14:34:34.127757,2022-01-10 09:23:18-05:00,3261,E8ifvhmyJGBGVQomo3AnZw2UcaLHcpGsTtuoCid8voU3,FMQUWTbTAfSLfrc6GTrz4DM2ZSgoxF3KtqGn8AyjVtsf,True,8865350,2216337,13386,6693,6693,3zqXX6kzhkbW3d4TwD2CNjMRwxTbREXySekvq37kfCNk,535453,3173552,-2638099,603
2022-01-10 14:34:34.127757,2022-01-10 09:23:18-05:00,3262,H1LftKtj94Zs6PG2A7gJt9rPurBkXkTy2hbbArQwAehi,8bANmhgdnPYa3PqdPnk5BA2xhvqJmPyaMF77mrBePJ13,True,47723,11930,72,36,36,3zqXX6kzhkbW3d4TwD2CNjMRwxTbREXySekvq37kfCNk,2912,37783,-34871,610
2022-01-10 14:34:34.127757,2022-01-10 09:23:18-05:00,3263,DdYgcyV1T2CDYiQVr4VL9Ym8RdKm93a7SKy8HxuyaoMW,GPdAeqeXb1UJ56AttcwwY1CyFhRyfptDC4BAX2Tc8MpE,True,658872,164718,1028,514,514,3zqXX6kzhkbW3d4TwD2CNjMRwxTbREXySekvq37kfCNk,41132,331387,-290255,624
2022-01-10 14:34:34.127757,2022-01-10 09:23:18-05:00,3264,HPDN6Ro6gPgYbNgnv7yhFCpyY3uYzT18epFxRFNZ985w,3Jop74A52E7gYLXJRUAoPBzSZ6mmP2gmaCg7eG6eQHu5,True,430901768,107725442,645265,322632,322633,3zqXX6kzhkbW3d4TwD2CNjMRwxTbREXySekvq37kfCNk,25810618,94878850,-69068232,598
2022-01-10 14:34:34.127757,2022-01-10 09:23:19-05:00,3265,AHm7zF4rpaxaayBLn5QDHgJSp8KAr647s4cNvQ9wLgd7,FDM33WngED24pukBvSDpPAzinW6afVAeGReum5nyLRiC,True,1031166,257791,1532,766,766,72FwbpFGoLEazJEdpqNtPNefsadUrimUqma9wSoy4qiS,61303,518791,-457488,594
2022-01-10 14:34:34.127757,2022-01-10 09:23:19-05:00,3266,6tFQaTqqffino9kwMZTL2xVNBG8k9VREFhXqVi2si3A3,3w3wGxBbS4bmXeqmvd595SAWFeXekVpnH4UdbeEs8Sx5,True,5457623,1364405,8166,4083,4083,4BnQKPLuE3DMTtxp8MjUBytgnhvxqq3ZTqZHTVZo4JJh,326674,1986422,-1659748,598
2022-01-10 14:34:34.127757,2022-01-10 09:23:30-05:00,3267,C2Dmfw4G8KKzFq38aRH2pLCRngnGZDvUUN3fHDMjFkoG,7kzJk3BTNvY3hGFNj7nDy9L5CAYus6eNiCAxWH8dSioX,True,462074,115518,675,337,338,3zqXX6kzhkbW3d4TwD2CNjMRwxTbREXySekvq37kfCNk,27021,278237,-251216,584
2022-01-10 14:34:34.127757,2022-01-10 09:23:30-05:00,3268,8RmB8o4zux2sD48dEsKpsX475KRxTwdk8QULUDU9xx8R,AKSiZnb4YKVB6B86aPPqvyXquhvN9xqt45bexBCZ7nx,True,78890634,19722658,118411,59205,59206,3zqXX6kzhkbW3d4TwD2CNjMRwxTbREXySekvq37kfCNk,4736447,44459966,-39723519,600
2022-01-10 14:34:34.127757,2022-01-10 09:23:31-05:00,3269,EmGW2aAG69ssWqCtbfDocRaM2u3TJsczn2HHP9jdmRvD,aypkDKsp9uqAB4F6mwvm5LofpsrFBuZT2MMWtE2eHdB,True,804045,201011,1206,603,603,4BnQKPLuE3DMTtxp8MjUBytgnhvxqq3ZTqZHTVZo4JJh,48263,370380,-322117,600
2022-01-10 14:34:34.127757,2022-01-10 09:23:31-05:00,3270,6yw4GPvkqUbakcEWtqSCfjVLukty11xqjDpGxtEN9Km2,5ppEx7wkpqbG5nApCWMdRja3oRSheFmAAsNHUX7h2w2Y,True,2056549,514137,3082,1541,1541,4BnQKPLuE3DMTtxp8MjUBytgnhvxqq3ZTqZHTVZo4JJh,123316,1799516,-1676200,599
2022-01-10 14:34:34.127757,2022-01-10 09:23:39-05:00,3271,DGAQzgZhS2yioeZmG3cbacM3hdz4F1aZn1PWRwgiFukc,48KUtJaNCPNxkLXJBtWAdDxY4b9vZzLgbGxTNdwMqmjz,True,655136205,163784051,1022086,511043,511043,4BnQKPLuE3DMTtxp8MjUBytgnhvxqq3ZTqZHTVZo4JJh,40883474,299478606,-258595132,624
2022-01-10 14:34:34.127757,2022-01-10 09:24:28-05:00,3272,BgNgALwBEuiumVgiXRmBZRnyFrr9QTDy2maHzsNwNHGf,ag35Ec2uFtqkarizCxFyhM2SPBuUwfmLRhAdFEWFCNa,True,26816988,6704247,41542,20771,20771,3zqXX6kzhkbW3d4TwD2CNjMRwxTbREXySekvq37kfCNk,1661708,8587220,-6925512,619
2022-01-10 14:34:34.127757,2022-01-10 09:25:23-05:00,3273,8xvLGVeDmhVYQhN2ZpWkVG9jCrukRsNQ4926a4TMiZqa,9ciBySSjvADwp47WkETiFWZKVTFL8Hf1XvK7aSxhcgQS,True,23975199,5993799,37274,18637,18637,3zqXX6kzhkbW3d4TwD2CNjMRwxTbREXySekvq37kfCNk,1490988,10286211,-8795223,621
2022-01-10 14:34:34.127757,2022-01-10 09:25:51-05:00,3274,C33hfnDHzVwKXxr6AwFAXhd1vJYrPKhtqc75Qpjm19Zt,2WYBMSyrHQEYZqxEtxBMe2xn7eioJEGsudqdCmGvssGh,True,62178902,15544725,97002,48501,48501,4BnQKPLuE3DMTtxp8MjUBytgnhvxqq3ZTqZHTVZo4JJh,3880085,12944085,-9064000,624
2022-01-10 14:34:34.127757,2022-01-10 09:25:54-05:00,3275,4k95B2HfiTXT8fDtW4286MoEPj6UdPiQd5BjFadjs8Pv,GmhpDUb5A14X8xRZHRnbrYEr3xJh9zJA7eqoCzwboDTW,True,1180232112,295058028,1834692,917346,917346,3zqXX6kzhkbW3d4TwD2CNjMRwxTbREXySekvq37kfCNk,73387704,275981439,-202593735,621
2022-01-10 14:34:34.127757,2022-01-10 09:25:59-05:00,3276,GKCeRcHQYMhcTwEm5wu1SbkXAT19gjGUGji43HS36B5N,EYQKX5sWsmXoge5xbTcMYAjvRbSUTXXpHEzckPY2LV8W,True,2328037,582009,3637,1818,1819,4BnQKPLuE3DMTtxp8MjUBytgnhvxqq3ZTqZHTVZo4JJh,145504,629684,-484180,625
2022-01-10 14:34:34.127757,2022-01-10 09:25:59-05:00,3277,HmspGdpobjC5Vbmo3FcKdw4RLPN7wJKxv3uKqDjVhLee,3YEX8TzdyJyuHo76Kw76imVCJjzrC9m188YuRKvwwSwD,True,404081110,101020277,629516,314758,314758,DddJ7EWCmYEEZETCBNgAUSg81Ls6fZtiAaY5ekJ5sXx1,25180640,89714830,-64534190,623
2022-01-10 14:34:34.127757,2022-01-10 09:26:13-05:00,3278,G25vsB3sDqRhHoSK4KwR1TywfrJDtpejVbbevEG9sQ9a,5xFC3Hm13magnAA9GD1EnwC9PrPoEfQ7omEa9p9zCrB1,True,2148400,537099,3359,1679,1680,4BnQKPLuE3DMTtxp8MjUBytgnhvxqq3ZTqZHTVZo4JJh,134375,837604,-703229,625
2022-01-10 14:34:34.127757,2022-01-10 09:26:20-05:00,3279,36ByQojnxEckWdQTjqHfxKqCx9yjqWQsPsZyqaN72UWR,AZoirtS1fjX61agRM64tqThVinnJTh3BWgiHyNHPTgZP,True,769627,192406,1195,597,598,4BnQKPLuE3DMTtxp8MjUBytgnhvxqq3ZTqZHTVZo4JJh,47822,439950,-392128,621
2022-01-10 14:34:34.127757,2022-01-10 09:26:23-05:00,3280,CbhrZUdan1axNDFUrX1ZuEohfNMEGrszKSkk6pppVQuw,DHEAjJNtuEePezYAv77thWabbVxxqQpfuiC6moRSrpG1,True,88935193,22233798,137937,68968,68969,DddJ7EWCmYEEZETCBNgAUSg81Ls6fZtiAaY5ekJ5sXx1,5517518,51570480,-46052962,620
2022-01-10 14:34:34.127757,2022-01-10 09:26:41-05:00,3281,D58t4uTjFumsUeYFaKnpV8BRTEQEqKXBreFTdwGrott7,67p6kHDfVqQijfcwugvZK59c3aRRH9x3eHxruqH8WEqF,True,1285977,321493,1981,990,991,4BnQKPLuE3DMTtxp8MjUBytgnhvxqq3ZTqZHTVZo4JJh,79277,562006,-482729,616
2022-01-10 14:34:34.127757,2022-01-10 09:27:50-05:00,3282,DdAPWdHnb7ocaYtcwwwYnppsH39sZpmzMyANeoJbCV7s,3BVmC39L8dEypPN1BZhsf9bx9Ge2sXCZR8Y6RH4eBNMJ,True,1317988197,329497049,2050931,1025465,1025466,3zqXX6kzhkbW3d4TwD2CNjMRwxTbREXySekvq37kfCNk,82037243,949597374,-867560131,622
2022-01-10 14:34:34.127757,2022-01-10 09:27:50-05:00,3283,9vcKW1GfrDZ3KLPh2pEVFF8ZyKqD1pJW1hiE8H98Av7S,C6Ki27mo4sCHu6u8UnR1p7WSgsTjFQxGGR9Lk9n5Rhjq,True,3480772,870193,5424,2712,2712,4BnQKPLuE3DMTtxp8MjUBytgnhvxqq3ZTqZHTVZo4JJh,216977,1666505,-1449528,623
2022-01-10 14:34:34.127757,2022-01-10 09:27:51-05:00,3284,EAUFD16wab8qRMJ4H6updHGt4xFqgRCDeRHVCsLCTSTL,8vkfYSyCyBY9g4TZrp52jUcQj6udy9xAaA4fioRE2RXx,True,2647673773,661918443,4138797,2069398,2069399,4BnQKPLuE3DMTtxp8MjUBytgnhvxqq3ZTqZHTVZo4JJh,165551893,643061445,-477509552,625
2022-01-10 14:34:34.127757,2022-01-10 09:27:51-05:00,3285,M69XSefqeum2arinvHEqmA3L2XHWNFN17p4msRhRZXf,2vK15yYUANLSbAoiBfgJ9VLyqsmtEpd2iNytQjms8GaQ,True,339484455,84871113,531042,265521,265521,4BnQKPLuE3DMTtxp8MjUBytgnhvxqq3ZTqZHTVZo4JJh,21241714,214121641,-192879927,625
2022-01-10 14:34:34.127757,2022-01-10 09:28:13-05:00,3286,8T4WK27RvWVGqPuNqY6whk1fmU4vd5qaUQPZG1GJ79bh,DvSz7knS8N3K7L6JhQf1s4mJSyxB8uJXNQXtyjJn8QRL,True,87995430,21998857,137627,68813,68814,3zqXX6kzhkbW3d4TwD2CNjMRwxTbREXySekvq37kfCNk,5505100,41873993,-36368893,625
2022-01-10 14:34:34.127757,2022-01-10 09:30:09-05:00,3287,Gs3WP18hbzNpbBgiU39e6tfkggfCKRyNqPqJQcthuHFD,4XAY25YUma6gUdG2GdbXeivum3t21g93ZagfWGTZYkWZ,True,12572481,3143120,19591,9795,9796,3zqXX6kzhkbW3d4TwD2CNjMRwxTbREXySekvq37kfCNk,783664,6218360,-5434696,623
2022-01-10 14:34:34.127757,2022-01-10 09:30:24-05:00,3288,JDeYjCLpfnzcfxDFgHf4aBcHsajwdR14GUaKAA9euzVf,EJbvKoyMZcoCx4vWa61uMbW2vr6mUhrgEuECdteVBuZZ,True,7473297,1868324,11693,5846,5847,4BnQKPLuE3DMTtxp8MjUBytgnhvxqq3ZTqZHTVZo4JJh,467757,4515796,-4048039,625
2022-01-10 14:34:34.127757,2022-01-10 09:30:27-05:00,3289,m7gf1jAYXBZjRZEY9w4MjPfhzLwgDKaXyaCVhRD6C5E,Aa2aTZnpPux1i5K2MT4i1TsVM8vR7qR7rZGijQW4zpwd,True,107676993,26919248,167775,83887,83888,3zqXX6kzhkbW3d4TwD2CNjMRwxTbREXySekvq37kfCNk,6711012,24014019,-17303007,623
2022-01-10 14:34:34.127757,2022-01-10 09:30:46-05:00,3290,6oroGB3mvzK3tDfiB9X2NJuL3x476pxhgRnt7VxqhdLo,2SoK8tKkLn2ppKURpTVazKsCEis4uahkHMsac1m85J4r,True,2243899,560974,3508,1754,1754,4BnQKPLuE3DMTtxp8MjUBytgnhvxqq3ZTqZHTVZo4JJh,140351,1900570,-1760219,625
2022-01-10 14:34:34.127757,2022-01-10 09:30:48-05:00,3291,Ckqos6cdncPKj13DnCmDVZsZTqp6eS7277CRrT9WhcEr,AtUV8m7VQJvZq7GLCAHMf3jV7iamKEPnWVZHWuuVZQp1,True,1555132,388783,2424,1212,1212,3zqXX6kzhkbW3d4TwD2CNjMRwxTbREXySekvq37kfCNk,96997,936129,-839132,623
2022-01-10 14:34:34.127757,2022-01-10 09:30:51-05:00,3292,HVZkXeDR3mc8oB9qFFwCK4RXpPojdcHk9tRGep6xtKGK,Bh3py7awPejWqeTMxtAgF7mPotL2Asxf8YrYJykq9nBt,True,8256843,2064210,12869,6434,6435,4BnQKPLuE3DMTtxp8MjUBytgnhvxqq3ZTqZHTVZo4JJh,514772,3521483,-3006711,623
2022-01-10 14:34:34.127757,2022-01-10 09:30:51-05:00,3293,CBL2NbekJrXvBiAcoj4fzQ4PfLDwTntW7Zt4nruHFYEw,59EvfgYTdKkfjUJz5LddLUAqbEdLaihcMzjcrTZsyzyS,True,11715,2928,18,9,9,4BnQKPLuE3DMTtxp8MjUBytgnhvxqq3ZTqZHTVZo4JJh,729,4899,-4170,622
2022-01-10 14:34:34.127757,2022-01-10 09:30:59-05:00,3294,5rW9kqXB9feGSKSvSMNJF1FCsBYV3vGmTmc8MvzaZ3pi,7AjnjcfPJevW5521hXw4VtgRCfHSsAqyzyArukKfNcHo,True,13765643,3441410,21435,10717,10718,4BnQKPLuE3DMTtxp8MjUBytgnhvxqq3ZTqZHTVZo4JJh,857416,7023378,-6165962,622
2022-01-10 14:34:34.127757,2022-01-10 09:30:59-05:00,3295,zLTuMVfVswjMkhyvjaXnvjcKXv5xNk3iSWSjRGpVqXf,J3D8NHUJCiSjvFYfJ5Es4YDhF1KcPZWRUmCQ5L92t8eB,True,152336581,38084145,236360,118180,118180,4BnQKPLuE3DMTtxp8MjUBytgnhvxqq3ZTqZHTVZo4JJh,9454429,61545846,-52091417,620
2022-01-10 14:34:34.127757,2022-01-10 09:30:59-05:00,3296,2jPxG5FL6D6XEJsRszJ9cmQ54AWSpZyPFSbn3DpWBSuM,3toQou4UVNvyWYvMvkuv379RVEF2aN2TzCpKKBUqeQV6,True,241737277,60434319,376550,188275,188275,3zqXX6kzhkbW3d4TwD2CNjMRwxTbREXySekvq37kfCNk,15062015,101369049,-86307034,623
2022-01-10 14:34:34.127757,2022-01-10 09:30:59-05:00,3297,CyWBZ1xJ9LahUnPesbXLZ4Rr5UyWAHgVFYwfrnhyrkNL,2Lpk87Xth8ZL5J9BfzmMpEE3x76FDrrrmdKiCNkSVip2,True,176750956,44187737,275092,137546,137546,3zqXX6kzhkbW3d4TwD2CNjMRwxTbREXySekvq37kfCNk,11003683,67820208,-56816525,622
2022-01-10 14:34:34.127757,2022-01-10 09:30:59-05:00,3298,CagSUfZLwXuCdypC4KzU6FSNdmCj9dKDroPcNeaRtsyt,yxw5d1ztZuEUY2QjL7eLpr72QJAj5rJd6ERvg91cy1m,True,2025030,506257,3152,1576,1576,3zqXX6kzhkbW3d4TwD2CNjMRwxTbREXySekvq37kfCNk,126103,769408,-643305,622
2022-01-10 14:34:34.127757,2022-01-10 09:31:01-05:00,3299,FhAt6pZW3k8StP9VLeWUfidpXfRLoKWdV7Wgxdh9cRy9,Guk93pTo3KcG8konHjJ52oi9rgexmmKhPQAkxZS1BtCG,True,227181985,56795495,354745,177372,177373,4BnQKPLuE3DMTtxp8MjUBytgnhvxqq3ZTqZHTVZo4JJh,14189820,103342111,-89152291,624
2022-01-10 14:34:34.127757,2022-01-10 09:31:05-05:00,3300,3qnPsgqW11AcDEmyjmJquPcPLyE3EdJQuVLJ5kinDrd3,86rZadBB7emKio76aFTahpbrFtxd9tqZ4Mxgzaavq2xU,True,197775,49443,308,154,154,3zqXX6kzhkbW3d4TwD2CNjMRwxTbREXySekvq37kfCNk,12357,84892,-72535,624
2022-01-10 14:34:34.127757,2022-01-10 09:32:33-05:00,3301,AWvHDdb2ikqV8wc7qQ8azbvNTZdixMNxhQjhQdhayYtR,9EpgEPBb1nog6aQeFdMXfSRiLSnzGQFQ39mbLdCxgYTv,True,44354169,11088542,69356,34678,34678,4BnQKPLuE3DMTtxp8MjUBytgnhvxqq3ZTqZHTVZo4JJh,2774262,14355955,-11581693,625
2022-01-10 14:34:34.127757,2022-01-10 09:33:11-05:00,3302,5eMLdQ4gYA5iqvTXSNdGvctHp7s5VpyFuwtJKqx6chBc,Ckxc5K39nkBNXBTmFTM8J48R7wGqNm3vHKZu4G5baumZ,True,314058297,78514574,489748,244874,244874,HfEnetJ7uBSmZWCjBNxdvv9HEC5nsW4wDV7wu6WnhWan,19589935,112929648,-93339713,623
2022-01-10 14:34:34.127757,2022-01-10 09:33:40-05:00,3303,BrHRMouGRz3LBNzd9anfdYMhWfg8yUPHL4PqJ8WdEDFS,4uzoLa3mC2VYHAPBoHLX4gTjPTC28rPf2fvEGtJWPYc,True,76129081,19032270,117888,58944,58944,3zqXX6kzhkbW3d4TwD2CNjMRwxTbREXySekvq37kfCNk,4715555,61179471,-56463916,619
2022-01-10 14:34:34.127757,2022-01-10 09:33:41-05:00,3304,2FEbsetZMkRqLjSC8GBbgecKgX5T1T1fci2sLQux29p8,H722Fcd6DkTFRZxqQWbPDufBfXEgmFfhiEpQZWhxwYv1,True,6043800,1510950,9382,4691,4691,HfEnetJ7uBSmZWCjBNxdvv9HEC5nsW4wDV7wu6WnhWan,375294,2339208,-1963914,620
2022-01-10 14:34:34.127757,2022-01-10 09:33:41-05:00,3305,3C2MZQKh9x4zNTCMbhhvoafGaFMwUooqfy9MCgPyXs6E,AHjgWKpYPWe6ketjDHDKFBFsKQiRJ41jnkuo39MVYxZo,True,264838941,66209735,410600,205300,205300,4BnQKPLuE3DMTtxp8MjUBytgnhvxqq3ZTqZHTVZo4JJh,16424015,151031511,-134607496,620
2022-01-10 14:34:34.127757,2022-01-10 09:33:42-05:00,3306,HGJoZvLakWfSDFwuvShNBc4kCf7nP7VqzyM3mELpbFEf,12Qn5jin7QvsBngXqYAv4UstyG3b6nRf1jsLp9Dp8G7k,True,20288379,5072094,31459,15729,15730,3zqXX6kzhkbW3d4TwD2CNjMRwxTbREXySekvq37kfCNk,1258374,9124275,-7865901,620
2022-01-10 14:34:34.127757,2022-01-10 09:33:42-05:00,3307,E1CShgy7M9998q9jyzpnHZxHJR6z5hvnshUJt37kVPtG,96f1nYW4S9APCJS3TXTGSb9UcJDdxJuoBR3pLYqcNz2b,True,221103888,55275972,344598,172299,172299,4BnQKPLuE3DMTtxp8MjUBytgnhvxqq3ZTqZHTVZo4JJh,13783942,92649754,-78865812,623
2022-01-10 14:34:34.127757,2022-01-10 09:33:43-05:00,3308,U3vvMQ4X4aKzVYfhMw1V1p58HRqaLnuXozqmmefYeD9,7JA94MArkNCFRhBq8f5a32DgMF6aPdFsoC5HvXDQ6NuR,True,392883264,98220816,610355,305177,305178,3zqXX6kzhkbW3d4TwD2CNjMRwxTbREXySekvq37kfCNk,24414239,203844306,-179430067,621
2022-01-10 14:34:34.127757,2022-01-10 09:33:43-05:00,3309,GqAS41YJssg9aaEp3hs3sG98APCsXhiQBQszXaSjZ2bN,2wodJ3AhrXdE1T4oVL95KvoBND7PubG5Wd5GWiLCMZJU,True,237608421,59402105,368030,184015,184015,3zqXX6kzhkbW3d4TwD2CNjMRwxTbREXySekvq37kfCNk,14721239,192208285,-177487046,619
2022-01-10 14:34:34.127757,2022-01-10 09:33:44-05:00,3310,BYvjENe16Ta77PqGV7JKEWrsqCTfkMGYwTSG5gXneDvd,EvxAXgvhPC6QkNurbK7vWyTApGo8J2R4EgMAknkHVU3d,True,3867745,966936,6037,3018,3019,3zqXX6kzhkbW3d4TwD2CNjMRwxTbREXySekvq37kfCNk,241517,2379953,-2138436,624
2022-01-10 14:34:34.127757,2022-01-10 09:33:44-05:00,3311,ymyzGH4Qc7HH5PbKpVphCbsQgLLXyGkPcXamQJuNj5C,8oTLHaV2XzbKXNWRuUjCfHjUn61Pw93LYK14m9q2VDpZ,True,17205661,4301415,26752,13376,13376,4BnQKPLuE3DMTtxp8MjUBytgnhvxqq3ZTqZHTVZo4JJh,1070081,6554109,-5484028,621
2022-01-10 14:34:34.127757,2022-01-10 09:33:47-05:00,3312,7PzGZgzieFyyFs1dbajkNQgVxooFUNZrj1bUsQvrSwbp,A2gDREmSmJTBPPw3sbKVY3smC9wbHMDdv87gr4Tr2ES7,True,3557145,889286,5505,2752,2753,3zqXX6kzhkbW3d4TwD2CNjMRwxTbREXySekvq37kfCNk,220229,1529079,-1308850,619
2022-01-10 14:34:34.127757,2022-01-10 09:33:47-05:00,3313,B4Uc39nKzz9wBRQsCkMR4A7RwTJ8rSuwpR6EQn2AesRb,H49bGZgatRZVpj6QufZRVgYrQtH7LpdbiqKBs23151m,True,32374369,8093592,50398,25199,25199,4BnQKPLuE3DMTtxp8MjUBytgnhvxqq3ZTqZHTVZo4JJh,2015958,28773877,-26757919,622
2022-01-10 14:34:34.127757,2022-01-10 09:33:48-05:00,3314,BPsM1um9ZJf7eNoVMsQCRSwgARMuLCGGSDxf9tZeNeEy,BpzDdXfxVygiSYSmsHV6uPxQMeTFtrURMCCqhswQjd5X,True,1508277,377069,2348,1174,1174,3zqXX6kzhkbW3d4TwD2CNjMRwxTbREXySekvq37kfCNk,93933,587716,-493783,622
2022-01-10 14:34:34.127757,2022-01-10 09:34:15-05:00,3315,DMgD2KCEhTGFLUZ5GnfNcwfiiwKYbyVpoWiN6knMkCAf,5KU2vgBkPTNVHsSULjgX7ZkZS56U3Dy3xqLTxL5sUZJ3,True,1782593321,445648330,2755436,1377718,1377718,4BnQKPLuE3DMTtxp8MjUBytgnhvxqq3ZTqZHTVZo4JJh,110217440,1073728043,-963510603,618
2022-01-10 14:34:34.127757,2022-01-10 09:34:15-05:00,3316,3WcJUt8jQ1ngL3ZCGo6dFrc3GmTMTYtzeDva7mri2Tqx,HeG1Pz2oMjqtkfsRMsbqP3VpatnVEQzcWmKDVoFp4Htr,True,20290732,5072683,31520,15760,15760,3pStmNaV47N2sqUtHJHLAtCKiN9JZ6jzNY9h94ng8G1D,1260832,9124381,-7863549,621
2022-01-10 14:34:34.127757,2022-01-10 09:34:16-05:00,3317,FFoYoBmkfEsCWVXQf3BhKeaFMZD3YVKvfhPWkXdnCZS9,8yW6WApAuN43brF1HioTLdyxvQTQJzt875E26QqrWWFk,True,692530,173132,1074,537,537,DddJ7EWCmYEEZETCBNgAUSg81Ls6fZtiAaY5ekJ5sXx1,42984,204754,-161770,620
2022-01-10 14:34:34.127757,2022-01-10 09:34:16-05:00,3318,96StvqZyFUPtyMr4o9s7K4V29RSNyRpVi76vNwxG5rUf,GZKXFSFq4aGiTaqovtxqNCCVGkAFNXPh4Hep1ZMwdZ8g,True,28859927,7214981,44673,22336,22337,3zqXX6kzhkbW3d4TwD2CNjMRwxTbREXySekvq37kfCNk,1786954,24781427,-22994473,619
2022-01-10 14:34:34.127757,2022-01-10 09:34:16-05:00,3319,6rb3fRVWJ5cSzFcmuC1YwdrNxiNctvboDF7HwsfyGoCA,H6JaYfFZkRk6iSJrA4nVeuFpMVQtVwQZHVgK1TyaupTE,True,54241,13560,83,41,42,3zqXX6kzhkbW3d4TwD2CNjMRwxTbREXySekvq37kfCNk,3351,42066,-38715,617
2022-01-10 14:34:34.127757,2022-01-10 09:34:16-05:00,3320,AA6QgBaH9F8QfPT9xjztv9uELcADPxwUuXofkBV8dYg4,FCMXozSstTNA74FVCJ5hpYvNJamjutnoakHoBVnzwcWj,True,26837,6709,41,20,21,DddJ7EWCmYEEZETCBNgAUSg81Ls6fZtiAaY5ekJ5sXx1,1670,12434,-10764,622
2022-01-10 14:34:34.127757,2022-01-10 09:34:16-05:00,3321,CwTus4FyoXYqyTKAYDp69NLhA1joYZ3tarzY6FFTr6fn,6ivuvYWU6i25MzJSY8rG9rPDKiq38E6QtrV1jvRubLGr,True,13087,3271,20,10,10,3zqXX6kzhkbW3d4TwD2CNjMRwxTbREXySekvq37kfCNk,811,5722,-4911,619
2022-01-10 14:34:34.127757,2022-01-10 09:34:17-05:00,3322,FV9CBGGTbppLnBKh79f2LzD1diTiS5g6u89FcpZHZmnK,Fe7mtmCUziFqbbYTvrhAcAq1Ub7YLfTJRtQ1hG7GzJD1,True,6800065,1700016,10520,5260,5260,4BnQKPLuE3DMTtxp8MjUBytgnhvxqq3ZTqZHTVZo4JJh,420822,2633607,-2212785,618
2022-01-10 14:34:34.127757,2022-01-10 09:34:17-05:00,3323,6Bq55LtGCEeGqh4JrFLCmmGc2iJfTTBJixivqH78aGSE,DSNrCgWJeNe2P9tAQu5FvCueTzNKDKds7wzuwTQSMRG,True,8585484,2146371,13295,6647,6648,4BnQKPLuE3DMTtxp8MjUBytgnhvxqq3ZTqZHTVZo4JJh,531817,3268463,-2736646,619
2022-01-10 14:34:34.127757,2022-01-10 09:34:22-05:00,3324,AL8JFS4gjaQx89f9j8wtaNJgV76K8bw1ugvNtgvhgAnb,HJYvG2kGKe8kXgtZSWTWwTmSjxA3XUeCvyT7acoKtS1C,True,5899887840,1474971960,9095404,4547702,4547702,3zqXX6kzhkbW3d4TwD2CNjMRwxTbREXySekvq37kfCNk,363816192,1938642486,-1574826294,616
2022-01-10 14:34:34.127757,2022-01-10 09:34:22-05:00,3325,9ebpuMtXee3DSx4qWiEYEtTT1gK5FqCY2H5yQVWWtTts,9b71dTsTYD1bx6KsjFs5h6d3Jj4T9eX3nqmS7RQj3HS5,True,378229248,94557312,586592,293296,293296,3zqXX6kzhkbW3d4TwD2CNjMRwxTbREXySekvq37kfCNk,23463697,158093860,-134630163,620
2022-01-10 14:34:34.127757,2022-01-10 09:34:22-05:00,3326,CP2qcTSw1Y5J7jZiEgbtsvJoigRbJ4m9oHGQS8Fiai2x,7Zd1uX1thbuGkp9H4r1t8aLTu9W8MxvUBNjji2FNJa8E,True,50693757,12673439,78738,39369,39369,DddJ7EWCmYEEZETCBNgAUSg81Ls6fZtiAaY5ekJ5sXx1,3149544,21448818,-18299274,621
2022-01-10 14:34:34.127757,2022-01-10 09:34:23-05:00,3327,Cs2YxkuqBK1kjoYZbUZdUcxapPbv8oC75trwGgWoCPfG,2PgHQM1GhHykE4bQ1ggueAw2Zs1BFUW5hxvMvr8DojKM,True,71013303,17753325,110008,55004,55004,3zqXX6kzhkbW3d4TwD2CNjMRwxTbREXySekvq37kfCNk,4400321,40164634,-35764313,619
2022-01-10 14:34:34.127757,2022-01-10 09:34:23-05:00,3328,F1JT1p2VuwK4L7zj7NNnZtYiZiNUCcTGKDkgdoX3BZdZ,3BKe4yzTwnnBnvTWP3britpPJ4oAWL7JZJzNLCxjUufS,True,6556,1639,10,5,5,4BnQKPLuE3DMTtxp8MjUBytgnhvxqq3ZTqZHTVZo4JJh,409,1646,-1237,623
2022-01-10 14:34:34.127757,2022-01-10 09:34:25-05:00,3329,4j19AEcDwhtAZrnoDc4epNPmEL1jPpVUMeg7RmQ72Qkb,84WB42AAGbczVE9txZPwXrx4FD5jP87r8QdDzEABTm5G,True,66199261560,16549815390,103478668,51739334,51739334,72FwbpFGoLEazJEdpqNtPNefsadUrimUqma9wSoy4qiS,4139146742,37929785192,-33790638450,625
2022-01-10 14:34:34.127757,2022-01-10 09:34:32-05:00,3330,CK3ocyWzXQkJJZQmM6bBK4Nv6Rh3UEufjY6DvNU6gJZy,C924o4GY3p2BHLeAbFbe9SEysXqCUyD8sFu2d4NzkAV7,True,6566870,1641717,10184,5092,5092,4BnQKPLuE3DMTtxp8MjUBytgnhvxqq3ZTqZHTVZo4JJh,407366,2515632,-2108266,620
2022-01-10 14:34:34.127757,2022-01-10 09:34:32-05:00,3331,2PzBAkdXkrwH9VuoMALumQz86qkW7sSBQtCrHw14JUp3,D5vwWAMHVooobG2sCWv9EwtJrAFZG6cwKH4dfmA98tbt,True,2621020,655255,4040,2020,2020,4BnQKPLuE3DMTtxp8MjUBytgnhvxqq3ZTqZHTVZo4JJh,161616,1144305,-982689,616
2022-01-10 14:34:34.127757,2022-01-10 09:34:33-05:00,3332,X5SF9srgzDgBRBhv8xUWyszYYSQiqFF6cVnVLWzQgp1,7rTqnMkPuUUJFt5px1DxwsUK8U5fQUtnx9N4v6dA4vGb,True,33333,8333,51,25,26,3zqXX6kzhkbW3d4TwD2CNjMRwxTbREXySekvq37kfCNk,2059,14502,-12443,617
2022-01-10 14:40:20.757903,2022-01-10 09:34:34-05:00,3333,7D4rFmGMPKNAF75VRPxHAhSn2wTjiW8jmth1UD22Xqq9,GQ7BrT6vsXu8tHCMm75YdxFR2r9QTCrCUbdPEZBSAg9w,True,48303783,12075945,74777,37388,37389,4BnQKPLuE3DMTtxp8MjUBytgnhvxqq3ZTqZHTVZo4JJh,2991099,17692403,-14701304,619
2022-01-10 14:40:20.757903,2022-01-10 09:34:34-05:00,3334,7vKmhLV45Q5etXhJL5ng8rxWhYSiUCDmAbGnwBPr7zcx,cP6xPeuHLnjr858QK1F9qYn7rJpEbPy7wEJHoju6oV7,True,43615681,10903920,67425,33712,33713,DddJ7EWCmYEEZETCBNgAUSg81Ls6fZtiAaY5ekJ5sXx1,2697000,18856703,-16159703,618
2022-01-10 14:40:20.757903,2022-01-10 09:34:34-05:00,3335,FX5sizQGZcDCaETDyJ3HbLxFwhu4t9bX6YyQM7cVEo9Z,6EqnCsv1JPjz6JX1yLNcf74rmkuhAUx6Sf35QMYGuuF6,True,220843643,55210910,341263,170631,170632,3zqXX6kzhkbW3d4TwD2CNjMRwxTbREXySekvq37kfCNk,13650549,93376546,-79725997,618
2022-01-10 14:40:20.757903,2022-01-10 09:34:34-05:00,3336,EhANPABkSw9x9WnsDEi8pCg67iQTX2UGTTUpyjADTwdN,4FKLi98hyg9ZjM4MY6ctJsv7B6vPUnTYWdhrnNoYsztX,True,10109506,2527376,15642,7821,7821,4BnQKPLuE3DMTtxp8MjUBytgnhvxqq3ZTqZHTVZo4JJh,625692,5446939,-4821247,618
2022-01-10 14:40:20.757903,2022-01-10 09:34:34-05:00,3337,Cb4zhnvig11U4GcC4kqKrnDicGgPhUpfDQB1U7hP3nPa,DiRAMrKqaevGXeXg38KnhaYBERj8tNKU7oWFJvhS32kw,True,203253,50813,316,158,158,3zqXX6kzhkbW3d4TwD2CNjMRwxTbREXySekvq37kfCNk,12662,76380,-63718,622
2022-01-10 14:40:20.757903,2022-01-10 09:34:34-05:00,3338,8W9NJfM6cqCsvR1FC8Ab8YZPSQF7bz7inxJZxWnF7GsX,3exfPuVcTnPxs8GwCtS3ruKUGveYymwGV7RXQssPiizJ,True,396661270,99165317,617861,308930,308931,3zqXX6kzhkbW3d4TwD2CNjMRwxTbREXySekvq37kfCNk,24714452,319983290,-295268838,623
2022-01-10 14:40:20.757903,2022-01-10 09:34:34-05:00,3339,i7TcF4weYcqgrRdH3GpndbEYxCxfcSfr9JWYrAUg1CF,BkDfknUir7PnSEW8auoB87PytycEFwyX5kT2GY4SGJJL,True,5328026,1332006,8244,4122,4122,4BnQKPLuE3DMTtxp8MjUBytgnhvxqq3ZTqZHTVZo4JJh,329775,4386444,-4056669,618
2022-01-10 14:40:20.757903,2022-01-10 09:34:34-05:00,3340,2d1qyEJRyGvB2H83ACSqUjqYLwcLHcURHWAKLXs4w9vp,EFA6rDFpTQcY2vjZMq6Qrjv56nJPN2FhWXNwFzkWtE2M,True,11426901,2856725,17659,8829,8830,DddJ7EWCmYEEZETCBNgAUSg81Ls6fZtiAaY5ekJ5sXx1,706395,6363719,-5657324,618
2022-01-10 14:40:20.757903,2022-01-10 09:34:34-05:00,3341,GhV3DChNShu8mGwUUy7VLidabCV6Y2aKdp7cqPynd6Ci,8R8QkgruGRCeE1pjXmn3WjdVDiawNbXFid8gU8BfabZA,True,17968,4492,27,13,14,3zqXX6kzhkbW3d4TwD2CNjMRwxTbREXySekvq37kfCNk,1116,7488,-6372,621
2022-01-10 14:40:20.757903,2022-01-10 09:34:35-05:00,3342,5Z3ZFCA65WoWhm3okRuuziEMi7ajGAEHWUFchzBNba5S,FcomdrWidygkxMKzcsY5xELbmwC652uMci648LMTv7AB,True,12532,3133,19,9,10,3zqXX6kzhkbW3d4TwD2CNjMRwxTbREXySekvq37kfCNk,782,5304,-4522,624
2022-01-10 14:40:20.757903,2022-01-10 09:34:35-05:00,3343,DrzTARa7RK8RXoxHZPKCBqYtMC8TAUHRw8SznXRKTa5M,FYANet92VhyXkKZqqBJR4sFxuCftWb68sgQU9VHCdTJk,True,33278,8319,51,25,26,3zqXX6kzhkbW3d4TwD2CNjMRwxTbREXySekvq37kfCNk,2065,13847,-11782,620
2022-01-10 14:40:20.757903,2022-01-10 09:34:44-05:00,3344,E1wp3bmkcY3eiEYyGYwhTCsr7BZ7RfPa5DJTZFupcFwj,452hVdYkD5SDDrA6hv6DLPFvyS8PvR2P6DPNScGxWTsW,True,812583,203145,1261,630,631,4BnQKPLuE3DMTtxp8MjUBytgnhvxqq3ZTqZHTVZo4JJh,50451,364030,-313579,620
2022-01-10 14:40:20.757903,2022-01-10 09:34:59-05:00,3345,9RtNbEZ4ZR8T1HFF4cujPVy2kejVBKFo3CPQi8psSa1q,7zwaGb71jKc9y2HKCKy5q2XV2YUphkyU1hkDaab1GBas,True,118870744,29717685,184978,92489,92489,4BnQKPLuE3DMTtxp8MjUBytgnhvxqq3ZTqZHTVZo4JJh,7399156,31959728,-24560572,622
2022-01-10 14:40:20.757903,2022-01-10 09:35:02-05:00,3346,Bsr6kx1B6BSEd5UnJ7Z61M49iUb3bFrDVhiEtMVtPDF2,3CFd1pUJAJPA9fobwn4Jj2mRju1CWmoop4Mh4znypNWT,True,27989882,6997470,43174,21587,21587,3zqXX6kzhkbW3d4TwD2CNjMRwxTbREXySekvq37kfCNk,1726984,10957244,-9230260,617
2022-01-10 14:40:20.757903,2022-01-10 09:35:02-05:00,3347,GufVttJatW8NLeztT1NRQSLZpQNRk45kaG41p3QcWhx7,GTJUsWoWRyeafYJVhx2aRo8NE94U5UrBjaehmJ4PRUhn,True,26828880,6707220,41909,20954,20955,3zqXX6kzhkbW3d4TwD2CNjMRwxTbREXySekvq37kfCNk,1676372,8589992,-6913620,624
2022-01-10 14:40:20.757903,2022-01-10 09:35:03-05:00,3348,6NJFN855M3Q3RLTDNo57gTgAmwPD6G2E3WvMb1m5eNCN,3YpqNnonsvXaRT4nCC3G5FZx1jjVtbDPc36LiR6WK5jR,True,72732030,18183007,112901,56450,56451,3zqXX6kzhkbW3d4TwD2CNjMRwxTbREXySekvq37kfCNk,4516070,43333863,-38817793,620
2022-01-10 14:40:20.757903,2022-01-10 09:35:11-05:00,3349,75ycx5sUFBxDhY1uwuPCW22s2C6BydkJTje7q7zEQFGT,FpEgrVFRubjGK4DRjTqdVbxSECURpn16zfpoC31NbwnN,True,6422935,1605733,10014,5007,5007,4BnQKPLuE3DMTtxp8MjUBytgnhvxqq3ZTqZHTVZo4JJh,400571,3468873,-3068302,623
2022-01-10 14:40:20.757903,2022-01-10 09:35:12-05:00,3350,AKxRtcdpi7gWhAuL8ENj7zhgeQezzEXe9TSANE6bQoRA,2YH4vrU9deP8Cu6E8Hzf8GqKG1yVjv5pdz4FE7r5YKir,True,6896220,1724055,10760,5380,5380,4BnQKPLuE3DMTtxp8MjUBytgnhvxqq3ZTqZHTVZo4JJh,430426,2948999,-2518573,624
2022-01-10 14:40:20.757903,2022-01-10 09:35:12-05:00,3351,2NHv3c4ufYGo3xNr6KXymAZJdpfURrNiCKbXZ7s82Vwo,E4NYpYgHTvSG6LqH2bBV9Q1XJ6pAzCp9FLSKMzJmYRrQ,True,26057142,6514285,40469,20234,20235,3zqXX6kzhkbW3d4TwD2CNjMRwxTbREXySekvq37kfCNk,1618791,14334644,-12715853,621
2022-01-10 14:40:20.757903,2022-01-10 09:35:12-05:00,3352,9TL17gjvWFdhSJkpXgfnX7fKF9c2hfw59k3g8WUqm8Cb,7TyxFBKG4z5Xv3js3n1gbEWWj1M9KBF7dEmFxjCPGidC,True,186336114,46584028,290740,145370,145370,4BnQKPLuE3DMTtxp8MjUBytgnhvxqq3ZTqZHTVZo4JJh,11629627,65197513,-53567886,624
2022-01-10 14:40:20.757903,2022-01-10 09:35:19-05:00,3353,89CkXnSZnr52Zsoh48efv9MQacrkB6GMtrbEpNJSyA2H,HcvRBS4Z22CpYgDNgm4TVF4AVXFDuYzBUAFcdHAwdpg4,True,3019384,754846,4703,2351,2352,HfEnetJ7uBSmZWCjBNxdvv9HEC5nsW4wDV7wu6WnhWan,188138,1293530,-1105392,623
2022-01-10 14:40:20.757903,2022-01-10 09:35:28-05:00,3354,GaEpNGa8jnwSRvjzzEMYkZe1pKcr2eiZtePrqFxpABjB,5CFZHuyWbJv14zPdX5dSQDREgHrCb4vsFvB6hLiEe3Ji,True,153435,38358,240,120,120,DddJ7EWCmYEEZETCBNgAUSg81Ls6fZtiAaY5ekJ5sXx1,9605,66411,-56806,625
2022-01-10 14:40:20.757903,2022-01-10 09:35:28-05:00,3355,H1Z83zVoskNuBvYao1FjdLfETfhPpQFQUkniJfGxbaNz,EVqbBRV6Zy1tPLRevxpAykp8Mvv6tDZVTc4RmCKw4Gq1,True,774664076,193666018,1198081,599040,599041,4BnQKPLuE3DMTtxp8MjUBytgnhvxqq3ZTqZHTVZo4JJh,47923271,379382961,-331459690,618
2022-01-10 14:40:20.757903,2022-01-10 09:35:29-05:00,3356,BgnsCfJ54ReunUtwPJLzkW4PWnqpBDWGNYxsW5PvDrbK,KpMqEkQ9dKMgCevsEK895wHd3fCLRPSzDmJSv3tKU4u,True,13833459298,3458364824,21131613,10565806,10565807,4BnQKPLuE3DMTtxp8MjUBytgnhvxqq3ZTqZHTVZo4JJh,845264549,5464215275,-4618950726,611
2022-01-10 14:40:20.757903,2022-01-10 09:35:29-05:00,3357,DkvR2xUPMyXWGGkUSmDSfhp7RtvMkfbT1ThKCS3TwrXd,F7jYV6TtT1LZ5XCNn1zkbUfNMo4gGcQUczAQy1jLHpaW,True,581295727,145323931,893012,446506,446506,72FwbpFGoLEazJEdpqNtPNefsadUrimUqma9wSoy4qiS,35720492,261581624,-225861132,614
2022-01-10 14:40:20.757903,2022-01-10 09:35:29-05:00,3358,D64rDiWT3YG28fCgXCmbNjYa2JakZbpKQ1D2XuLChUfV,8WmMWq8cTsGQym5pUbHm9dPCpJugBeWUMVERYFGLxWHj,True,34044967,8511241,51134,25567,25567,3zqXX6kzhkbW3d4TwD2CNjMRwxTbREXySekvq37kfCNk,2045381,12491090,-10445709,600
2022-01-10 14:40:20.757903,2022-01-10 09:35:30-05:00,3359,8xQ3tsWVUe75EG1HmocULJ3kh52utveoFMEPotTGrKno,i3SKW3ywrwYucX9ySEx1C4zaUKGnzLerP3V38437NyV,True,56512376,14128093,87394,43697,43697,4BnQKPLuE3DMTtxp8MjUBytgnhvxqq3ZTqZHTVZo4JJh,3495792,27533030,-24037238,618
2022-01-10 14:40:20.757903,2022-01-10 09:35:31-05:00,3360,GJ3PbEfPK8jjrPgMmZtvN5fMSSy2dtiiAtZ8wcfgxVuc,FCUDVFb2TjDvehHE8fVBofqSykpb9W6Afc9QeHtj7te7,True,77323453,19330863,120176,60088,60088,4BnQKPLuE3DMTtxp8MjUBytgnhvxqq3ZTqZHTVZo4JJh,4807063,44177710,-39370647,621
2022-01-10 14:40:20.757903,2022-01-10 09:35:32-05:00,3361,Ar5QB4VBcUyzSCG23z2QNAbrWY55NbHCr1MNN6P2GAmh,BusFGTiDrJmxzwGUxWz9b3SFF3eseqtgh2DRHqyAwyVe,True,465738,116434,723,361,362,3zqXX6kzhkbW3d4TwD2CNjMRwxTbREXySekvq37kfCNk,28944,210242,-181298,621
2022-01-10 14:40:20.757903,2022-01-10 09:35:33-05:00,3362,8swGZMrPrLAxZd7MxTbkCL13k3DmAJUw41jCp6Xo6awW,3fKnX7yTNXAT4uMmXVdTy47ALJT8h8YSD3WiBb4BGuzH,True,221459418,55364854,340254,170127,170127,3zqXX6kzhkbW3d4TwD2CNjMRwxTbREXySekvq37kfCNk,13610162,102175833,-88565671,614
2022-01-10 14:40:20.757903,2022-01-10 09:35:34-05:00,3363,2BH44k4TYoQSqsSs5EASqJhxpH17Fr8Ahxbg2MAkWa72,HwvvVWpqfN7NDsVYdxbCSbqxSrLCThwnJiZQHh2w2zJb,True,18060,4515,28,14,14,3zqXX6kzhkbW3d4TwD2CNjMRwxTbREXySekvq37kfCNk,1124,7606,-6482,622
2022-01-10 14:40:20.757903,2022-01-10 09:35:36-05:00,3364,DY6k3Dkwe18iLneaT8Xo3VpJWB6V4jWwQQjoDvEzdg2j,3GGV7S9FpRQGbARBXkvGFVqLrmw8JvYAcpnR1aKVUY2f,True,11819008,2954752,18252,9126,9126,4BnQKPLuE3DMTtxp8MjUBytgnhvxqq3ZTqZHTVZo4JJh,730098,7102706,-6372608,617
2022-01-10 14:40:20.757903,2022-01-10 09:35:36-05:00,3365,2rCRdyfi65rpxRRmg7knaSb8t55FuPt3h8wF4Fzhy8MM,CLVY5nSG3jTdRo7tRSKgK9DJgW6aswfWKe4tLxzsENmb,True,634377,158594,989,494,495,3zqXX6kzhkbW3d4TwD2CNjMRwxTbREXySekvq37kfCNk,39585,243490,-203905,623
2022-01-10 14:40:20.757903,2022-01-10 09:35:37-05:00,3366,D3mXrJzhHf8qRaoCKLschUxAFoijFCFuT6bmNZH4W7Cj,9E3Xtqw7TncXWnbhAbFJMtuNmP6WS3ooGuptzyzw7UpA,True,58258,14564,91,45,46,72FwbpFGoLEazJEdpqNtPNefsadUrimUqma9wSoy4qiS,3643,33580,-29937,625
2022-01-10 14:40:20.757903,2022-01-10 09:35:38-05:00,3367,8vva9SmKpMGW8wjpkvydQczxVK6VtN79qzH2i4JQSwg4,F8a3GLicsSapt4aLURoU4qHxJaxCij4LS6JVxoMF3YHT,True,967006,241751,1512,756,756,4BnQKPLuE3DMTtxp8MjUBytgnhvxqq3ZTqZHTVZo4JJh,60498,286347,-225849,625
2022-01-10 14:40:20.757903,2022-01-10 09:35:48-05:00,3368,3JrhHRs4UkkuMoCrQAaAGKZQrWoU72zWArnDGxKFESzH,8yREVE3kMYB7UAwtUDnTDK3egXTuTsN4igtJ5yeHYkCP,True,386348791,96587197,601896,300948,300948,DddJ7EWCmYEEZETCBNgAUSg81Ls6fZtiAaY5ekJ5sXx1,24075870,113059834,-88983964,623
2022-01-10 14:40:20.757903,2022-01-10 09:36:12-05:00,3369,DDsY5V3F9wnEGBoQFCEf1hvEYuKUaJdysbc7TxhNqe9G,5oBCGzvy8odB8MCxCUvPDqYCnTyteZ4Yy1JDroroygbi,True,70400610,17600152,109817,54908,54909,3zqXX6kzhkbW3d4TwD2CNjMRwxTbREXySekvq37kfCNk,4392700,18304327,-13911627,623
2022-01-10 14:40:20.757903,2022-01-10 09:36:14-05:00,3370,8aKqLY7GXxNnGRK8Utke7o6EDGZATNDDF8Ph9Q27ppyi,7MQKkebLEzQgjWjByBMzzkn68yqtYivS4VDcraAScZR6,True,999848,249960,1553,776,777,4BnQKPLuE3DMTtxp8MjUBytgnhvxqq3ZTqZHTVZo4JJh,62145,313640,-251495,621
2022-01-10 14:40:20.757903,2022-01-10 09:36:17-05:00,3371,8Xt3qHjZG3zLxozgM5vPHMVxp8eYFMg89kaVW7vdHKoA,2i8riSsQpfADD9LUVpiBJBfX5qjVAgmZegzfKx6RG9dW,True,53526239,13381559,83492,41746,41746,3zqXX6kzhkbW3d4TwD2CNjMRwxTbREXySekvq37kfCNk,3339697,17748048,-14408351,623
2022-01-10 14:40:20.757903,2022-01-10 09:37:03-05:00,3372,56488NdcUy6Hi6X5SLs2GFtW5pG4u5wJpH7vHdxTCx4z,tGgXjJeVr3W2m3T2NXPCqpBEd6HJKE2cRsgCyiDZQy4,True,37123153,9280788,57787,28893,28894,4BnQKPLuE3DMTtxp8MjUBytgnhvxqq3ZTqZHTVZo4JJh,2311485,18582523,-16271038,622
2022-01-10 14:40:20.757903,2022-01-10 09:37:37-05:00,3373,2mfcg17QocKKvDcqDH88TwxHRiS8dAQiJAGoAh1brns9,8aQLELBgaA9eXsxSciMjxWv8B1hpbUPfLwqVjEnasZbe,True,156344532,39086133,243709,121854,121855,3zqXX6kzhkbW3d4TwD2CNjMRwxTbREXySekvq37kfCNk,9748367,43231125,-33482758,623
2022-01-10 14:40:20.757903,2022-01-10 09:37:38-05:00,3374,BZxJ6CtrVoiU86DMMieMeDFLNWtMpHGTvZfM7nyay6o4,6CRxRR8bisRLHFJBFWjyumYuy7j4C4PkjYH1K8gXhdWD,True,3590094,897522,5604,2802,2802,HfEnetJ7uBSmZWCjBNxdvv9HEC5nsW4wDV7wu6WnhWan,224179,1172557,-948378,624
2022-01-10 14:40:20.757903,2022-01-10 09:37:42-05:00,3375,B9WJfmrYEkVH3L1UWz4qqWpaexHydymbzvEfwNVtB9BV,6mQb4yzGq8jE1NbweKCKSbevnnYVhHYxyc6Gz2a5kJLn,True,319944145,79986036,489464,244732,244732,3zqXX6kzhkbW3d4TwD2CNjMRwxTbREXySekvq37kfCNk,19578571,76780290,-57201719,611
2022-01-10 14:40:20.757903,2022-01-10 09:37:42-05:00,3376,8trFFwvXKKMwMx952ugCZmqyw29e1HxEKBuQmFn8ZwTf,FsD7gCvHXM3QchQiDcd292ksy5afZMWApneNTat5ndeS,True,285301580,71325395,442009,221004,221005,3zqXX6kzhkbW3d4TwD2CNjMRwxTbREXySekvq37kfCNk,17680375,68126585,-50446210,619
2022-01-10 14:40:20.757903,2022-01-10 09:37:46-05:00,3377,aTkGURJptmKNNP6RSXSWsmVbfcriSAJaMuUiT2eZEfb,5qoGxL83PLhrguyk27X8xE6jGitRg5BaQpXzrcfEvCfJ,True,194856829,48714207,304652,152326,152326,4BnQKPLuE3DMTtxp8MjUBytgnhvxqq3ZTqZHTVZo4JJh,12186088,72342285,-60156197,625
2022-01-10 14:40:20.757903,2022-01-10 09:38:33-05:00,3378,243SAnGxchCVB1LQAUF4SsozR86yDwEdg2QQpbWGsMYe,5u8sNkb2oEQjUXJAB3yGStmv3Uwz16gBgExBo5myVK4b,True,10072560,2518140,15722,7861,7861,HfEnetJ7uBSmZWCjBNxdvv9HEC5nsW4wDV7wu6WnhWan,628887,3908496,-3279609,624
2022-01-12 12:53:00.971132,2022-01-12 07:32:05-05:00,3379,8G3MZPpXc9r39cFuEPoeVhG5jiJchAD6FfUZEu1Ua5q9,Cym1s8kog2DysSqRjccnDDtnnVbyQmGNnmv3Jk85wcGn,True,11330833558,2832708389,17425155,8712577,8712578,HfEnetJ7uBSmZWCjBNxdvv9HEC5nsW4wDV7wu6WnhWan,697006215,2027839774,-1330833559,615
2022-01-12 13:46:51.256179,2022-01-12 08:41:51-05:00,3380,2VTYgeeefRGR3R14ywsrn7h3Q9NcCVesVrbK11QKEzSu,FKJUBEkabSEXMmSanm85TDF9zy8Gf2MWEy9Ku2chMqcy,True,69754523,17438630,108061,54030,54031,DddJ7EWCmYEEZETCBNgAUSg81Ls6fZtiAaY5ekJ5sXx1,4322466,12366990,-8044524,619
2022-01-12 21:28:05.795096,2022-01-12 16:25:03-05:00,3381,8AhMgKNmKmYtDnc6YCvK6GRmbEM8RmbAkjSSCdJz4Mag,CVBS4BZMTrc7QemUujwAmS9fh7EgNxsUD14w9WNgyKNu,True,7478853953,1869713487,11667137,5833568,5833569,DddJ7EWCmYEEZETCBNgAUSg81Ls6fZtiAaY5ekJ5sXx1,466685486,1318870385,-852184899,624
2022-01-12 21:28:05.795096,2022-01-12 16:25:36-05:00,3382,2VTYgeeefRGR3R14ywsrn7h3Q9NcCVesVrbK11QKEzSu,FKJUBEkabSEXMmSanm85TDF9zy8Gf2MWEy9Ku2chMqcy,True,53211445,13302861,83168,41584,41584,3zqXX6kzhkbW3d4TwD2CNjMRwxTbREXySekvq37kfCNk,3326722,10255808,-6929086,625
